tot_units,occupied,vacant,owned,rented,med_year,med_rent,med_value,single_fam,multi_fam,per_single,per_multi,pres1990,d1980_1989,d1970_1979,d1960_1969,before1960,r0_500,r500_1000,r1000_1500,r1500_2000,r2000,v0_100,v100_250,v250_400,v400_500,v500,ID_1
996,673,323,558,115,1986,658,145200,771,225,77.41,22.59,436,193,257,114,198,40,169,14,0,0,204,310,108,17,29,0
278,262,16,174,88,1971,325,153300,194,84,69.78,30.22,65,18,93,39,148,100,45,11,0,0,21,152,22,0,0,1
801,666,135,481,185,1992,1299,360200,657,144,82.02,17.98,439,50,188,0,78,20,66,0,15,2,59,19,87,94,236,2
1151,1082,69,179,903,1987,581,284700,179,972,15.55,84.45,398,65,417,29,11,212,339,0,0,0,48,120,94,0,14,3
496,444,52,279,165,1962,623,99900,337,159,67.94,32.06,80,38,71,96,349,112,114,13,0,0,191,44,8,0,0,4
324,296,28,263,33,1949,805,192400,324,0,100.00,0.00,119,42,64,18,74,17,15,0,0,0,23,166,51,0,11,5
507,482,25,447,35,1980,754,190400,428,79,84.42,15.58,202,75,153,28,38,0,0,10,0,0,60,125,70,57,31,6
844,779,65,512,267,1980,1023,123500,735,109,87.09,12.91,303,103,449,20,99,0,429,36,0,0,90,365,0,0,0,7
720,720,0,497,223,1965,687,195900,641,79,89.03,10.97,57,71,166,102,392,23,187,34,0,10,0,364,83,0,0,8
701,686,15,360,326,1971,607,145000,443,258,63.20,36.80,86,73,83,64,304,73,135,12,0,0,133,224,33,0,0,9
324,306,18,280,26,1959,759,212300,319,5,98.46,1.54,63,19,59,17,236,2,28,0,0,0,67,158,51,22,32,10
422,303,119,226,77,1968,661,163000,360,62,85.31,14.69,73,22,46,36,152,7,8,0,0,0,66,104,24,5,20,11
1592,513,1079,334,179,1992,1011,188900,1074,518,67.46,32.54,778,291,216,0,89,9,0,124,18,0,19,156,93,19,91,12
2095,793,1302,629,164,1988,760,208600,1710,385,81.62,18.38,664,532,672,205,194,78,139,29,18,0,71,164,97,67,93,13
404,328,76,9,319,1974,654,0,49,355,12.13,87.87,29,76,95,115,35,110,144,12,0,0,0,50,0,0,0,14
856,744,112,50,694,1988,774,134500,140,716,16.36,83.64,505,316,224,45,18,67,798,0,0,0,55,91,0,0,0,15
660,578,82,470,108,1984,725,192200,535,125,81.06,18.94,201,68,262,108,61,0,24,0,0,0,64,184,155,55,100,16
791,791,0,127,664,1992,739,76500,343,448,43.36,56.64,344,53,153,22,102,63,393,102,0,0,27,89,0,0,0,17
935,732,203,411,321,1983,523,543000,701,234,74.97,25.03,514,282,19,86,197,35,266,60,49,0,0,43,104,140,347,18
776,649,127,300,349,1953,835,228900,359,417,46.26,53.74,234,124,62,26,437,105,256,84,0,0,24,212,46,16,0,19
966,883,83,676,207,1996,1200,180600,786,180,81.37,18.63,576,107,84,12,0,0,108,53,0,0,122,344,39,12,0,20
1235,1235,0,1079,156,1999,0,146900,1235,0,100.00,0.00,1031,29,119,43,31,16,105,17,0,0,31,748,136,36,0,21
724,672,52,593,79,1997,788,167100,613,111,84.67,15.33,243,60,225,35,83,0,22,0,0,0,47,469,38,0,11,22
651,388,263,21,367,1984,698,0,26,625,3.99,96.01,132,199,158,65,48,46,186,141,100,17,0,29,0,0,0,23
362,309,53,142,167,1965,700,160900,178,184,49.17,50.83,56,39,124,8,174,70,83,17,0,0,22,169,16,0,0,24
1239,1239,0,706,533,1990,745,125400,838,401,67.64,32.36,897,59,154,16,54,114,215,21,0,0,32,630,27,0,0,25
931,545,386,403,142,1979,443,146100,714,217,76.69,23.31,265,165,158,48,70,49,47,0,0,0,68,178,22,0,39,26
662,593,69,280,313,1939,719,266700,414,248,62.54,37.46,0,31,102,84,673,170,317,27,0,0,0,68,127,0,16,27
315,295,20,228,67,1952,817,110700,287,28,91.11,8.89,0,0,24,36,229,47,15,0,0,0,97,130,0,0,0,28
234,234,0,234,0,1989,0,156400,186,48,79.49,20.51,17,33,114,77,32,0,11,0,0,0,70,110,8,0,0,29
403,348,55,260,88,1976,575,162800,335,68,83.13,16.87,89,32,68,27,235,4,11,10,0,7,92,206,7,0,0,30
589,461,128,419,42,1990,0,193400,484,105,82.17,17.83,127,27,85,90,298,33,0,0,0,0,22,242,124,38,0,31
1099,1034,65,641,393,1992,1167,233600,897,202,81.62,18.38,555,306,141,0,16,0,17,86,13,67,17,364,245,59,92,32
990,921,69,888,33,1994,0,231900,990,0,100.00,0.00,578,144,117,16,0,0,0,0,0,0,35,414,298,6,28,33
345,328,17,290,38,1973,0,189600,262,83,75.94,24.06,151,21,58,10,110,0,0,25,0,0,45,167,16,0,30,34
360,323,37,252,71,1964,1107,131300,360,0,100.00,0.00,154,10,74,50,180,33,99,14,0,0,0,302,15,0,0,35
695,644,51,494,150,1966,410,100300,600,95,86.33,13.67,52,65,305,136,282,76,100,0,0,0,341,147,0,0,0,36
1121,1067,54,475,592,1972,844,157300,729,392,65.03,34.97,144,151,501,113,338,62,517,77,0,0,18,497,40,0,0,37
620,536,84,322,214,1990,836,125000,383,237,61.77,38.23,146,9,86,108,116,12,99,27,0,0,30,283,0,0,0,38
414,324,90,271,53,1983,424,213900,359,55,86.71,13.29,120,36,72,56,88,0,15,0,0,0,62,100,89,5,40,39
2126,251,1875,206,45,1979,0,237500,1852,274,87.11,12.89,447,563,334,189,492,0,55,0,12,0,38,127,103,5,98,40
285,285,0,93,192,1958,757,97500,141,144,49.47,50.53,9,10,11,79,152,22,136,25,0,0,0,43,0,0,0,41
589,525,64,183,342,1954,912,142100,415,174,70.46,29.54,34,87,115,60,266,37,231,20,15,0,24,153,15,0,0,42
445,420,25,283,137,1971,518,118400,380,65,85.39,14.61,56,18,148,125,102,8,132,13,0,0,88,173,0,0,0,43
422,422,0,268,154,1976,631,84300,292,130,69.19,30.81,50,6,94,43,70,125,75,0,0,0,63,0,0,0,0,44
332,287,45,183,104,1939,577,94500,263,69,79.22,20.78,53,26,18,25,199,58,64,0,0,0,126,44,0,0,0,45
662,616,46,297,319,1983,846,150100,467,195,70.54,29.46,283,117,104,16,216,12,217,84,0,0,30,303,7,8,0,46
1132,239,893,202,37,1981,619,271400,850,282,75.09,24.91,247,78,185,172,414,18,66,0,0,0,42,27,58,21,58,47
744,697,47,283,414,1971,750,325300,420,324,56.45,43.55,74,104,173,62,288,28,219,103,0,0,0,29,83,63,30,48
600,556,44,476,80,1976,1018,130000,515,85,85.83,14.17,160,46,164,126,153,7,46,0,0,0,224,337,14,0,0,49
820,765,55,740,25,1971,628,297300,813,7,99.15,0.85,183,109,170,108,182,0,23,5,0,0,20,250,202,129,74,50
668,569,99,257,312,1939,625,88500,390,278,58.38,41.62,14,35,115,16,632,193,144,0,0,0,217,92,0,0,9,51
167,103,64,93,10,1982,758,294600,124,43,74.25,25.75,40,18,51,56,25,2,31,0,0,0,0,19,0,0,9,52
729,693,36,160,533,1973,728,122200,428,301,58.71,41.29,113,26,205,16,418,140,276,0,0,0,18,202,53,0,0,53
366,366,0,258,108,1981,1086,195200,341,25,93.17,6.83,51,208,138,0,17,0,80,23,0,0,0,259,44,8,0,54
1171,1072,99,530,542,1990,986,147900,852,319,72.76,27.24,628,28,242,176,263,18,206,165,0,0,0,668,150,12,0,55
518,505,13,436,69,1983,739,176900,421,97,81.27,18.73,149,109,311,60,0,0,46,10,0,0,48,298,130,55,0,56
499,430,69,395,35,1979,593,102500,476,23,95.39,4.61,88,67,184,52,107,9,86,39,0,0,66,220,9,0,14,57
531,495,36,351,144,1974,997,185000,365,166,68.74,31.26,148,40,78,15,154,0,58,0,0,0,47,177,80,5,8,58
404,388,16,351,37,1969,835,128600,387,17,95.79,4.21,0,35,173,37,119,0,0,0,0,0,64,300,0,0,0,59
168,168,0,133,35,1960,658,43400,95,73,56.55,43.45,128,69,199,25,68,74,146,16,0,0,152,20,22,0,0,60
510,510,0,348,162,1949,683,127000,475,35,93.14,6.86,0,16,80,12,623,47,242,13,0,0,77,226,0,0,0,61
344,321,23,76,245,1977,673,151400,161,183,46.80,53.20,137,32,55,0,124,0,220,0,0,0,8,114,0,0,0,62
329,329,0,258,71,1977,0,197000,329,0,100.00,0.00,24,61,244,0,27,0,0,29,0,0,0,99,157,11,0,63
667,667,0,346,321,1979,1017,148200,586,81,87.86,12.14,139,90,149,68,101,28,32,64,0,0,35,314,24,0,17,64
257,151,106,28,123,1968,1334,0,47,210,18.29,81.71,44,27,20,23,66,59,37,35,19,0,0,8,0,0,0,65
416,387,29,254,133,1979,654,62500,346,70,83.17,16.83,95,49,170,47,100,72,62,0,0,0,159,111,0,16,3,66
711,657,54,255,402,1943,619,104400,492,219,69.20,30.80,0,14,46,62,575,141,165,12,0,0,108,172,0,0,0,67
344,307,37,213,94,1972,888,134200,278,66,80.81,19.19,32,67,105,106,85,0,41,0,0,0,55,242,0,0,0,68
901,901,0,604,297,1982,720,158400,704,197,78.14,21.86,235,292,374,63,13,0,284,42,0,0,16,493,77,31,0,69
1063,929,134,450,479,1954,774,135000,703,360,66.13,33.87,215,39,79,57,615,37,405,31,0,0,68,319,67,0,17,70
572,524,48,118,406,1946,538,101800,242,330,42.31,57.69,6,37,117,31,379,242,97,0,0,0,22,185,0,7,0,71
586,525,61,393,132,1975,487,89300,513,73,87.54,12.46,50,53,116,54,175,45,101,0,0,0,207,95,0,0,0,72
581,568,13,303,265,1947,501,131100,487,94,83.82,16.18,19,0,172,59,430,13,182,14,7,0,89,363,0,0,0,73
409,276,133,254,22,1960,743,160900,375,34,91.69,8.31,93,47,50,30,142,26,13,0,0,0,74,98,11,10,25,74
1222,1185,37,289,896,1978,860,89600,614,608,50.25,49.75,422,184,225,54,126,0,345,30,0,48,119,398,15,0,17,75
527,485,42,294,191,1989,686,128100,306,221,58.06,41.94,81,88,65,44,100,8,163,23,0,0,47,124,0,0,0,76
333,259,74,180,79,1951,713,111900,293,40,87.99,12.01,4,0,39,54,271,12,68,0,0,0,71,66,0,11,0,77
4090,525,3565,485,40,1984,0,287700,3631,459,88.78,11.22,1164,750,796,580,381,41,17,0,0,0,39,237,83,70,31,78
838,244,594,220,24,1982,0,245000,750,88,89.50,10.50,220,216,150,40,176,5,0,0,0,0,48,32,41,0,49,79
612,590,22,526,64,1993,0,173800,457,155,74.67,25.33,276,12,266,84,39,0,14,0,0,0,86,269,99,0,27,80
866,733,133,526,207,1991,847,138300,629,237,72.63,27.37,309,140,285,82,73,36,161,17,15,0,87,399,17,0,0,81
486,363,123,248,115,1996,1118,184100,313,173,64.40,35.60,220,17,187,50,40,15,0,30,0,0,120,153,21,0,0,82
696,614,82,350,264,1976,575,239600,434,262,62.36,37.64,176,158,236,65,170,167,52,0,0,0,120,63,137,0,34,83
441,168,273,133,35,1978,0,106500,310,131,70.29,29.71,84,116,161,59,63,18,28,0,0,0,70,173,10,0,0,84
538,505,33,430,75,1975,686,99000,371,167,68.96,31.04,24,34,109,37,136,6,57,0,0,0,146,97,3,0,0,85
998,998,0,668,330,1983,753,151200,789,209,79.06,20.94,459,190,321,86,11,12,185,73,0,0,68,604,37,0,0,86
1325,1319,6,953,366,1997,698,156000,1150,175,86.79,13.21,631,206,114,0,29,0,40,62,0,0,40,813,25,0,0,87
573,443,130,407,36,1991,0,191900,438,135,76.44,23.56,228,127,80,43,57,0,33,0,0,0,19,218,95,9,99,88
495,462,33,212,250,1948,392,110300,300,195,60.61,39.39,56,0,23,81,327,45,71,22,0,0,101,141,6,0,0,89
896,556,340,382,174,1983,634,398300,710,186,79.24,20.76,281,84,193,62,107,18,59,28,0,0,40,85,51,4,184,90
1226,983,243,741,242,1992,2250,463500,1142,84,93.15,6.85,689,179,281,11,16,0,0,44,17,0,0,54,222,57,559,91
509,509,0,330,179,1952,0,79500,434,75,85.27,14.73,32,0,15,64,296,11,84,0,0,0,174,78,0,0,0,92
483,483,0,123,360,1982,647,106600,207,276,42.86,57.14,30,66,182,44,172,0,233,69,0,0,58,65,14,0,0,93
415,357,58,175,182,1939,568,108900,342,73,82.41,17.59,0,0,38,14,336,118,51,0,0,0,42,167,10,0,0,94
445,342,103,297,45,1964,636,85800,401,44,90.11,9.89,34,15,25,145,222,12,5,0,0,0,198,41,8,0,0,95
366,211,155,137,74,1976,570,153300,252,114,68.85,31.15,43,31,66,11,143,35,22,0,0,0,67,39,10,0,4,96
336,282,54,251,31,1959,716,110200,257,79,76.49,23.51,49,20,53,4,142,17,2,0,0,0,100,85,9,37,0,97
380,380,0,216,164,1965,825,86000,302,78,79.47,20.53,29,19,77,21,171,51,44,0,0,0,60,99,0,29,0,98
547,406,141,351,55,1976,525,159200,454,93,83.00,17.00,80,72,116,67,183,44,52,0,0,0,80,124,49,11,32,99
478,425,53,354,71,1979,798,199200,390,88,81.59,18.41,110,33,209,0,122,8,0,0,0,0,75,215,142,12,22,100
744,714,30,496,218,1980,944,258100,656,88,88.17,11.83,323,172,237,0,32,13,24,57,0,0,8,208,277,26,114,101
523,487,36,167,320,1949,821,191400,386,137,73.80,26.20,24,0,102,35,467,0,152,55,0,0,0,298,34,26,0,102
1493,1374,119,913,461,1998,764,145200,768,725,51.44,48.56,886,93,120,4,149,38,300,70,0,0,172,502,90,0,51,103
321,313,8,248,65,1982,721,119800,305,16,95.02,4.98,78,26,94,74,123,16,48,0,0,0,122,92,0,0,0,104
472,308,164,253,55,1993,0,251800,435,37,92.16,7.84,106,258,22,16,75,0,0,0,0,0,37,129,0,0,143,105
608,531,77,410,121,1968,780,118300,485,123,79.77,20.23,82,8,155,84,216,94,15,0,0,0,247,147,0,10,0,106
832,775,57,678,97,1978,1158,184600,732,100,87.98,12.02,235,58,301,50,116,31,29,21,0,0,70,250,160,78,90,107
439,402,37,157,245,1977,536,92100,192,247,43.74,56.26,0,0,206,28,322,149,66,0,23,0,158,83,14,0,15,108
310,260,50,206,54,1959,804,120800,233,77,75.16,24.84,31,26,34,56,188,0,61,0,0,0,61,139,7,0,0,109
291,291,0,152,139,1948,820,92600,231,60,79.38,20.62,0,13,67,77,182,8,88,8,0,0,84,104,0,0,13,110
454,395,59,181,214,1939,451,96000,202,252,44.49,55.51,20,7,61,30,245,82,140,0,0,0,21,82,0,0,0,111
218,164,54,99,65,1939,936,135400,182,36,83.49,16.51,0,0,21,21,190,26,35,0,0,0,10,140,0,0,0,112
564,526,38,422,104,1974,671,134900,496,68,87.94,12.06,72,31,295,28,123,4,19,13,0,0,52,339,31,0,11,113
365,365,0,283,82,1973,814,122000,312,53,85.48,14.52,29,48,152,93,56,0,57,28,0,0,78,158,0,0,0,114
239,239,0,160,79,1959,953,110400,239,0,100.00,0.00,12,0,50,35,190,0,63,0,0,0,103,121,0,0,0,115
547,547,0,458,89,1987,1119,192800,547,0,100.00,0.00,227,190,113,6,0,0,16,21,0,0,31,282,186,0,0,116
411,411,0,355,56,1975,1219,147600,411,0,100.00,0.00,65,0,203,71,39,0,0,11,0,0,53,286,28,0,0,117
450,450,0,313,137,1977,1019,159800,322,128,71.56,28.44,180,39,87,92,44,0,36,13,0,0,118,189,77,9,0,118
787,738,49,453,285,1986,1380,173600,770,17,97.84,2.16,343,175,272,47,14,0,0,25,17,0,0,520,122,13,42,119
668,623,45,497,126,1983,1079,120100,647,21,96.86,3.14,197,109,307,97,16,12,140,16,0,0,24,453,0,0,15,120
1189,978,211,437,541,1992,902,247600,549,640,46.17,53.83,810,201,156,23,45,34,446,12,12,0,16,326,148,42,57,121
382,382,0,272,110,1977,961,128900,368,14,96.34,3.66,0,34,213,44,49,0,13,41,0,0,45,156,0,0,0,122
485,485,0,285,200,1979,676,124100,272,213,56.08,43.92,134,26,193,24,158,16,102,0,0,0,0,212,21,0,0,123
301,278,23,183,95,1939,683,298900,246,55,81.73,18.27,14,0,59,17,333,0,130,63,0,0,0,130,23,0,61,124
397,322,75,208,114,1945,752,277800,292,105,73.55,26.45,16,48,62,50,257,69,107,23,0,0,0,105,62,16,17,125
1276,1119,157,782,337,1984,886,234900,880,396,68.97,31.03,390,638,128,40,95,42,291,118,0,0,0,309,372,31,0,126
363,363,0,333,30,1954,0,113000,351,12,96.69,3.31,106,47,15,0,164,0,22,32,0,0,0,92,61,15,0,127
655,655,0,487,168,1964,837,140000,615,40,93.89,6.11,32,19,48,363,236,11,118,22,0,0,21,507,8,0,0,128
443,443,0,266,177,1950,820,153500,349,94,78.78,21.22,0,19,12,83,314,6,109,21,0,0,39,183,63,7,0,129
364,356,8,182,174,1967,763,107700,290,74,79.67,20.33,108,35,119,12,130,34,103,37,0,0,0,125,57,0,0,130
835,777,58,509,268,1977,771,147800,611,224,73.17,26.83,161,99,284,64,138,29,223,14,0,0,55,345,55,0,0,131
480,440,40,187,253,1978,607,117100,224,256,46.67,53.33,72,106,53,79,24,36,94,0,0,0,47,134,16,0,0,132
523,523,0,429,94,1978,0,129900,447,76,85.47,14.53,124,107,283,47,44,6,181,0,0,0,7,375,6,0,0,133
317,317,0,317,0,1964,0,89300,317,0,100.00,0.00,12,23,124,12,207,17,90,0,0,0,98,136,5,0,0,134
552,552,0,416,136,1973,715,157900,501,51,90.76,9.24,183,22,138,22,149,0,69,0,13,0,118,293,9,0,0,135
1216,1052,164,262,790,1993,769,134100,379,837,31.17,68.83,355,158,253,124,146,170,251,61,14,16,76,272,13,0,0,136
405,384,21,353,31,1958,0,114800,384,21,94.81,5.19,21,14,40,42,240,0,16,31,0,0,86,210,0,0,0,137
459,421,38,57,364,1975,687,101800,115,344,25.05,74.95,0,91,123,125,277,9,210,13,11,57,69,90,0,0,0,138
327,310,17,215,95,1955,704,112700,253,74,77.37,22.63,116,0,22,0,255,12,64,0,0,0,15,169,48,34,0,139
421,374,47,162,212,1968,726,98000,335,86,79.57,20.43,103,64,13,35,260,75,120,31,0,0,67,162,10,0,0,140
424,424,0,295,129,1974,664,107300,343,81,80.90,19.10,52,23,99,92,128,16,119,0,0,0,97,117,13,0,0,141
296,296,0,194,102,1977,531,154100,166,130,56.08,43.92,60,2,118,77,43,2,33,0,0,0,81,113,47,0,0,142
123,68,55,15,53,1973,1401,0,35,88,28.46,71.54,31,23,62,88,58,49,22,72,20,0,0,18,0,0,0,143
272,139,133,9,130,1983,650,0,31,241,11.40,88.60,60,44,32,0,9,40,45,0,39,0,0,21,0,0,0,144
329,329,0,253,76,1974,1016,191000,312,17,94.83,5.17,19,26,165,50,83,21,56,0,0,0,28,178,25,4,0,145
647,614,33,214,400,1962,675,198000,341,306,52.70,47.30,24,49,159,63,203,93,140,63,0,0,0,132,18,10,0,146
327,246,81,197,49,1939,0,200800,243,84,74.31,25.69,0,0,77,15,186,8,100,0,0,0,0,86,66,0,0,147
436,386,50,282,104,1942,719,208500,392,44,89.91,10.09,29,13,54,128,234,36,148,42,0,0,0,223,9,0,0,148
435,364,71,268,96,1970,640,165600,348,87,80.00,20.00,82,28,57,30,177,25,60,0,0,0,61,143,42,2,21,149
796,159,637,102,57,1979,712,0,708,88,88.94,11.06,219,40,113,80,125,4,31,0,0,0,58,23,21,14,3,150
522,484,38,326,158,1964,820,150200,466,56,89.27,10.73,19,25,41,26,292,0,47,4,0,0,76,155,6,0,0,151
625,560,65,412,148,1996,635,221700,553,72,88.48,11.52,286,98,48,0,111,0,0,0,0,0,38,146,131,94,20,152
367,262,105,189,73,1939,664,82800,338,29,92.10,7.90,12,28,0,23,300,33,52,0,0,0,126,84,0,0,0,153
516,399,117,315,84,1956,613,140400,449,67,87.02,12.98,146,37,93,34,303,9,20,0,0,0,133,236,59,13,0,154
1145,307,838,252,55,1991,657,243200,950,195,82.97,17.03,338,401,362,128,66,15,18,14,0,0,70,140,127,35,18,155
2799,912,1887,711,201,1988,811,287900,2230,569,79.67,20.33,973,417,464,185,229,45,118,51,0,0,50,342,264,104,248,156
1021,624,397,466,158,1975,584,106700,766,255,75.02,24.98,173,225,212,174,275,108,43,0,0,0,193,231,109,37,25,157
1210,644,566,490,154,1992,592,209300,997,213,82.40,17.60,379,132,194,67,178,18,45,16,10,0,50,213,92,20,100,158
627,613,14,323,290,1992,919,160900,405,222,64.59,35.41,412,70,84,52,26,24,21,12,0,0,67,309,121,26,64,159
978,712,266,605,107,1977,739,175700,852,126,87.12,12.88,247,87,281,22,260,157,92,0,0,0,98,264,17,20,13,160
666,642,24,470,172,1995,1031,112100,637,29,95.65,4.35,436,61,80,32,33,0,79,17,0,0,119,375,0,0,0,161
749,679,70,431,248,1994,685,132200,539,210,71.96,28.04,266,72,149,58,57,15,0,28,0,0,0,304,167,50,24,162
689,657,32,407,250,1988,812,98600,436,253,63.28,36.72,342,84,221,30,24,38,207,0,0,0,181,197,0,0,0,163
501,460,41,155,305,1982,724,106400,268,233,53.49,46.51,204,21,126,34,141,26,249,0,0,0,94,145,0,0,12,164
317,275,42,212,63,1958,600,118400,264,53,83.28,16.72,44,8,25,39,178,32,12,0,0,0,84,66,30,0,0,165
1863,372,1491,290,82,1986,913,124000,1410,453,75.68,24.32,601,263,440,228,236,0,61,21,0,0,99,119,50,14,48,166
472,422,50,318,104,1991,1167,186100,367,105,77.75,22.25,217,167,115,0,0,0,26,50,0,40,0,207,141,0,0,167
926,918,8,522,396,1991,871,138000,639,287,69.01,30.99,574,61,237,19,13,13,272,52,0,0,43,447,4,0,0,168
591,554,37,288,266,1967,773,115400,343,248,58.04,41.96,34,132,209,84,184,29,238,15,0,0,14,304,0,0,0,169
435,393,42,343,50,1986,0,169800,435,0,100.00,0.00,208,270,28,13,15,0,24,10,0,0,0,328,76,0,48,170
1682,1589,93,952,637,1993,1078,237300,1529,153,90.90,9.10,478,93,509,9,66,15,170,96,0,0,0,348,293,52,52,171
1200,1150,50,500,650,1996,758,136100,598,602,49.83,50.17,683,94,173,14,0,12,230,101,0,0,157,444,12,0,0,172
373,358,15,335,23,1985,0,281000,373,0,100.00,0.00,113,214,22,0,28,0,0,9,0,0,0,67,219,69,0,173
332,216,116,124,92,1975,511,142200,202,130,60.84,39.16,62,104,154,42,137,13,0,0,0,0,50,80,44,0,46,174
333,201,132,132,69,1977,0,163500,239,94,71.77,28.23,103,0,102,34,73,28,0,0,0,0,28,102,0,0,17,175
1091,1091,0,324,767,1993,650,87100,244,847,22.36,77.64,459,71,297,11,34,90,257,75,0,0,233,103,16,0,0,176
804,761,43,679,82,1979,586,145400,704,100,87.56,12.44,268,116,306,64,34,0,51,9,0,0,72,643,13,0,0,177
448,448,0,430,18,1980,0,165700,396,52,88.39,11.61,63,231,113,6,0,0,0,0,0,0,44,359,10,0,0,178
364,364,0,279,85,1954,610,98000,300,64,82.42,17.58,8,0,32,6,289,10,11,44,0,0,142,93,8,0,0,179
591,562,29,242,320,1981,545,125000,205,386,34.69,65.31,155,25,211,58,123,29,74,0,0,0,123,211,41,0,0,180
369,369,0,48,321,1968,422,84500,113,256,30.62,69.38,41,38,11,29,177,150,41,0,0,0,46,30,0,0,0,181
807,705,102,310,395,1945,602,106000,502,305,62.21,37.79,31,10,68,94,763,111,151,28,0,0,327,192,17,0,12,182
452,362,90,241,121,1959,633,106600,364,88,80.53,19.47,70,18,28,47,253,9,82,0,0,0,101,224,0,0,0,183
709,677,32,144,533,1939,444,91900,247,462,34.84,65.16,56,0,20,37,542,214,39,0,0,0,91,81,9,0,0,184
304,304,0,201,103,1974,714,122600,231,73,75.99,24.01,34,11,134,42,85,0,65,11,0,0,13,183,13,0,0,185
392,338,54,319,19,1977,707,123300,326,66,83.16,16.84,61,27,62,15,209,22,0,0,0,0,108,186,19,0,5,186
354,271,83,124,147,1954,544,134500,172,182,48.59,51.41,23,0,58,11,160,12,24,50,0,0,10,138,11,7,0,187
384,384,0,257,127,1974,927,86700,384,0,100.00,0.00,6,40,138,67,158,0,82,6,0,0,86,188,20,0,0,188
494,391,103,159,232,1968,670,82300,378,116,76.52,23.48,38,26,26,120,284,82,160,23,0,0,109,70,0,0,3,189
286,279,7,104,175,1966,646,102600,254,32,88.81,11.19,7,8,0,20,213,0,107,18,0,0,15,66,19,0,0,190
421,421,0,284,137,1965,708,92200,315,106,74.82,25.18,68,44,10,14,182,0,38,0,0,0,121,102,0,0,18,191
344,336,8,89,247,1977,580,69500,107,237,31.10,68.90,180,0,156,33,168,93,160,0,0,0,171,0,0,0,0,192
784,746,38,457,289,1965,574,119500,606,178,77.30,22.70,88,37,180,224,360,60,173,63,0,0,107,266,8,0,11,193
508,440,68,245,195,1956,396,87800,371,137,73.03,26.97,66,24,94,76,236,57,52,20,0,0,245,90,0,0,0,194
648,562,86,290,272,1971,583,109300,388,260,59.88,40.12,51,163,191,80,256,168,71,0,0,0,199,179,10,0,15,195
623,564,59,483,81,1977,843,111300,337,286,54.09,45.91,72,31,286,67,91,10,78,0,0,0,140,237,9,0,0,196
622,228,394,195,33,1979,0,144300,519,103,83.44,16.56,216,153,79,181,167,63,23,0,0,0,56,59,50,0,0,197
519,440,79,128,312,1946,710,178000,258,261,49.71,50.29,3,26,38,54,505,220,156,0,0,0,38,118,13,0,0,198
728,627,101,395,232,1977,682,214500,455,273,62.50,37.50,104,133,112,55,118,15,106,0,35,0,14,231,89,19,13,199
626,584,42,320,264,1965,732,158300,411,215,65.65,34.35,52,40,94,87,332,62,179,0,0,0,37,240,28,0,0,200
424,424,0,354,70,1968,704,157300,377,47,88.92,11.08,158,68,121,22,100,0,36,0,0,0,41,300,71,13,8,201
526,526,0,343,183,1957,593,130500,386,140,73.38,26.62,83,36,63,87,307,41,125,12,0,0,64,245,61,0,0,202
260,260,0,193,67,1975,822,133800,164,96,63.08,36.92,47,94,78,30,175,58,138,0,0,0,0,213,15,0,0,203
625,615,10,300,315,2001,716,195800,361,264,57.76,42.24,426,71,122,68,105,19,255,44,0,6,72,246,86,11,31,204
724,625,99,500,125,1962,549,100500,598,126,82.60,17.40,46,38,122,7,416,15,74,0,0,0,232,133,20,0,12,205
387,327,60,135,192,1947,852,128000,284,103,73.39,26.61,78,0,204,0,137,17,108,46,0,15,57,155,0,0,0,206
855,827,28,598,229,1971,662,86300,663,192,77.54,22.46,105,20,155,68,270,47,85,2,0,0,175,237,18,4,0,207
633,549,84,188,361,1973,600,140900,309,324,48.82,51.18,85,50,175,0,258,107,237,0,0,0,32,120,22,0,0,208
427,396,31,131,265,1947,649,164400,266,161,62.30,37.70,29,35,27,57,210,11,146,13,0,0,11,64,19,37,18,209
894,894,0,496,398,1990,737,120600,348,546,38.93,61.07,383,151,214,93,58,24,139,68,0,0,304,270,0,0,0,210
992,900,92,205,695,1973,760,120100,180,812,18.15,81.85,109,123,311,101,235,113,315,15,119,30,0,245,42,0,0,211
379,295,84,185,110,1978,768,110500,279,100,73.61,26.39,151,62,92,31,100,5,10,6,0,0,79,223,14,0,19,212
624,599,25,347,252,1975,764,208300,409,215,65.54,34.46,179,50,283,56,168,0,230,23,0,0,0,288,53,0,48,213
856,856,0,359,497,1973,619,129300,458,398,53.50,46.50,84,48,220,49,317,116,330,0,0,0,27,152,15,0,0,214
434,389,45,303,86,1962,546,149100,360,74,82.95,17.05,10,11,169,81,198,0,89,97,0,0,15,208,54,0,6,215
583,509,74,73,436,1978,615,132200,160,423,27.44,72.56,130,85,194,52,74,183,167,0,0,0,0,73,14,0,0,216
1178,1096,82,758,338,1992,1141,212400,948,230,80.48,19.52,771,137,197,38,66,7,181,51,41,107,8,550,139,45,22,217
355,336,19,293,43,1956,0,91500,302,53,85.07,14.93,11,11,43,23,337,15,26,0,0,0,152,172,0,0,0,218
412,382,30,304,78,1966,1012,140300,336,76,81.55,18.45,40,0,19,291,104,0,45,0,0,0,26,311,9,14,0,219
307,307,0,229,78,1961,645,122000,249,58,81.11,18.89,12,0,98,119,183,0,48,15,0,0,97,236,0,0,0,220
214,214,0,163,51,1957,593,71900,196,18,91.59,8.41,0,19,37,41,224,23,41,0,0,0,201,7,10,0,0,221
1160,1124,36,588,536,1994,978,152700,774,386,66.72,33.28,660,192,48,52,37,15,284,142,0,39,52,363,13,13,0,222
459,408,51,240,168,1962,488,105000,309,150,67.32,32.68,118,23,66,65,244,116,148,0,0,0,34,192,0,0,0,223
307,296,11,214,82,1978,725,161900,252,55,82.08,17.92,112,6,244,17,20,0,25,3,12,0,47,258,37,0,0,224
598,454,144,358,96,1981,622,141700,511,87,85.45,14.55,142,191,58,52,255,35,34,6,0,0,164,207,62,0,4,225
987,720,267,622,98,1986,549,172700,720,267,72.95,27.05,373,123,125,106,167,6,32,0,0,0,94,152,124,0,112,226
342,334,8,155,179,1945,843,128500,238,104,69.59,30.41,0,21,11,11,380,89,78,34,0,0,31,171,0,0,20,227
265,265,0,133,132,1951,498,113400,173,92,65.28,34.72,7,0,13,0,301,78,15,32,0,0,51,84,0,0,0,228
531,511,20,304,207,1953,720,176700,456,75,85.88,14.12,52,16,46,78,426,10,145,25,0,0,17,237,110,0,0,229
979,928,51,544,384,1974,600,90000,689,290,70.38,29.62,234,186,261,163,340,14,280,42,0,0,292,302,0,0,0,230
676,640,36,340,300,1948,833,308400,463,213,68.49,31.51,65,0,11,91,382,114,159,0,0,0,0,89,124,44,19,231
569,569,0,497,72,1975,745,160800,569,0,100.00,0.00,25,48,380,100,18,18,35,25,0,0,14,398,58,12,0,232
321,321,0,205,116,1976,1033,157100,311,10,96.88,3.12,0,69,314,0,0,0,87,12,0,0,15,228,13,0,0,233
260,211,49,93,118,1951,765,114300,260,0,100.00,0.00,0,0,44,16,298,13,40,0,0,0,193,112,0,0,0,234
942,808,134,734,74,1969,525,130800,766,176,81.32,18.68,176,34,174,32,292,60,99,0,0,0,119,172,50,33,0,235
1347,1347,0,1130,217,2002,1313,187700,1234,113,91.61,8.39,1102,134,126,33,51,0,106,212,0,0,68,770,159,0,26,236
538,457,81,164,293,1997,887,16900,20,518,3.72,96.28,214,0,41,15,27,10,25,0,0,0,188,42,32,0,0,237
582,567,15,362,205,1979,719,87700,348,234,59.79,40.21,42,83,97,126,250,91,141,0,0,0,154,108,13,0,10,238
431,347,84,145,202,1958,646,143300,204,227,47.33,52.67,0,33,49,84,253,52,140,5,0,0,13,182,0,0,0,239
837,798,39,644,154,1964,825,213000,735,102,87.81,12.19,48,76,224,141,318,12,103,18,10,0,31,334,194,72,21,240
345,256,89,184,72,1960,776,83500,315,30,91.30,8.70,0,0,43,0,242,9,77,0,0,0,92,76,0,0,0,241
340,324,16,192,132,1957,692,116800,277,63,81.47,18.53,38,9,25,31,135,0,78,0,0,0,46,114,0,0,0,242
393,222,171,163,59,1973,732,196500,206,187,52.42,47.58,62,39,126,46,240,8,156,0,45,0,0,66,28,15,37,243
1652,1596,56,1321,275,2002,874,172300,1575,77,95.34,4.66,993,88,247,59,118,54,92,32,0,0,197,889,120,22,22,244
323,323,0,147,176,1959,645,78300,262,61,81.11,18.89,13,11,5,6,218,13,37,0,0,0,41,120,0,0,0,245
786,511,275,433,78,1965,628,137800,619,167,78.75,21.25,182,17,107,63,218,21,39,0,0,0,108,175,19,6,10,246
402,402,0,250,152,1972,647,114200,193,209,48.01,51.99,50,33,93,62,188,0,110,18,0,0,108,140,0,0,0,247
521,508,13,201,307,1975,744,122600,350,171,67.18,32.82,35,66,380,107,83,0,278,10,9,0,39,274,7,0,0,248
948,896,52,352,544,1975,836,181300,497,451,52.43,47.57,255,134,110,100,335,142,248,95,0,0,8,205,68,14,32,249
681,639,42,480,159,1939,649,219500,666,15,97.80,2.20,14,41,53,13,629,0,170,13,39,0,0,151,275,39,11,250
725,670,55,498,172,1959,619,206100,602,123,83.03,16.97,101,49,63,64,447,0,148,45,12,0,15,289,123,13,10,251
871,772,99,556,216,1977,880,143500,775,96,88.98,11.02,189,16,420,116,101,29,102,34,0,0,33,594,50,0,0,252
826,654,172,431,223,1978,625,145200,592,234,71.67,28.33,186,131,166,43,222,36,80,0,0,0,138,205,30,15,25,253
292,252,40,69,183,1951,643,95900,183,109,62.67,37.33,22,27,118,115,212,62,123,12,0,0,73,82,0,0,0,254
294,283,11,231,52,1966,623,170700,217,77,73.81,26.19,43,39,137,79,61,0,25,0,0,0,0,162,42,0,0,255
396,266,130,190,76,1975,523,114100,275,121,69.44,30.56,92,93,77,64,174,64,9,0,0,0,110,120,10,0,39,256
1659,1632,27,1188,444,2001,921,132200,1565,94,94.33,5.67,1271,41,201,9,16,0,90,147,29,0,52,965,50,0,0,257
391,391,0,214,177,1962,833,96800,354,37,90.54,9.46,29,13,53,43,318,20,130,0,0,0,91,135,0,0,0,258
697,646,51,432,214,1959,525,99800,492,205,70.59,29.41,38,91,236,0,458,113,87,0,0,0,380,109,11,0,0,259
840,775,65,671,104,1984,1018,166900,733,107,87.26,12.74,266,183,186,123,70,0,68,10,19,0,58,395,130,32,11,260
675,675,0,535,140,1982,784,185900,564,111,83.56,16.44,276,201,212,22,12,0,56,9,0,0,31,627,0,0,0,261
865,688,177,586,102,1974,933,239100,748,117,86.47,13.53,227,108,267,166,315,0,44,7,0,0,82,441,170,91,123,262
536,465,71,202,263,1990,897,0,88,448,16.42,83.58,227,83,168,46,69,118,239,14,0,0,120,57,0,0,0,263
489,333,156,300,33,1977,0,206300,411,78,84.05,15.95,169,98,81,49,104,0,8,0,9,0,27,193,105,45,0,264
466,292,174,248,44,1988,0,196900,289,177,62.02,37.98,105,123,59,76,153,39,0,0,0,0,28,146,52,9,11,265
278,241,37,109,132,1963,873,181500,261,17,93.88,6.12,0,40,107,45,59,23,84,0,0,0,13,80,0,0,0,266
374,354,20,210,144,1974,286,130000,229,145,61.23,38.77,10,47,167,77,54,122,66,0,0,0,110,43,0,0,0,267
485,485,0,289,196,1981,775,153000,380,105,78.35,21.65,159,0,133,68,35,57,6,0,0,0,81,214,37,0,0,268
534,464,70,298,166,1974,577,108800,298,236,55.81,44.19,92,52,121,58,233,61,108,9,0,0,155,123,0,0,29,269
777,595,182,520,75,1984,565,176400,541,236,69.63,30.37,148,324,166,9,186,37,36,0,0,0,150,370,11,41,0,270
399,233,166,179,54,1979,454,180700,310,89,77.69,22.31,154,55,47,19,143,24,28,0,0,0,22,98,40,0,22,271
923,770,153,421,349,1981,686,247300,619,304,67.06,32.94,428,83,81,25,108,46,115,74,31,0,14,101,123,55,106,272
419,364,55,96,268,1974,558,61600,69,350,16.47,83.53,53,43,266,62,27,106,241,0,0,0,73,13,0,0,0,273
310,263,47,239,24,1975,713,167900,256,54,82.58,17.42,79,48,79,47,139,21,35,0,0,0,69,195,0,0,0,274
511,423,88,308,115,1965,680,138800,419,92,82.00,18.00,65,26,48,23,223,17,17,0,0,0,156,140,5,0,6,275
278,237,41,116,121,1960,598,73500,211,67,75.90,24.10,87,10,22,68,178,32,20,0,0,0,119,117,0,0,0,276
657,514,143,451,63,1989,675,231000,513,144,78.08,21.92,392,31,161,107,36,119,24,0,0,0,105,190,128,43,12,277
359,317,42,174,143,1973,703,226500,219,140,61.00,39.00,85,26,148,172,68,44,66,0,10,0,0,223,79,0,0,278
324,308,16,177,131,1964,0,86800,232,92,71.60,28.40,47,10,97,50,157,76,112,13,0,0,71,47,0,0,0,279
440,374,66,312,62,1986,470,97500,344,96,78.18,21.82,156,128,36,52,52,0,27,0,0,0,130,139,12,0,0,280
301,301,0,105,196,1944,636,448100,133,168,44.19,55.81,82,46,26,0,123,50,120,0,0,0,0,39,42,14,12,281
621,529,92,249,280,1939,474,134800,430,191,69.24,30.76,0,0,0,53,588,112,141,0,0,0,71,206,5,0,0,282
343,343,0,230,113,1968,729,137800,286,57,83.38,16.62,108,0,96,96,98,0,62,0,0,0,94,220,0,0,22,283
1326,1211,115,747,464,1995,1023,0,557,769,42.01,57.99,928,90,133,55,69,0,336,179,0,0,409,235,17,0,26,284
748,748,0,168,580,1988,666,140300,326,422,43.58,56.42,445,171,47,36,127,134,268,41,0,0,35,198,0,0,0,285
2025,2025,0,1716,309,2000,1297,251200,1985,40,98.02,1.98,1591,34,498,8,0,25,23,336,0,0,0,733,663,182,38,286
780,780,0,302,478,1981,812,118700,370,410,47.44,52.56,359,139,262,19,0,0,198,27,0,0,163,258,47,0,0,287
408,333,75,135,198,1970,722,45900,217,191,53.19,46.81,175,54,88,0,127,71,187,0,0,0,93,40,0,0,0,288
1059,947,112,511,436,1988,682,140100,616,443,58.17,41.83,469,35,329,58,120,136,227,55,0,0,250,343,0,0,0,289
809,691,118,248,443,1974,825,110900,476,333,58.84,41.16,131,192,266,54,176,15,403,48,0,0,137,216,0,0,0,290
1326,1169,157,134,1035,1990,674,93600,332,994,25.04,74.96,592,100,381,65,135,217,577,16,0,0,58,156,0,0,0,291
404,366,38,165,201,1958,619,109000,277,127,68.56,31.44,16,39,72,113,139,49,48,0,0,0,117,105,9,0,0,292
665,573,92,242,331,1992,799,208000,269,396,40.45,59.55,252,129,143,0,180,44,357,24,0,0,36,153,46,0,0,293
273,273,0,197,76,1970,1160,242700,273,0,100.00,0.00,49,22,92,72,186,0,100,15,0,0,0,25,146,23,95,294
597,162,435,0,162,2003,0,0,30,567,5.03,94.97,161,42,64,12,0,21,0,100,71,0,0,0,0,0,0,295
368,368,0,260,108,1955,865,94300,351,17,95.38,4.62,13,0,0,60,312,0,107,0,0,0,211,12,0,0,0,296
568,487,81,456,31,1971,0,160500,568,0,100.00,0.00,81,126,152,118,110,0,9,0,0,0,18,408,76,28,11,297
928,830,98,290,540,1952,444,120500,478,450,51.51,48.49,36,109,211,59,630,285,270,9,0,0,151,138,9,0,0,298
876,435,441,296,139,1982,661,164500,742,134,84.70,15.30,226,73,135,50,283,6,49,18,0,0,57,120,89,9,35,299
647,484,163,238,246,1971,783,195500,410,237,63.37,36.63,47,40,72,59,196,27,171,0,0,0,59,109,36,0,0,300
479,479,0,402,77,1990,1129,172000,479,0,100.00,0.00,91,175,101,24,40,0,32,0,0,0,69,281,43,6,0,301
551,551,0,443,108,1965,0,149200,517,34,93.83,6.17,0,0,165,251,199,0,15,8,0,0,77,499,0,16,0,302
453,401,52,267,134,1975,812,90100,308,145,67.99,32.01,63,22,52,37,169,28,41,5,0,0,122,73,23,0,0,303
1322,391,931,327,64,1987,908,351900,1149,173,86.91,13.09,485,79,170,129,263,18,24,0,0,0,0,88,52,21,172,304
457,444,13,219,225,1970,587,137500,235,222,51.42,48.58,66,28,113,107,190,58,121,33,0,0,57,235,0,0,0,305
962,559,403,408,151,1979,559,159800,719,243,74.74,25.26,146,159,231,68,248,58,18,0,0,0,139,206,50,10,4,306
1139,1139,0,947,192,1994,1089,148200,1116,23,97.98,2.02,735,183,84,34,18,86,74,85,0,0,49,698,10,0,0,307
676,651,25,209,442,1944,649,78300,523,153,77.37,22.63,56,13,140,13,300,47,233,23,0,0,111,75,0,0,0,308
1024,577,447,378,199,1979,664,174600,758,266,74.02,25.98,342,106,218,86,195,43,33,5,0,0,64,211,155,0,41,309
350,315,35,257,58,1974,767,129200,240,110,68.57,31.43,67,66,48,37,146,15,32,5,0,0,101,112,27,23,11,310
366,274,92,241,33,1956,592,123400,311,55,84.97,15.03,78,28,79,18,194,22,6,0,0,0,110,114,12,2,4,311
394,394,0,282,112,1973,763,148500,338,56,85.79,14.21,37,0,31,28,224,0,37,0,0,0,82,180,21,0,0,312
1138,1138,0,1024,114,1997,1087,180200,1138,0,100.00,0.00,867,27,29,0,0,0,25,62,49,0,11,441,241,45,14,313
1123,1077,46,674,403,1995,1063,155300,1101,22,98.04,1.96,1025,48,16,32,0,0,122,65,49,0,9,708,44,0,0,314
545,476,69,326,150,1980,679,145600,472,73,86.61,13.39,102,80,106,72,89,20,25,7,0,0,61,271,16,0,0,315
934,317,617,289,28,1979,0,161200,698,236,74.73,25.27,312,192,176,67,166,10,0,0,0,0,25,91,75,36,64,316
405,330,75,195,135,1971,571,145800,381,24,94.07,5.93,209,17,149,0,158,25,65,36,0,0,45,87,53,75,6,317
375,342,33,329,13,1978,0,211200,301,74,80.27,19.73,177,90,82,15,101,0,0,0,0,0,52,148,93,12,27,318
773,663,110,529,134,2002,1167,216300,773,0,100.00,0.00,302,12,23,19,55,14,28,45,0,0,8,138,46,0,115,319
517,517,0,291,226,1977,634,132300,377,140,72.92,27.08,156,0,62,145,202,0,27,0,0,0,187,261,0,15,16,320
1409,516,893,232,284,1981,765,199300,1138,271,80.77,19.23,404,543,330,153,173,79,198,34,14,0,0,214,200,121,107,321
601,585,16,473,112,1981,2033,558000,571,30,95.01,4.99,133,105,262,80,0,0,0,47,0,0,0,14,85,93,309,322
669,407,262,281,126,1979,728,115700,473,196,70.70,29.30,125,130,117,63,198,38,90,4,0,0,86,80,49,12,14,323
624,538,86,503,35,1987,0,280400,563,61,90.22,9.78,360,96,151,39,74,20,45,12,0,0,10,194,159,65,162,324
368,347,21,291,56,1978,788,166200,276,92,75.00,25.00,118,18,84,21,111,4,24,8,0,0,21,143,57,34,5,325
653,593,60,261,332,1976,625,328200,356,297,54.52,45.48,173,111,255,30,62,50,248,2,0,0,0,27,128,47,116,326
375,375,0,351,24,2001,0,311200,358,17,95.47,4.53,292,9,84,9,0,0,0,0,0,0,14,106,141,32,66,327
509,483,26,354,129,1941,773,138700,444,65,87.23,12.77,46,0,30,11,288,31,70,0,0,0,39,235,0,0,0,328
855,834,21,796,38,1991,1080,192000,855,0,100.00,0.00,470,73,153,62,77,16,29,0,0,0,33,413,147,98,69,329
510,510,0,274,236,1989,716,91300,325,185,63.73,36.27,151,28,132,61,63,69,146,52,0,0,45,87,36,0,0,330
1223,1195,28,873,322,1992,447,112500,870,353,71.14,28.86,893,119,354,14,157,17,444,0,0,0,368,500,89,0,0,331
4067,4028,39,3076,952,2004,1146,193400,3859,208,94.89,5.11,2412,249,279,59,38,0,102,299,20,0,242,1220,877,130,49,332
444,403,41,283,120,1953,532,116900,395,49,88.96,11.04,14,0,81,143,195,12,42,10,0,0,133,187,0,0,13,333
535,535,0,396,139,1988,732,120900,408,127,76.26,23.74,372,118,113,24,32,10,31,68,0,0,94,291,0,0,0,334
1445,1445,0,1136,309,1984,851,52400,590,855,40.83,59.17,868,266,251,27,63,84,248,0,0,14,473,541,0,0,0,335
530,499,31,396,103,1972,692,129300,384,146,72.45,27.55,28,35,95,59,191,0,33,3,0,0,103,183,16,0,3,336
548,517,31,388,129,1976,583,96000,432,116,78.83,21.17,55,48,329,83,95,64,38,0,0,0,384,84,5,0,8,337
366,307,59,265,42,1957,567,107500,325,41,88.80,11.20,44,18,72,57,232,3,33,0,0,0,134,154,9,0,5,338
409,307,102,244,63,1979,1079,87500,254,155,62.10,37.90,163,86,80,4,35,0,55,0,0,0,81,86,4,3,16,339
2494,2249,245,636,1613,2005,648,174600,853,1641,34.20,65.80,1440,52,142,35,68,65,869,50,0,0,29,368,104,0,12,340
606,534,72,462,72,1993,1120,154500,535,71,88.28,11.72,339,178,78,0,0,51,30,11,0,0,8,456,39,0,0,341
241,241,0,176,65,1953,688,86000,241,0,100.00,0.00,0,0,17,57,225,48,53,0,0,0,117,46,0,0,0,342
909,808,101,653,155,1987,929,170500,629,280,69.20,30.80,612,122,137,54,85,26,131,72,0,0,121,341,189,28,28,343
674,522,152,391,131,1993,532,149700,601,73,89.17,10.83,274,94,79,0,263,9,0,0,0,0,142,223,45,0,6,344
605,505,100,235,270,1953,432,124300,408,197,67.44,32.56,54,119,67,32,114,22,105,0,0,0,60,53,0,7,12,345
640,558,82,389,169,1982,748,150900,354,286,55.31,44.69,306,83,250,32,28,33,89,16,0,0,136,207,59,14,0,346
490,405,85,296,109,1966,707,86500,353,137,72.04,27.96,36,55,78,71,301,34,23,0,0,0,199,149,8,0,0,347
1026,815,211,696,119,1994,950,197000,742,284,72.32,27.68,518,115,118,20,21,7,88,7,0,0,98,281,144,66,82,348
1163,228,935,153,75,1980,691,273600,1093,70,93.98,6.02,373,93,53,128,528,51,0,0,0,0,9,22,57,28,40,349
664,535,129,439,96,1979,0,224800,592,72,89.16,10.84,247,48,188,0,70,16,11,0,0,0,123,148,111,10,116,350
564,461,103,308,153,1980,894,300900,326,238,57.80,42.20,99,34,13,132,130,0,116,49,17,0,0,31,103,39,53,351
298,298,0,256,42,1973,644,218800,278,20,93.29,6.71,65,48,64,55,99,37,27,0,0,0,17,151,15,0,30,352
1074,1021,53,832,189,1995,817,157800,979,95,91.15,8.85,550,231,41,7,20,0,102,21,0,0,0,475,111,0,0,353
492,399,93,257,142,1973,525,134900,353,139,71.75,28.25,138,35,129,118,201,89,22,0,0,0,102,144,38,12,36,354
306,291,15,227,64,1966,657,125800,260,46,84.97,15.03,129,5,54,54,151,48,59,0,0,0,120,78,23,0,0,355
307,269,38,247,22,1974,733,101000,157,150,51.14,48.86,35,50,129,15,42,26,5,0,0,0,156,56,6,0,0,356
607,567,40,458,109,1976,734,162700,469,138,77.27,22.73,134,53,172,42,101,0,25,0,0,0,83,280,54,0,0,357
684,649,35,601,48,1998,1490,217200,684,0,100.00,0.00,389,58,79,17,0,0,17,0,0,0,14,308,143,27,0,358
756,730,26,495,235,1978,971,234100,647,109,85.58,14.42,136,224,279,73,0,0,101,0,0,0,0,314,124,64,44,359
244,234,10,199,35,1993,0,190800,194,50,79.51,20.49,51,62,154,22,58,29,41,0,0,0,87,144,28,18,0,360
835,747,88,221,526,1981,572,81000,362,473,43.35,56.65,346,79,209,41,82,106,154,23,0,0,271,161,0,0,10,361
399,384,15,260,124,1953,733,259000,396,3,99.25,0.75,146,38,46,48,155,27,43,2,0,0,29,132,54,24,42,362
427,427,0,338,89,1977,1063,157700,405,22,94.85,5.15,67,39,235,96,16,0,0,0,0,0,18,369,30,0,0,363
2109,1950,159,1222,728,1998,881,154000,1366,743,64.77,35.23,1489,214,207,52,36,59,558,161,0,0,92,751,295,0,0,364
1226,1226,0,836,390,1997,740,170800,954,272,77.81,22.19,824,101,240,15,18,0,178,145,0,0,14,736,110,0,0,365
772,699,73,578,121,1980,827,138900,762,10,98.70,1.30,189,69,315,9,57,0,76,6,0,0,229,269,59,0,0,366
469,307,162,292,15,1990,0,144200,402,67,85.71,14.29,156,125,77,80,39,0,12,0,0,0,17,186,29,40,113,367
467,314,153,139,175,1946,618,128100,304,163,65.10,34.90,33,27,64,67,362,114,38,13,0,0,57,111,31,0,5,368
687,612,75,554,58,1995,1356,145700,523,164,76.13,23.87,216,143,120,72,64,82,74,17,0,0,176,185,64,17,0,369
1983,1983,0,1757,226,2003,900,386300,1815,168,91.53,8.47,1273,73,136,39,105,0,73,11,29,6,39,183,179,262,672,370
473,473,0,453,20,1968,0,180400,446,27,94.29,5.71,0,0,281,340,13,0,40,14,0,0,22,408,38,0,0,371
1164,1164,0,953,211,2002,1359,150700,1083,81,93.04,6.96,766,21,109,0,0,0,25,95,9,0,24,464,199,0,36,372
433,417,16,341,76,1986,0,221900,375,58,86.61,13.39,102,33,163,43,156,84,40,0,0,0,81,204,7,0,0,373
617,593,24,560,33,1980,0,246200,561,56,90.92,9.08,307,0,198,59,45,59,51,16,0,0,44,122,245,36,6,374
967,371,596,293,78,1982,0,288800,800,167,82.73,17.27,408,171,73,145,143,0,0,25,0,0,46,110,255,41,68,375
502,471,31,388,83,1978,643,142400,445,57,88.65,11.35,96,32,186,33,96,0,5,0,0,0,59,306,23,23,5,376
1049,386,663,343,43,1987,734,293200,936,113,89.23,10.77,344,194,144,232,141,0,0,3,0,0,17,74,95,55,153,377
670,593,77,430,163,1971,592,90800,625,45,93.28,6.72,12,18,170,195,210,12,112,56,0,0,120,212,77,0,0,378
979,941,38,655,286,1975,710,140000,659,320,67.31,32.69,226,107,344,190,99,43,198,8,0,0,47,462,57,44,0,379
590,590,0,508,82,1975,0,196900,546,44,92.54,7.46,142,34,130,80,105,0,26,7,0,0,48,336,47,20,7,380
757,701,56,646,55,1994,1013,190700,707,50,93.39,6.61,285,12,210,25,36,0,43,0,0,0,80,343,72,12,0,381
369,306,63,193,113,1968,656,95000,320,49,86.72,13.28,50,3,62,42,181,9,31,0,0,0,124,87,12,0,10,382
999,999,0,866,133,2003,1225,219500,999,0,100.00,0.00,806,12,83,16,39,0,25,46,23,0,8,293,441,38,9,383
329,320,9,180,140,1951,499,123600,316,13,96.05,3.95,52,30,83,18,237,0,79,0,0,0,24,182,35,49,5,384
1704,1369,335,612,757,1990,651,113500,921,783,54.05,45.95,772,27,293,229,168,125,317,36,0,0,180,597,0,0,0,385
404,331,73,174,157,1980,766,156300,278,126,68.81,31.19,111,35,65,39,117,54,22,0,0,0,79,113,0,15,0,386
420,318,102,262,56,1980,900,206900,328,92,78.10,21.90,90,78,98,40,49,33,19,0,0,0,60,91,55,27,33,387
748,636,112,480,156,1997,656,222400,620,128,82.89,17.11,368,90,214,27,41,65,70,19,0,0,43,226,143,29,30,388
325,305,20,210,95,1970,442,169600,255,70,78.46,21.54,36,0,9,43,147,0,27,0,0,0,63,135,7,0,3,389
571,571,0,491,80,1983,1575,307600,558,13,97.72,2.28,216,88,143,31,59,0,33,43,0,0,0,182,80,66,133,390
673,595,78,487,108,1998,825,225000,529,144,78.60,21.40,298,77,49,26,13,13,0,0,0,0,31,140,111,77,69,391
884,639,245,496,143,1993,1213,252500,656,228,74.21,25.79,401,137,144,14,173,0,120,0,0,0,60,188,139,40,84,392
297,242,55,194,48,1989,603,172800,197,100,66.33,33.67,159,68,53,47,39,0,0,0,0,0,93,155,76,11,7,393
632,504,128,326,178,1961,588,94100,419,213,66.30,33.70,76,41,150,159,410,104,44,0,0,10,230,236,58,0,0,394
1847,1690,157,977,713,1996,861,213100,1158,689,62.70,37.30,1119,517,133,55,18,52,277,202,45,0,25,306,533,113,23,395
1015,923,92,677,246,1977,871,153300,998,17,98.33,1.67,306,43,190,141,172,0,58,11,12,0,114,496,81,0,0,396
255,227,28,133,94,1964,697,87400,202,53,79.22,20.78,13,15,43,21,177,20,34,0,0,0,69,102,3,0,0,397
562,562,0,486,76,1966,827,150500,485,77,86.30,13.70,29,149,123,45,353,13,89,8,0,0,113,349,0,18,0,398
512,396,116,305,91,1939,675,96500,487,25,95.12,4.88,9,29,56,59,375,70,155,0,0,0,149,126,5,0,0,399
429,366,63,295,71,1982,1039,190000,361,68,84.15,15.85,68,30,86,0,126,36,17,0,0,0,28,118,63,10,38,400
589,539,50,434,105,1994,745,142100,409,180,69.44,30.56,406,92,112,0,79,0,30,57,12,0,38,370,92,13,16,401
361,329,32,286,43,1972,383,92400,252,109,69.81,30.19,14,23,75,59,78,42,4,0,0,0,87,55,0,0,0,402
621,616,5,599,17,1999,0,243700,621,0,100.00,0.00,495,54,54,35,24,0,0,9,30,0,8,244,186,79,68,403
2069,1992,77,1276,716,2004,980,172600,1791,278,86.56,13.44,1006,130,192,78,73,0,160,79,0,0,119,511,257,45,95,404
1175,1121,54,748,373,1995,662,121800,996,179,84.77,15.23,685,28,143,79,126,0,149,50,0,0,24,700,79,0,0,405
1154,1115,39,671,444,1988,763,161300,712,442,61.70,38.30,510,211,254,14,40,0,157,86,0,0,135,410,80,33,49,406
387,374,13,239,135,1969,672,153900,212,175,54.78,45.22,111,45,47,35,241,86,17,44,0,0,110,193,29,0,0,407
363,363,0,271,92,1959,705,115400,299,64,82.37,17.63,52,11,164,52,243,74,119,19,0,0,89,149,16,0,0,408
1378,1208,170,279,929,1982,740,193500,438,940,31.79,68.21,515,285,354,61,365,145,810,31,38,50,13,142,95,26,0,409
1392,1392,0,462,930,1981,848,146100,732,660,52.59,47.41,525,42,323,230,197,14,717,30,11,27,24,418,67,9,0,410
334,220,114,159,61,1974,746,131000,200,134,59.88,40.12,97,50,34,21,167,0,9,0,0,0,81,182,25,0,0,411
216,184,32,123,61,1971,443,117000,132,84,61.11,38.89,31,10,83,11,70,21,22,0,0,0,60,19,26,0,19,412
491,445,46,374,71,1978,585,209900,471,20,95.93,4.07,134,76,60,66,148,10,72,0,0,0,57,270,67,0,8,413
817,368,449,271,97,1977,638,184000,686,131,83.97,16.03,160,108,138,79,247,18,45,6,0,0,50,98,19,6,39,414
352,320,32,253,67,1977,570,150500,286,66,81.25,18.75,41,0,208,41,64,3,16,22,0,0,168,122,4,0,0,415
426,343,83,179,164,1965,598,161700,363,63,85.21,14.79,40,21,77,84,180,19,45,0,0,0,55,98,8,0,0,416
569,543,26,464,79,1983,726,181000,498,71,87.52,12.48,191,72,189,113,20,25,134,6,0,0,18,328,27,0,38,417
1366,954,412,798,156,1987,1112,259200,1111,255,81.33,18.67,686,203,203,29,91,0,40,17,0,0,128,337,237,36,158,418
423,362,61,308,54,1976,675,119100,262,161,61.94,38.06,70,33,140,27,139,56,46,18,0,0,112,114,9,0,0,419
815,703,112,376,327,1979,654,97100,612,203,75.09,24.91,141,7,242,82,308,132,148,9,0,0,126,306,0,0,0,420
482,446,36,197,249,1951,476,99900,246,236,51.04,48.96,0,139,36,38,242,157,152,0,0,11,21,50,0,0,0,421
841,705,136,44,661,1993,605,0,125,716,14.86,85.14,149,173,206,45,33,228,132,29,33,0,12,60,0,0,0,422
549,515,34,225,290,1969,924,154800,385,164,70.13,29.87,56,44,72,41,255,76,139,15,0,0,13,204,21,0,0,423
514,514,0,71,443,1965,580,139900,120,394,23.35,76.65,63,71,9,0,211,108,113,60,24,0,0,32,0,0,17,424
625,572,53,132,440,1975,549,80300,262,363,41.92,58.08,145,51,67,30,241,192,104,0,0,0,105,94,0,29,0,425
489,489,0,473,16,1987,0,299600,428,61,87.53,12.47,288,124,57,26,25,0,0,57,11,0,15,62,122,97,123,426
668,668,0,203,465,1976,682,127500,345,323,51.65,48.35,40,52,121,26,415,13,301,0,0,0,46,241,0,12,0,427
1776,1714,62,1305,409,2001,781,163900,1170,606,65.88,34.12,1199,85,154,43,106,88,296,40,28,0,197,412,254,62,122,428
551,499,52,491,8,1974,0,188300,525,26,95.28,4.72,93,41,167,90,148,0,104,0,0,0,9,383,16,0,0,429
264,252,12,214,38,1956,585,92100,242,22,91.67,8.33,11,0,37,43,147,0,31,0,0,0,107,65,0,0,0,430
870,870,0,786,84,1987,1235,185800,854,16,98.16,1.84,440,232,161,98,189,7,133,0,0,0,36,725,115,18,0,431
530,530,0,408,122,1976,1189,148400,524,6,98.87,1.13,84,78,267,67,70,0,30,0,0,0,0,378,91,0,0,432
813,724,89,313,411,1979,704,171600,440,373,54.12,45.88,124,64,405,152,46,64,192,0,0,0,13,448,61,0,0,433
964,905,59,817,88,1992,957,146700,899,65,93.26,6.74,442,146,192,9,71,0,77,41,0,0,45,527,122,0,31,434
452,426,26,305,121,1958,479,95500,319,133,70.58,29.42,124,16,66,18,192,91,116,0,0,0,91,82,0,0,0,435
766,720,46,428,292,1983,710,547300,532,234,69.45,30.55,301,93,41,13,351,0,197,113,0,0,34,21,62,45,265,436
474,398,76,310,88,1968,602,148400,375,99,79.11,20.89,223,30,116,105,151,0,60,0,0,0,50,246,128,23,55,437
326,326,0,239,87,1976,558,126100,267,59,81.90,18.10,158,10,122,53,96,27,52,0,0,0,15,145,30,30,10,438
605,605,0,237,368,2000,661,230300,238,367,39.34,60.66,555,22,51,13,20,26,360,0,0,0,90,89,73,0,0,439
1010,990,20,922,68,1997,740,184700,970,40,96.04,3.96,534,26,242,71,76,57,10,0,0,0,59,574,171,9,0,440
583,583,0,583,0,1993,0,453300,569,14,97.60,2.40,371,70,127,65,57,0,15,0,0,0,23,33,118,102,258,441
1666,1430,236,1016,414,2000,1008,138800,1542,124,92.56,7.44,1185,15,36,0,110,0,242,61,0,0,48,868,98,0,0,442
598,521,77,230,291,1971,622,76300,300,298,50.17,49.83,118,78,316,62,289,186,267,0,0,0,228,49,10,0,0,443
650,477,173,390,87,1988,0,401700,537,113,82.62,17.38,239,192,61,15,36,0,34,0,0,0,17,102,74,77,111,444
512,453,59,390,63,1990,0,243500,487,25,95.12,4.88,310,61,90,0,70,0,8,0,0,0,0,106,37,83,105,445
598,459,139,383,76,1945,820,118500,586,12,97.99,2.01,136,0,63,29,379,5,71,8,0,0,207,251,5,0,3,446
1212,1212,0,635,577,1995,684,195000,636,576,52.48,47.52,591,290,93,194,205,71,523,61,0,0,80,357,91,0,0,447
653,592,61,360,232,1977,553,99500,426,227,65.24,34.76,202,55,119,97,174,114,20,0,0,0,290,179,44,0,0,448
510,422,88,283,139,1987,780,233400,348,162,68.24,31.76,59,33,74,9,202,0,14,0,0,0,21,202,114,9,0,449
444,444,0,444,0,1972,0,163500,407,37,91.67,8.33,87,28,44,87,118,10,31,0,0,0,0,304,19,0,0,450
1993,1845,148,1407,438,2002,1121,155100,1756,237,88.11,11.89,1730,72,108,55,41,0,105,79,0,0,51,1069,503,56,0,451
407,320,87,271,49,1972,585,108500,332,75,81.57,18.43,60,29,76,19,202,11,17,0,0,0,100,101,38,5,15,452
298,257,41,160,97,1961,631,109500,220,78,73.83,26.17,15,0,66,29,175,12,48,0,0,0,92,70,12,0,0,453
1314,959,355,861,98,1991,1097,191800,1164,150,88.58,11.42,365,344,180,93,25,0,0,28,0,0,155,378,197,99,26,454
409,326,83,216,110,1973,642,129600,272,137,66.50,33.50,98,64,90,64,129,56,59,13,0,0,87,112,35,5,6,455
508,498,10,436,62,1986,677,183100,401,107,78.94,21.06,130,8,123,25,180,15,12,0,0,0,106,131,72,51,17,456
923,459,464,351,108,1985,725,265200,752,171,81.47,18.53,283,299,244,29,171,6,31,11,0,0,15,188,185,9,179,457
1382,1359,23,976,383,1998,747,127100,1245,137,90.09,9.91,713,70,223,9,72,59,221,35,0,0,119,459,51,0,13,458
527,508,19,447,61,1986,574,144300,429,98,81.40,18.60,106,35,138,44,169,14,24,8,0,0,101,209,49,0,0,459
591,551,40,441,110,1955,632,129400,530,61,89.68,10.32,28,34,79,68,315,0,75,0,0,0,143,265,0,0,0,460
569,420,149,280,140,1975,631,159900,440,129,77.33,22.67,206,32,87,40,192,32,33,0,0,0,101,164,51,19,14,461
2319,579,1740,491,88,1978,1116,677300,861,1458,37.13,62.87,349,468,962,362,83,0,65,9,0,10,18,36,22,38,269,462
311,280,31,151,129,1992,766,537700,151,160,48.55,51.45,140,24,71,0,25,0,81,0,0,0,15,11,96,46,11,463
1107,1100,7,777,323,1994,713,215800,842,265,76.06,23.94,706,207,103,54,75,122,178,60,0,0,229,234,154,39,41,464
953,906,47,759,147,1990,919,134800,831,122,87.20,12.80,377,76,229,42,173,0,36,14,0,0,146,485,108,0,0,465
786,673,113,36,637,1996,654,666700,98,688,12.47,87.53,392,0,0,17,185,79,345,27,0,0,0,23,17,0,37,466
362,314,48,286,28,1975,0,273500,311,51,85.91,14.09,108,26,96,13,108,0,0,64,0,0,17,151,56,30,10,467
659,540,119,408,132,1985,650,155600,457,202,69.35,30.65,199,93,100,66,99,51,49,0,0,0,128,162,73,10,13,468
681,602,79,98,504,1971,745,180800,421,260,61.82,38.18,104,107,176,23,370,65,297,31,0,0,39,332,0,0,0,469
353,277,76,187,90,1955,729,95800,281,72,79.60,20.40,36,0,81,0,340,20,51,0,0,0,144,148,0,0,0,470
164,135,29,125,10,1976,0,148000,132,32,80.49,19.51,67,17,22,7,46,7,0,0,0,0,39,61,22,0,0,471
520,481,39,279,202,1970,484,70300,213,307,40.96,59.04,149,40,67,46,230,71,239,0,0,0,95,127,0,0,0,472
427,427,0,337,90,1967,808,149700,427,0,100.00,0.00,124,7,53,50,205,0,35,0,0,0,102,259,43,0,0,473
748,408,340,353,55,1972,0,301400,571,177,76.34,23.66,172,111,260,32,94,0,46,0,0,0,44,160,51,13,11,474
334,318,16,201,117,1973,735,125500,208,126,62.28,37.72,64,55,63,29,180,51,41,7,0,0,56,182,12,0,0,475
866,707,159,600,107,1991,769,298700,735,131,84.87,15.13,315,72,59,142,83,26,0,0,0,0,20,190,113,42,148,476
357,344,13,317,27,1977,425,121400,235,122,65.83,34.17,137,78,55,19,49,0,0,0,0,0,177,133,21,0,0,477
544,429,115,358,71,1979,0,130200,302,242,55.51,44.49,82,169,65,0,37,0,0,0,0,0,92,74,12,0,0,478
421,380,41,188,192,1972,652,100400,289,132,68.65,31.35,57,7,112,57,191,47,59,33,0,0,101,108,10,0,0,479
1260,1186,74,380,806,1991,984,278000,554,706,43.97,56.03,589,430,46,15,13,26,283,143,24,40,12,169,159,84,76,480
402,391,11,312,79,1977,648,179900,325,77,80.85,19.15,226,47,98,16,187,0,64,0,0,0,101,250,26,8,0,481
379,338,41,211,127,1967,653,151700,296,83,78.10,21.90,54,39,53,58,140,15,32,0,0,0,62,103,22,6,5,482
371,300,71,199,101,1977,460,145200,283,88,76.28,23.72,42,40,103,44,103,42,34,0,0,0,86,80,26,6,0,483
710,643,67,450,193,1976,1019,125000,537,173,75.63,24.37,123,50,53,6,218,26,24,0,0,0,47,263,36,0,0,484
237,237,0,237,0,1970,0,116200,237,0,100.00,0.00,15,0,60,153,26,0,0,10,0,0,31,201,12,0,0,485
236,222,14,98,124,1951,688,97200,208,28,88.14,11.86,13,14,36,22,235,40,37,0,0,15,69,66,14,0,0,486
799,799,0,732,67,1992,0,160300,634,165,79.35,20.65,329,86,134,11,96,15,31,24,17,0,61,273,160,39,18,487
1834,1684,150,1621,63,1998,0,197200,1822,12,99.35,0.65,1410,28,60,0,25,0,34,91,32,10,34,546,497,127,65,488
316,295,21,182,113,1958,699,116200,213,103,67.41,32.59,96,0,40,22,174,52,66,0,0,0,47,116,0,13,0,489
330,330,0,251,79,1957,513,132700,261,69,79.09,20.91,23,0,6,61,196,10,95,6,0,0,76,99,0,0,0,490
878,700,178,203,497,1987,685,56800,100,778,11.39,88.61,496,51,241,24,38,54,561,0,0,0,152,83,0,0,0,491
882,840,42,608,232,1980,735,169800,663,219,75.17,24.83,125,184,410,62,20,0,108,18,0,0,61,438,124,0,10,492
418,323,95,286,37,1975,643,153900,370,48,88.52,11.48,48,21,131,26,122,0,33,0,0,0,42,169,7,0,0,493
4421,4152,269,3046,1106,2003,850,112100,3984,437,90.12,9.88,3189,179,66,80,96,18,412,176,7,0,637,1746,111,15,16,494
482,482,0,356,126,1974,1101,123800,434,48,90.04,9.96,55,58,274,104,12,40,95,35,0,0,11,276,14,0,24,495
657,601,56,485,116,1974,276,139300,518,139,78.84,21.16,98,90,57,41,291,48,26,0,0,0,105,234,43,0,0,496
225,199,26,168,31,1977,672,190000,175,50,77.78,22.22,88,15,72,42,101,35,75,0,0,0,63,65,40,0,30,497
854,854,0,769,85,1982,827,277200,815,39,95.43,4.57,232,134,306,28,164,35,110,37,0,0,22,286,170,59,72,498
762,630,132,373,257,1939,789,233600,515,247,67.59,32.41,71,58,63,82,455,77,161,101,0,0,11,111,74,86,27,499
331,331,0,268,63,1955,0,115700,322,9,97.28,2.72,29,15,8,44,124,0,12,0,0,0,64,62,19,0,0,500
674,625,49,389,236,1975,621,116800,384,290,56.97,43.03,163,194,209,175,95,101,247,0,0,0,157,192,14,0,0,501
1270,769,501,574,195,1987,1622,657300,1013,257,79.76,20.24,415,305,361,35,20,22,71,20,0,0,92,8,0,14,360,502
579,505,74,317,188,1976,753,99600,510,69,88.08,11.92,213,13,98,54,148,0,32,11,0,0,148,257,66,0,12,503
526,526,0,328,198,1973,740,95200,435,91,82.70,17.30,183,79,97,56,298,0,140,0,0,0,114,403,9,10,0,504
548,490,58,299,191,1978,695,168800,349,199,63.69,36.31,34,46,91,57,125,20,60,0,0,0,61,83,39,14,0,505
445,357,88,274,83,1972,0,204000,402,43,90.34,9.66,176,18,68,22,101,0,34,27,0,0,9,143,67,0,32,506
690,549,141,497,52,1996,952,231900,621,69,90.00,10.00,221,17,65,58,123,14,3,5,0,0,3,144,150,61,45,507
685,664,21,645,19,1993,0,323300,685,0,100.00,0.00,185,74,179,91,25,0,0,0,0,0,23,151,133,72,117,508
806,725,81,614,111,1991,680,244100,695,111,86.23,13.77,406,48,113,49,48,34,46,3,38,0,43,161,166,58,82,509
460,381,79,285,96,1984,518,152200,338,122,73.48,26.52,125,86,79,24,153,56,30,8,0,0,142,111,54,0,0,510
1041,835,206,613,222,1996,735,132500,1008,33,96.83,3.17,371,49,49,62,301,102,66,35,0,0,167,381,6,0,0,511
559,421,138,265,156,1984,700,90700,431,128,77.10,22.90,143,12,122,119,176,76,78,37,0,0,169,149,12,0,0,512
867,821,46,380,441,2000,606,143700,540,327,62.28,37.72,330,89,195,93,105,143,167,16,0,0,53,303,6,0,0,513
424,386,38,186,200,1954,640,107600,330,94,77.83,22.17,61,0,0,35,407,15,109,60,0,0,105,108,0,0,0,514
525,494,31,314,180,1988,703,159200,299,226,56.95,43.05,68,97,123,48,171,65,112,0,0,0,45,118,46,0,26,515
810,740,70,516,224,1983,800,189700,633,177,78.15,21.85,154,81,144,65,194,0,65,5,0,5,34,337,99,39,8,516
795,757,38,655,102,1979,852,265600,719,76,90.44,9.56,335,33,130,104,116,0,85,84,0,0,22,174,177,86,54,517
868,797,71,661,136,1987,1051,369900,803,65,92.51,7.49,178,205,251,67,68,0,13,34,0,0,6,131,151,112,260,518
1152,1051,101,850,201,1996,1267,198100,1040,112,90.28,9.72,846,17,235,64,20,0,142,73,0,0,44,460,289,68,97,519
731,683,48,554,129,1989,955,243800,563,168,77.02,22.98,254,90,228,0,0,10,68,16,0,0,94,130,61,34,127,520
976,594,382,488,106,1993,1147,375600,894,82,91.60,8.40,337,85,74,34,109,7,33,0,0,0,19,84,84,75,155,521
1006,974,32,711,263,1991,735,230100,654,352,65.01,34.99,628,192,214,12,141,54,136,15,10,0,217,170,268,128,117,522
2777,2472,305,1685,787,2003,680,168700,2204,573,79.37,20.63,1062,120,429,49,83,87,165,130,0,0,85,830,236,10,71,523
373,257,116,232,25,1981,0,188000,324,49,86.86,13.14,80,77,46,56,239,0,11,0,0,0,77,235,26,0,0,524
1427,1139,288,778,361,1999,1010,155800,965,462,67.62,32.38,676,120,242,49,105,13,116,13,0,0,107,591,101,0,0,525
819,467,352,387,80,1981,1074,224400,731,88,89.26,10.74,207,152,109,38,141,0,0,0,0,0,65,170,209,57,44,526
453,360,93,258,102,1984,767,170000,322,131,71.08,28.92,165,73,126,0,146,38,9,44,0,0,8,196,27,9,47,527
1243,337,906,250,87,1992,1075,233300,727,516,58.49,41.51,501,160,136,31,51,0,25,0,0,0,14,128,116,27,73,528
487,388,99,174,214,1951,629,89700,417,70,85.63,14.37,77,13,51,66,247,50,63,8,0,0,90,91,22,2,0,529
635,506,129,471,35,1997,0,395100,606,29,95.43,4.57,292,140,91,95,124,10,116,0,0,0,12,109,94,38,161,530
2230,1972,258,1514,458,1993,1255,334800,1930,300,86.55,13.45,1172,302,214,22,86,0,98,12,49,0,33,165,781,296,269,531
533,419,114,308,111,1978,701,135000,370,163,69.42,30.58,201,75,147,58,305,70,19,0,0,0,61,104,117,23,24,532
437,332,105,119,213,1971,658,69000,314,123,71.85,28.15,70,39,154,78,85,0,141,0,0,0,54,72,43,0,0,533
622,293,329,248,45,1987,0,218400,585,37,94.05,5.95,157,58,145,77,119,32,36,0,0,0,14,197,28,32,86,534
407,155,252,123,32,1973,588,123200,326,81,80.10,19.90,103,34,50,19,156,13,10,0,0,0,40,63,7,0,17,535
377,359,18,129,230,1981,706,161600,228,149,60.48,39.52,99,0,50,46,60,43,40,0,0,0,28,37,32,0,22,536
216,187,29,126,61,1987,0,111200,178,38,82.41,17.59,123,19,28,50,0,0,36,0,0,0,34,47,27,26,0,537
409,362,47,246,116,1973,575,121200,353,56,86.31,13.69,68,26,67,28,237,14,27,0,0,0,105,150,21,9,13,538
688,639,49,621,18,2001,0,175200,589,99,85.61,14.39,189,13,227,24,135,27,50,0,0,0,5,339,64,57,8,539
353,320,33,249,71,1973,485,162700,238,115,67.42,32.58,30,8,82,46,116,27,6,2,0,0,23,144,48,2,0,540
1000,956,44,928,28,1979,0,190100,987,13,98.70,1.30,529,49,472,0,0,0,14,32,0,0,0,498,351,38,47,541
600,565,35,477,88,1968,718,196400,557,43,92.83,7.17,166,91,80,46,144,24,78,0,0,0,92,128,112,18,47,542
357,314,43,236,78,1961,678,84100,231,126,64.71,35.29,30,19,172,8,211,75,63,0,0,0,175,59,10,0,0,543
506,402,104,311,91,1982,874,324300,492,14,97.23,2.77,169,44,108,15,163,9,57,0,9,0,33,234,69,10,0,544
339,339,0,233,106,1953,1085,186200,339,0,100.00,0.00,40,0,57,16,152,0,0,94,0,0,0,121,50,0,0,545
817,817,0,541,276,1989,1270,141000,817,0,100.00,0.00,673,232,121,0,0,0,13,52,11,0,0,839,42,0,0,546
939,892,47,678,214,1987,744,165200,684,255,72.84,27.16,218,156,252,80,184,157,41,0,0,0,156,345,102,15,0,547
375,338,37,213,125,1978,474,162500,146,229,38.93,61.07,51,10,126,124,50,51,60,0,0,0,100,41,13,8,22,548
342,316,26,237,79,1974,432,120400,255,87,74.56,25.44,62,83,108,49,110,26,85,0,0,0,73,180,15,0,0,549
395,303,92,240,63,1979,908,71200,212,183,53.67,46.33,214,37,85,49,31,0,163,18,0,0,48,57,14,0,15,550
453,453,0,349,104,1986,895,170600,391,62,86.31,13.69,142,107,237,68,42,24,154,18,0,0,38,188,111,0,0,551
394,348,46,322,26,1979,0,171900,256,138,64.97,35.03,49,35,172,15,76,0,6,0,0,0,10,183,45,23,21,552
1299,1250,49,799,451,1993,803,168900,931,368,71.67,28.33,603,115,279,114,158,0,150,235,0,0,45,615,176,0,0,553
298,298,0,276,22,1975,0,193500,276,22,92.62,7.38,128,23,73,106,150,53,87,23,12,0,8,233,42,0,8,554
363,292,71,223,69,1957,807,120600,266,97,73.28,26.72,33,20,77,165,187,41,67,3,0,0,109,133,32,0,0,555
717,682,35,630,52,1980,594,178800,717,0,100.00,0.00,259,60,412,0,12,0,14,0,0,0,51,336,226,71,45,556
742,645,97,425,220,1982,758,119800,502,240,67.65,32.35,56,128,205,127,71,49,143,0,0,0,90,227,0,0,0,557
701,611,90,598,13,1981,0,167300,688,13,98.15,1.85,257,117,249,0,0,0,0,0,20,0,32,464,99,0,0,558
585,501,84,443,58,1991,497,164400,530,55,90.60,9.40,254,43,167,0,144,31,84,0,0,0,33,412,13,16,19,559
1041,746,295,281,465,1957,641,112900,569,472,54.66,45.34,40,50,274,145,549,123,279,89,0,0,255,88,0,0,0,560
429,327,102,254,73,1952,0,110000,410,19,95.57,4.43,13,13,21,31,326,0,51,0,0,0,79,228,0,0,0,561
384,352,32,296,56,1975,0,150000,285,99,74.22,25.78,96,15,46,29,160,38,4,0,0,0,128,142,14,0,0,562
734,734,0,521,213,1977,793,136300,734,0,100.00,0.00,217,32,472,34,21,0,78,48,0,0,148,417,30,0,0,563
591,477,114,239,238,1974,592,133600,235,356,39.76,60.24,97,15,258,135,55,61,191,0,0,0,91,193,0,0,0,564
362,314,48,184,130,1958,652,89500,273,89,75.41,24.59,0,42,74,124,167,52,52,0,0,0,162,100,0,0,0,565
549,510,39,230,280,1986,717,89600,253,296,46.08,53.92,139,66,55,29,73,9,32,42,0,0,59,99,24,14,0,566
1006,966,40,852,114,2001,1399,249100,1006,0,100.00,0.00,888,82,0,0,26,0,0,45,26,0,16,303,408,75,123,567
355,336,19,151,185,1980,653,107800,257,98,72.39,27.61,73,0,134,36,60,14,52,0,0,0,76,120,18,0,0,568
250,201,49,130,71,1978,708,143200,194,56,77.60,22.40,6,30,64,34,187,0,7,0,0,0,71,21,41,0,0,569
590,537,53,305,232,1966,459,82100,367,223,62.20,37.80,45,80,100,10,248,33,156,0,0,0,225,50,0,0,0,570
494,423,71,214,209,1977,715,142200,224,270,45.34,54.66,124,126,120,22,140,11,182,0,0,0,122,54,17,0,0,571
510,510,0,155,355,1974,715,101100,203,307,39.80,60.20,79,89,271,91,166,20,273,0,0,0,252,42,0,0,0,572
990,969,21,816,153,2003,0,232400,883,107,89.19,10.81,472,68,25,0,152,0,15,53,0,0,0,201,114,92,156,573
1575,1559,16,1302,257,1997,1127,300000,1483,92,94.16,5.84,1200,119,132,0,0,0,90,55,14,9,46,402,466,244,77,574
431,431,0,393,38,2003,1672,415900,431,0,100.00,0.00,216,43,73,0,24,0,0,0,0,0,24,45,79,87,91,575
561,518,43,474,44,1976,639,172800,508,53,90.55,9.45,142,44,155,31,123,0,32,0,0,0,89,287,51,10,17,576
388,334,54,303,31,1977,634,174700,338,50,87.11,12.89,118,47,54,46,117,0,12,0,0,0,57,236,31,22,0,577
424,394,30,322,72,1981,797,165600,369,55,87.03,12.97,136,27,76,53,81,9,26,0,0,0,82,171,33,0,16,578
863,828,35,777,51,1984,910,170900,856,7,99.19,0.81,234,62,145,88,147,0,45,0,0,0,44,385,103,17,0,579
545,449,96,308,141,1957,913,111900,526,19,96.51,3.49,33,24,56,48,319,6,19,42,0,0,83,303,7,0,0,580
318,234,84,204,30,1951,775,91800,251,67,78.93,21.07,0,0,47,24,259,0,79,37,0,0,92,122,0,0,0,581
333,299,34,234,65,1955,1069,113800,333,0,100.00,0.00,0,22,46,0,208,0,69,0,0,0,65,110,32,0,0,582
456,363,93,108,255,1939,571,0,160,296,35.09,64.91,14,27,40,38,399,57,172,30,0,0,31,130,0,0,0,583
153,153,0,41,112,1939,560,127100,65,88,42.48,57.52,37,40,0,10,150,47,12,0,0,0,50,0,0,0,0,584
710,684,26,570,114,1978,1135,161100,685,25,96.48,3.52,66,138,280,53,29,0,49,0,0,0,0,406,27,18,10,585
701,701,0,599,102,1979,960,186900,684,17,97.57,2.43,129,207,368,20,7,11,14,43,0,0,23,465,97,11,29,586
169,169,0,152,17,1973,0,219600,144,25,85.21,14.79,33,65,91,49,42,8,81,0,11,0,19,97,0,0,0,587
1466,1428,38,647,781,1991,841,121600,565,901,38.54,61.46,747,374,154,242,43,63,559,71,0,0,153,394,27,0,13,588
3569,3410,159,3062,348,2004,1185,296600,3526,43,98.80,1.20,2879,52,66,59,12,0,46,182,18,40,30,661,1003,301,436,589
1075,1018,57,527,491,1994,816,134300,682,393,63.44,36.56,667,55,88,15,180,114,288,41,0,0,85,344,27,0,0,590
1511,1353,158,1159,194,1992,1155,252200,1428,83,94.51,5.49,901,259,247,89,39,0,0,60,14,0,128,381,532,239,181,591
1236,1029,207,113,916,1993,575,115800,173,1063,14.00,86.00,402,70,140,50,392,269,427,45,0,0,14,42,45,0,13,592
1412,1369,43,954,415,1990,844,165700,1143,269,80.95,19.05,481,556,157,57,59,0,229,104,0,0,29,781,138,0,13,593
741,616,125,85,531,1939,574,309600,230,511,31.04,68.96,23,26,68,81,701,211,414,0,0,0,12,30,11,0,0,594
464,464,0,168,296,1951,634,192300,288,176,62.07,37.93,52,17,82,118,271,71,141,15,0,0,0,138,26,0,0,595
433,433,0,300,133,1960,813,174100,384,49,88.68,11.32,141,11,121,38,270,11,267,0,0,0,0,119,74,24,0,596
594,594,0,452,142,1978,902,179700,551,43,92.76,7.24,126,38,432,36,32,26,207,54,0,0,13,145,81,13,9,597
359,359,0,244,115,1967,544,450000,273,86,76.04,23.96,18,21,79,47,193,13,61,10,0,0,0,69,68,74,63,598
669,578,91,348,230,1961,821,242100,589,80,88.04,11.96,102,27,53,16,249,0,40,34,0,0,0,125,153,22,59,599
433,399,34,242,157,1939,848,281900,344,89,79.45,20.55,35,0,0,34,297,21,67,11,0,0,0,73,63,68,15,600
1025,920,105,298,622,1971,759,247000,404,621,39.41,60.59,128,127,300,78,536,83,641,0,0,0,0,107,138,13,99,601
647,598,49,352,246,1979,895,183300,476,171,73.57,26.43,59,209,268,57,91,0,84,17,0,0,0,352,124,16,0,602
283,283,0,22,261,1977,751,0,158,125,55.83,44.17,13,33,17,78,195,25,154,11,0,0,0,94,0,0,0,603
547,536,11,402,134,1965,1045,145600,464,83,84.83,15.17,179,17,106,14,320,0,124,74,0,0,42,281,30,0,35,604
1012,1012,0,290,722,1973,659,228900,311,701,30.73,69.27,394,42,122,210,281,273,412,34,0,0,65,78,24,0,41,605
697,697,0,501,196,1977,855,110000,471,226,67.58,32.42,38,138,423,22,38,0,228,13,0,0,29,366,11,0,0,606
615,587,28,393,194,1964,1032,138200,531,84,86.34,13.66,94,9,127,180,205,32,102,0,0,0,33,343,18,10,0,607
294,294,0,138,156,1958,799,114400,266,28,90.48,9.52,84,0,15,29,249,0,104,16,0,0,53,174,0,0,0,608
395,351,44,314,37,1965,806,154000,395,0,100.00,0.00,24,0,30,135,123,11,29,17,0,0,0,229,13,13,0,609
549,387,162,212,175,1973,697,134700,332,217,60.47,39.53,58,40,118,88,75,7,70,24,0,0,44,139,7,0,0,610
1505,1505,0,984,521,1987,760,120100,990,515,65.78,34.22,535,385,321,34,14,64,255,70,0,0,98,714,0,0,0,611
865,736,129,608,128,1987,1097,166100,632,233,73.06,26.94,353,88,197,83,14,8,183,88,17,0,16,222,128,26,0,612
222,215,7,73,142,1990,500,144500,152,70,68.47,31.53,39,11,43,122,31,26,0,0,0,0,13,26,0,36,0,613
2393,2147,246,1955,192,2003,1292,310000,2194,199,91.68,8.32,1455,84,322,40,58,0,62,58,0,0,129,349,631,309,348,614
539,274,265,171,103,1972,528,97300,356,183,66.05,33.95,128,22,130,34,208,40,31,0,0,0,157,63,39,0,0,615
462,390,72,270,120,1978,568,131300,289,173,62.55,37.45,113,13,35,38,145,3,22,0,0,0,77,144,26,7,13,616
560,460,100,356,104,1970,571,147100,451,109,80.54,19.46,172,56,75,8,202,3,41,3,0,0,182,123,43,15,18,617
731,586,145,399,187,1974,608,120800,495,236,67.72,32.28,279,58,146,169,233,32,101,0,0,0,126,287,100,7,12,618
657,635,22,465,170,1974,472,143400,484,173,73.67,26.33,170,41,117,71,135,21,108,16,0,0,71,266,32,0,0,619
632,632,0,516,116,1966,843,134700,602,30,95.25,4.75,93,43,82,180,238,79,53,0,0,0,82,333,28,15,0,620
637,598,39,453,145,1979,516,161000,470,167,73.78,26.22,272,66,93,81,171,49,83,0,0,0,148,223,52,23,0,621
364,364,0,251,113,1975,906,144400,287,77,78.85,21.15,46,14,150,21,111,22,23,0,0,0,103,46,16,12,0,622
453,367,86,287,80,1971,539,190600,361,92,79.69,20.31,118,90,147,43,32,53,47,10,0,0,9,163,46,0,57,623
1828,1572,256,1156,416,2002,1190,198800,1344,484,73.52,26.48,998,115,137,71,56,96,106,13,18,56,35,623,234,67,98,624
534,471,63,350,121,1994,638,217000,407,127,76.22,23.78,190,56,108,0,198,0,55,0,0,0,158,118,87,15,59,625
358,337,21,314,23,1978,0,152700,247,111,68.99,31.01,177,14,130,50,147,14,0,0,0,0,87,207,67,0,19,626
503,495,8,436,59,1987,0,172200,466,37,92.64,7.36,134,36,83,35,88,0,14,0,0,0,125,129,67,0,11,627
970,839,131,586,253,1998,856,180200,783,187,80.72,19.28,307,52,83,116,172,0,91,0,0,12,81,428,57,0,6,628
601,534,67,218,316,1972,567,121400,347,254,57.74,42.26,136,53,88,22,200,43,112,15,0,0,186,37,10,19,14,629
1259,1166,93,1153,13,2001,0,172500,1128,131,89.59,10.41,902,85,195,70,64,119,36,49,0,0,166,524,257,6,19,630
688,644,44,515,129,1979,786,139500,512,176,74.42,25.58,245,84,89,26,172,23,33,14,0,0,199,154,93,10,12,631
1048,891,157,502,389,1960,699,281500,654,394,62.40,37.60,247,18,69,109,521,62,362,63,0,0,16,171,86,23,70,632
307,287,20,201,86,1954,740,141700,256,51,83.39,16.61,85,10,84,17,218,28,172,38,0,8,27,94,6,15,0,633
444,340,104,272,68,1942,603,74300,386,58,86.94,13.06,15,14,73,31,389,67,45,8,0,0,148,113,11,0,13,634
261,210,51,165,45,1948,0,180300,208,53,79.69,20.31,51,48,74,24,76,0,37,0,0,0,0,185,0,32,10,635
424,372,52,194,178,1954,635,62700,234,190,55.19,44.81,29,32,59,75,182,30,75,0,0,0,112,94,7,0,0,636
565,392,173,214,178,1939,638,86000,412,153,72.92,27.08,14,3,23,24,633,87,86,11,0,0,102,152,37,3,4,637
648,554,94,343,211,1977,748,146000,497,151,76.70,23.30,100,88,112,79,58,9,43,0,0,0,95,197,28,0,17,638
327,286,41,188,98,1975,713,165000,202,125,61.77,38.23,118,35,75,16,133,48,23,0,0,0,49,151,62,7,0,639
687,609,78,328,281,1975,669,121300,449,238,65.36,34.64,148,20,140,115,220,103,12,9,0,0,142,188,0,0,0,640
468,468,0,330,138,1974,769,192300,454,14,97.01,2.99,42,48,97,80,140,17,133,0,0,0,37,53,9,22,16,641
605,561,44,431,130,1961,819,179300,478,127,79.01,20.99,111,41,135,61,213,24,39,0,0,0,120,233,69,2,7,642
489,430,59,364,66,1986,775,169300,475,14,97.14,2.86,93,46,105,7,189,19,39,0,0,0,51,261,27,8,16,643
1098,835,263,499,336,1992,628,243900,647,451,58.93,41.07,461,76,133,55,86,39,153,74,0,35,0,211,156,10,38,644
681,609,72,528,81,1987,640,186300,621,60,91.19,8.81,178,135,228,25,137,20,54,0,0,0,144,285,122,8,8,645
412,385,27,325,60,1976,687,158200,325,87,78.88,21.12,93,44,59,38,168,11,26,9,0,0,119,147,55,3,17,646
299,299,0,267,32,1977,734,144900,299,0,100.00,0.00,44,7,167,8,90,26,46,0,0,0,29,85,29,9,10,647
521,488,33,403,85,1975,773,167000,485,36,93.09,6.91,120,29,168,19,158,0,16,0,23,0,24,256,54,0,40,648
621,552,69,283,269,1976,686,86200,443,178,71.34,28.66,207,132,150,69,28,10,16,0,0,0,184,273,74,18,0,649
349,316,33,258,58,1971,721,160800,340,9,97.42,2.58,257,19,76,0,96,10,49,22,0,0,42,90,122,0,51,650
365,311,54,182,129,1959,402,86800,252,113,69.04,30.96,32,102,46,5,231,53,50,0,0,0,120,105,0,0,0,651
2048,976,1072,527,449,1980,950,587600,847,1201,41.36,58.64,528,168,697,205,249,0,261,190,0,0,0,68,88,25,330,652
1384,1231,153,860,371,1998,833,166200,1131,253,81.72,18.28,824,139,277,97,106,36,366,62,16,0,106,620,107,0,20,653
1115,1033,82,902,131,1996,786,195100,957,158,85.83,14.17,387,82,143,49,59,23,42,11,0,0,42,311,155,79,18,654
741,741,0,551,190,1983,741,138600,581,160,78.41,21.59,238,287,101,24,15,17,44,85,0,0,13,397,26,0,27,655
374,284,90,227,57,1981,618,119100,295,79,78.88,21.12,98,14,53,24,161,0,46,0,0,0,111,83,32,15,21,656
1117,977,140,685,292,1991,1563,246800,972,145,87.02,12.98,430,258,218,66,80,10,144,32,16,0,44,558,169,17,17,657
697,658,39,265,393,1986,606,243100,339,358,48.64,51.36,190,183,116,46,72,123,318,0,13,0,17,79,48,0,0,658
337,337,0,92,245,1944,589,202100,89,248,26.41,73.59,82,0,36,21,210,24,96,40,0,0,0,102,53,0,0,659
280,239,41,115,124,1971,921,184100,153,127,54.64,45.36,22,0,39,99,94,54,66,0,0,0,11,111,12,0,0,660
1283,1097,186,734,363,1990,774,223100,903,380,70.38,29.62,404,139,476,26,74,103,149,60,0,0,41,402,122,62,78,661
496,430,66,398,32,1993,0,178700,365,131,73.59,26.41,232,82,133,13,44,11,34,0,0,0,89,283,38,14,0,662
515,443,72,339,104,1984,618,143000,392,123,76.12,23.88,123,146,125,33,50,41,68,5,0,0,98,152,24,3,5,663
2737,1736,1001,1258,478,2000,871,214200,2145,592,78.37,21.63,1642,254,144,60,146,56,288,210,38,0,95,291,417,113,237,664
955,591,364,509,82,1996,578,296300,865,90,90.58,9.42,273,239,199,66,110,12,71,0,0,0,158,57,72,0,140,665
1167,254,913,243,11,1994,0,173300,1054,113,90.32,9.68,372,125,217,3,271,2,100,0,0,0,37,104,84,20,37,666
567,386,181,362,24,1992,0,225700,541,26,95.41,4.59,129,65,81,16,81,0,19,0,0,0,24,95,33,65,23,667
637,598,39,511,87,1969,525,139100,524,113,82.26,17.74,162,80,216,52,128,11,43,0,0,0,173,247,36,0,32,668
993,865,128,320,545,1976,672,108300,475,518,47.83,52.17,155,95,150,100,496,127,421,11,0,0,148,60,18,0,0,669
755,723,32,459,264,1988,733,153400,524,231,69.40,30.60,255,84,178,128,151,13,176,0,0,0,118,240,18,0,13,670
356,280,76,200,80,1956,760,108900,318,38,89.33,10.67,26,19,66,28,345,0,162,0,0,0,161,143,18,0,0,671
1428,1339,89,993,346,1994,633,170400,1181,247,82.70,17.30,761,86,271,12,51,69,79,27,0,0,75,664,216,28,0,672
552,552,0,396,156,1987,795,158300,396,156,71.74,28.26,160,67,287,55,57,0,98,0,0,0,57,310,84,10,0,673
701,607,94,418,189,1980,817,131900,512,189,73.04,26.96,297,0,122,27,40,17,35,0,0,0,109,169,67,4,50,674
583,468,115,360,108,1977,1006,166300,522,61,89.54,10.46,181,72,75,53,206,95,42,0,0,0,125,205,71,0,11,675
528,473,55,156,317,1939,443,98300,228,300,43.18,56.82,33,14,16,9,351,182,82,0,0,0,57,79,0,0,0,676
338,313,25,248,65,1976,856,132700,314,24,92.90,7.10,89,34,152,36,34,0,26,9,0,0,12,203,49,0,0,677
119,96,23,55,41,1967,608,184400,83,36,69.75,30.25,33,17,17,31,10,31,0,0,0,0,18,41,0,0,8,678
886,741,145,495,246,1990,621,0,232,654,26.19,73.81,301,128,369,15,15,11,101,30,0,0,373,150,0,0,0,679
715,694,21,404,290,1945,729,97000,562,153,78.60,21.40,52,34,125,44,513,50,131,0,0,0,257,249,11,0,0,680
1041,979,62,961,18,1986,0,222200,1014,27,97.41,2.59,418,107,319,44,91,0,8,0,8,0,33,514,303,20,17,681
1234,1004,230,258,746,1959,434,98100,421,813,34.12,65.88,366,17,208,84,662,439,409,70,11,0,111,95,0,0,0,682
591,565,26,352,213,1964,653,140000,408,183,69.04,30.96,78,0,156,89,280,25,181,0,0,0,18,308,0,0,0,683
350,326,24,68,258,1974,678,164300,128,222,36.57,63.43,57,33,137,45,39,56,181,0,0,14,0,50,10,0,0,684
386,364,22,164,200,1973,686,9999,102,284,26.42,73.58,92,24,255,41,26,84,71,0,0,0,165,15,0,0,18,685
276,276,0,181,95,1974,867,140200,244,32,88.41,11.59,66,99,90,65,8,0,13,58,0,0,48,195,14,0,0,686
1680,1543,137,1054,489,1997,987,205000,1192,488,70.95,29.05,1301,108,135,12,38,10,278,64,54,0,144,357,449,44,26,687
353,335,18,303,32,1978,569,150800,296,57,83.85,16.15,112,33,90,44,62,15,8,19,0,0,100,106,10,8,0,688
524,485,39,367,118,1974,850,139700,435,89,83.02,16.98,87,41,170,135,105,13,76,17,0,0,40,355,37,0,0,689
565,498,67,209,289,1957,390,64900,388,177,68.67,31.33,80,0,190,45,242,144,210,0,0,0,101,72,0,0,0,690
339,271,68,159,112,1944,494,71900,237,102,69.91,30.09,11,24,11,13,191,41,24,0,0,0,96,66,0,0,0,691
513,468,45,231,237,1977,560,86100,271,242,52.83,47.17,184,155,65,37,144,219,190,16,0,0,38,88,0,0,0,692
1465,1393,72,1120,273,1993,826,308400,1310,155,89.42,10.58,924,133,181,68,124,19,81,0,20,0,67,469,370,170,112,693
445,339,106,252,87,1979,895,110700,429,16,96.40,3.60,135,38,155,26,54,0,37,0,0,0,73,255,0,0,13,694
564,438,126,304,134,1972,527,87600,400,164,70.92,29.08,255,15,117,34,76,0,29,0,0,0,116,194,0,0,0,695
1011,935,76,767,168,1993,774,203600,935,76,92.48,7.52,424,68,193,33,295,0,0,0,0,0,165,379,228,66,118,696
443,356,87,157,199,1953,792,78800,417,26,94.13,5.87,35,0,45,53,353,45,70,25,0,0,133,115,0,0,0,697
408,408,0,339,69,1981,753,158800,400,8,98.04,1.96,121,48,168,38,0,0,46,0,0,0,0,223,79,14,0,698
335,335,0,231,104,1981,941,126000,335,0,100.00,0.00,38,40,196,86,17,0,65,49,0,0,83,180,0,0,0,699
479,437,42,351,86,1987,0,96300,401,78,83.72,16.28,194,30,104,0,37,0,56,12,0,0,75,208,0,0,0,700
806,806,0,518,288,2002,777,130100,490,316,60.79,39.21,348,11,96,16,15,29,110,18,0,0,134,157,14,9,0,701
563,563,0,399,164,1987,860,105400,563,0,100.00,0.00,337,97,32,29,41,0,110,0,0,0,95,322,0,0,9,702
1789,1563,226,1187,376,1996,737,135700,1648,141,92.12,7.88,1103,193,228,52,14,0,88,90,0,0,155,1005,178,15,0,703
854,854,0,714,140,1999,819,99900,780,74,91.33,8.67,728,42,23,0,7,12,89,57,37,0,76,380,59,0,0,704
2106,1974,132,1524,450,2002,1086,131200,2021,85,95.96,4.04,1480,41,61,57,54,0,111,159,10,0,85,1090,172,0,41,705
865,763,102,542,221,1981,379,127900,679,186,78.50,21.50,421,137,107,43,249,226,134,8,3,0,137,215,48,40,51,706
1005,947,58,642,305,1994,1148,159100,893,112,88.86,11.14,912,113,56,0,29,0,74,45,0,0,159,666,61,0,14,707
781,781,0,593,188,1971,842,281000,729,52,93.34,6.66,145,100,43,15,382,0,29,33,0,0,13,160,368,16,50,708
1266,1266,0,1009,257,1993,1133,193600,1266,0,100.00,0.00,673,102,283,44,10,0,89,32,0,0,0,637,321,17,0,709
1354,1256,98,1068,188,1999,1150,222300,1133,221,83.68,16.32,1187,96,228,29,0,0,26,173,7,0,233,410,514,35,48,710
1889,1808,81,1451,357,1999,1048,243500,1667,222,88.25,11.75,1255,130,56,49,78,20,182,61,26,14,63,460,333,114,240,711
1005,1005,0,1005,0,1997,0,173200,1005,0,100.00,0.00,920,88,33,0,13,0,40,118,30,0,0,647,158,48,13,712
1514,1306,208,812,494,1997,950,232200,893,621,58.98,41.02,1079,40,32,0,0,12,220,55,0,0,51,148,457,186,22,713
697,697,0,505,192,2001,895,346600,460,237,66.00,34.00,580,31,47,0,60,75,89,0,0,0,129,42,115,106,105,714
4016,4016,0,3426,590,2003,1069,236800,3885,131,96.74,3.26,2676,48,113,173,65,0,350,95,35,0,9,969,1128,133,180,715
1471,1471,0,1224,247,1995,1226,233700,1453,18,98.78,1.22,792,50,521,62,0,0,27,16,0,0,0,686,499,78,16,716
589,578,11,355,223,1971,598,95000,447,142,75.89,24.11,68,54,154,48,270,50,57,0,0,0,199,178,52,0,0,717
470,427,43,315,112,1972,461,104600,391,79,83.19,16.81,84,26,98,5,142,23,26,0,0,0,98,137,14,0,0,718
796,705,91,614,91,1977,749,177800,714,82,89.70,10.30,168,62,163,77,151,25,42,0,0,0,59,284,70,47,37,719
514,499,15,383,116,1983,735,158800,411,103,79.96,20.04,182,51,79,44,142,8,45,0,0,0,108,137,100,16,23,720
560,553,7,395,158,1991,1007,119100,523,37,93.39,6.61,279,15,210,0,52,0,77,44,0,0,82,299,0,0,22,721
660,605,55,411,194,1989,733,129500,530,130,80.30,19.70,251,32,211,56,147,17,29,4,0,0,104,341,90,0,14,722
1039,877,162,826,51,1988,0,231700,928,111,89.32,10.68,550,45,301,88,56,9,76,0,10,0,46,545,243,77,34,723
1565,1404,161,902,502,1997,973,132100,1236,329,78.98,21.02,1144,63,354,77,68,29,240,151,0,0,71,999,56,0,0,724
1488,1468,20,926,542,1996,624,80500,849,639,57.06,42.94,844,185,368,0,71,135,160,64,0,0,602,395,0,0,0,725
564,505,59,279,226,1969,563,87100,436,128,77.30,22.70,56,14,159,58,196,34,112,9,0,0,132,156,0,8,0,726
108,98,10,47,51,1995,344,133000,93,15,86.11,13.89,20,11,17,12,13,7,8,0,0,0,29,13,0,0,0,727
582,541,41,492,49,1979,1121,270000,560,22,96.22,3.78,176,94,125,59,34,0,14,0,0,0,22,223,106,40,29,728
363,363,0,352,11,1979,0,223400,363,0,100.00,0.00,110,60,89,69,43,0,0,0,14,0,45,127,144,15,26,729
276,276,0,32,244,1973,626,9999,4,272,1.45,98.55,173,104,190,52,54,94,284,10,0,0,10,14,12,10,0,730
546,483,63,318,165,1975,401,80400,370,176,67.77,32.23,147,170,230,34,89,78,64,0,0,0,184,142,0,10,16,731
245,185,60,161,24,1977,0,167200,245,0,100.00,0.00,19,0,69,26,136,0,7,0,0,0,45,198,0,0,0,732
658,658,0,552,106,1978,690,165000,532,126,80.85,19.15,154,74,157,80,110,0,16,0,0,0,111,286,48,0,8,733
600,546,54,437,109,1978,1071,196600,445,155,74.17,25.83,169,117,166,57,98,9,53,22,0,0,77,221,160,14,7,734
377,363,14,299,64,1962,661,131700,348,29,92.31,7.69,91,39,53,6,174,0,14,0,0,0,45,154,56,10,0,735
771,708,63,658,50,1990,953,164200,640,131,83.01,16.99,236,43,136,24,120,11,26,10,0,0,100,208,75,0,15,736
670,615,55,242,373,1975,619,133800,370,300,55.22,44.78,110,105,162,73,125,101,42,0,0,0,156,175,0,8,0,737
234,234,0,93,141,1939,377,91500,170,64,72.65,27.35,112,0,22,22,272,167,69,0,0,0,102,53,6,0,0,738
159,159,0,126,33,1980,0,0,128,31,80.50,19.50,39,30,39,81,61,0,16,0,0,0,63,97,30,0,8,739
645,507,138,425,82,1973,545,135100,516,129,80.00,20.00,97,47,207,65,146,33,12,0,0,0,252,174,50,0,9,740
267,221,46,205,16,1987,0,216400,197,70,73.78,26.22,187,22,46,7,16,7,0,0,0,0,47,82,19,5,35,741
379,326,53,230,96,1976,633,115700,228,151,60.16,39.84,90,19,90,19,101,13,54,4,0,0,63,73,41,15,23,742
661,594,67,505,89,1976,542,130000,462,199,69.89,30.11,223,74,266,109,128,45,100,21,0,0,216,346,30,0,10,743
497,416,81,333,83,1970,463,117200,465,32,93.56,6.44,58,27,134,24,146,33,23,0,0,0,122,153,0,5,13,744
405,384,21,234,150,1976,513,134400,237,168,58.52,41.48,89,40,132,67,76,84,50,0,0,0,95,90,30,0,0,745
26,18,8,15,3,1957,0,325000,26,0,100.00,0.00,12,10,8,0,3,0,0,0,0,0,4,13,7,0,0,746
339,262,77,218,44,1971,683,121700,288,51,84.96,15.04,86,34,48,17,138,21,43,8,0,0,97,114,12,3,0,747
432,240,192,240,0,1994,0,269800,402,30,93.06,6.94,190,102,141,0,56,12,0,0,10,0,0,134,16,18,53,748
368,368,0,234,134,1973,795,161200,254,114,69.02,30.98,23,77,95,60,130,10,40,0,0,0,58,244,11,0,0,749
588,512,76,323,189,1978,663,107300,417,171,70.92,29.08,105,104,61,45,100,30,58,0,0,0,142,101,35,0,8,750
559,415,144,339,76,1963,0,147400,483,76,86.40,13.60,34,9,89,30,173,39,8,23,0,0,61,158,11,0,0,751
289,254,35,178,76,1976,575,101600,201,88,69.55,30.45,94,12,179,44,154,27,45,20,0,0,115,117,55,21,7,752
398,347,51,276,71,1974,563,106900,313,85,78.64,21.36,42,69,78,69,150,71,41,0,0,0,119,82,16,0,2,753
410,401,9,244,157,1981,698,0,230,180,56.10,43.90,98,79,109,43,217,103,85,0,0,0,109,54,21,65,19,754
234,234,0,127,107,1939,761,153600,163,71,69.66,30.34,0,9,13,12,194,9,69,0,0,0,81,69,0,0,0,755
945,819,126,465,354,1988,672,159300,478,467,50.58,49.42,481,59,158,0,119,74,192,0,58,99,86,249,37,0,0,756
294,244,50,165,79,1970,249,124300,248,46,84.35,15.65,74,0,84,24,183,53,39,0,0,0,53,110,6,0,30,757
387,354,33,252,102,1979,764,162500,334,53,86.30,13.70,124,54,157,40,33,47,36,15,0,0,93,105,37,30,12,758
444,364,80,228,136,1974,662,136800,387,57,87.16,12.84,93,27,115,62,252,28,39,7,0,0,128,215,31,18,11,759
507,419,88,341,78,1960,719,135400,457,50,90.14,9.86,78,24,151,120,141,57,23,0,0,0,193,185,38,0,0,760
521,485,36,248,237,1981,496,106400,234,287,44.91,55.09,143,129,164,92,32,114,153,8,0,0,127,90,0,0,0,761
697,572,125,427,145,1972,736,119600,452,245,64.85,35.15,81,37,191,82,90,29,83,0,0,0,171,141,0,0,0,762
406,366,40,277,89,1974,0,123500,307,99,75.62,24.38,67,38,59,38,115,9,26,0,0,0,96,129,6,0,0,763
581,549,32,403,146,1997,712,232200,500,81,86.06,13.94,138,81,105,7,93,7,7,12,0,0,13,216,51,26,28,764
1660,1549,111,451,1098,1988,777,221500,691,969,41.63,58.37,889,379,259,140,115,177,868,201,0,0,0,227,114,15,23,765
1432,1371,61,1087,284,2001,879,141800,1400,32,97.77,2.23,968,54,49,48,67,17,103,93,0,0,43,760,122,0,0,766
715,630,85,414,216,1992,1128,340700,541,174,75.66,24.34,270,30,229,7,24,0,57,0,12,19,19,125,90,112,83,767
622,563,59,305,258,1955,648,126100,446,176,71.70,28.30,70,0,21,92,424,22,80,0,0,0,112,314,14,0,0,768
251,251,0,184,67,1975,675,158300,179,72,71.31,28.69,0,59,210,12,82,0,74,45,0,0,39,193,12,0,0,769
1320,503,817,386,117,1990,696,993200,714,606,54.09,45.91,240,280,337,44,139,0,78,0,0,0,0,32,15,0,224,770
236,227,9,147,80,1956,778,84400,218,18,92.37,7.63,0,0,20,0,382,81,146,0,0,0,94,21,0,0,0,771
467,352,115,249,103,1973,655,120700,390,77,83.51,16.49,93,15,98,24,222,4,18,13,0,0,83,236,14,0,13,772
1242,1163,79,922,241,1994,972,143700,944,298,76.01,23.99,715,185,174,0,30,34,71,68,0,0,235,466,74,0,92,773
315,290,25,201,89,1962,569,82500,206,109,65.40,34.60,42,13,46,57,202,44,32,0,0,0,106,140,6,0,6,774
1235,1235,0,836,399,1965,786,132400,943,292,76.36,23.64,138,47,276,428,350,43,211,0,0,0,60,811,25,0,9,775
1544,1515,29,1168,347,1983,1070,162500,1533,11,99.29,0.71,731,379,303,14,14,0,89,81,9,0,0,1003,132,29,0,776
621,602,19,442,160,1994,839,147500,512,109,82.45,17.55,272,69,34,31,131,0,34,6,0,0,127,251,75,0,13,777
339,320,19,252,68,1950,727,176500,331,8,97.64,2.36,151,47,10,33,134,3,103,0,0,0,2,117,140,0,10,778
562,436,126,418,18,1994,0,169000,443,119,78.83,21.17,193,28,81,28,100,0,0,15,0,0,0,156,49,19,73,779
952,539,413,381,158,1980,865,192600,840,112,88.24,11.76,304,56,90,92,393,19,65,14,0,0,75,190,83,11,43,780
434,415,19,211,204,1952,491,192500,377,57,86.87,13.13,17,0,0,23,401,89,106,9,10,0,0,98,63,42,24,781
941,555,386,481,74,1992,428,169600,552,389,58.66,41.34,376,71,259,12,45,11,75,0,0,0,152,264,112,77,0,782
789,672,117,546,126,1975,788,138900,588,201,74.52,25.48,300,95,92,55,128,8,50,0,0,0,98,356,75,0,0,783
677,653,24,542,111,1976,769,202900,634,43,93.65,6.35,387,63,128,11,141,0,70,0,0,0,37,397,185,0,18,784
897,897,0,690,207,1986,1004,224800,568,329,63.32,36.68,385,200,165,55,56,0,88,21,0,0,74,212,112,83,205,785
523,413,110,295,118,1958,795,134000,431,92,82.41,17.59,93,0,95,42,251,10,23,0,0,0,67,349,32,0,0,786
347,295,52,114,181,1945,345,0,237,110,68.30,31.70,16,10,47,22,153,72,27,0,0,0,77,58,0,0,0,787
651,547,104,389,158,1947,835,166800,526,125,80.80,19.20,28,0,105,122,449,79,137,68,0,0,26,251,53,0,13,788
897,897,0,748,149,1995,684,193800,731,166,81.49,18.51,508,114,273,33,80,126,123,16,0,0,17,577,111,0,0,789
413,325,88,182,143,1946,721,114300,358,55,86.68,13.32,97,37,53,0,293,48,108,0,0,0,110,120,12,0,16,790
910,869,41,621,248,1967,419,113400,715,195,78.57,21.43,122,73,184,228,292,113,91,0,0,0,241,268,21,0,18,791
365,322,43,263,59,1972,535,152600,351,14,96.16,3.84,85,31,55,98,132,15,9,0,0,0,53,260,45,0,0,792
349,218,131,133,85,1967,827,76700,269,80,77.08,22.92,40,11,62,20,166,26,35,0,0,0,101,137,0,0,0,793
477,477,0,415,62,1984,0,145600,477,0,100.00,0.00,202,212,140,0,0,16,99,0,15,0,0,379,0,0,0,794
672,634,38,409,225,1976,642,118300,470,202,69.94,30.06,191,90,206,147,57,37,250,0,0,0,32,286,0,0,0,795
2280,2159,121,1778,381,2003,939,124100,2104,176,92.28,7.72,1720,25,65,23,212,62,102,258,0,0,215,1015,117,21,54,796
641,559,82,454,105,1977,0,143800,442,199,68.95,31.05,286,39,20,0,216,10,170,0,0,0,56,187,35,11,27,797
463,356,107,190,166,1948,625,114400,380,83,82.07,17.93,0,0,30,38,384,78,0,52,0,0,54,139,0,0,0,798
827,813,14,611,202,1977,934,174200,651,176,78.72,21.28,225,39,579,29,0,0,37,60,0,0,0,473,112,103,10,799
350,304,46,186,118,1975,546,107000,242,108,69.14,30.86,86,47,160,2,85,29,37,11,0,0,168,90,10,0,7,800
512,426,86,371,55,1979,342,122000,373,139,72.85,27.15,150,105,150,22,153,8,30,0,0,0,153,220,50,10,29,801
811,524,287,384,140,1985,746,147300,578,233,71.27,28.73,177,89,194,37,213,38,76,0,0,0,94,227,90,15,44,802
420,383,37,332,51,1975,643,190200,352,68,83.81,16.19,96,25,129,21,130,9,48,2,0,0,37,206,54,13,4,803
382,334,48,169,165,1955,752,106100,335,47,87.70,12.30,24,12,95,25,276,11,98,0,0,0,100,118,19,0,0,804
281,223,58,173,50,1976,1225,148600,222,59,79.00,21.00,31,22,56,37,92,0,0,0,0,0,45,82,0,15,25,805
228,193,35,133,60,1993,700,0,60,168,26.32,73.68,64,57,55,9,23,0,9,0,0,0,141,23,8,0,0,806
385,354,31,285,69,1979,730,325900,355,30,92.21,7.79,95,53,163,18,78,58,36,0,0,0,0,49,148,51,51,807
249,249,0,199,50,1979,0,241700,200,49,80.32,19.68,157,115,35,20,25,0,0,0,0,0,24,159,122,0,0,808
563,545,18,521,24,1986,0,338400,556,7,98.76,1.24,190,179,281,41,174,0,24,0,0,0,0,161,355,82,97,809
3556,3556,0,2772,784,2006,1345,244000,3284,272,92.35,7.65,2544,0,146,0,129,0,80,288,104,16,12,615,906,267,261,810
3154,2974,180,2078,896,2003,1125,143500,2845,309,90.20,9.80,1689,79,859,0,8,8,183,168,0,0,87,1766,208,15,64,811
441,441,0,291,150,1963,1006,148700,429,12,97.28,2.72,57,51,74,35,53,0,28,14,0,0,0,147,47,0,0,812
485,436,49,36,400,1976,668,0,92,393,18.97,81.03,232,45,226,101,71,28,474,89,15,0,16,14,26,0,0,813
541,541,0,455,86,1959,835,171500,541,0,100.00,0.00,10,39,122,140,240,7,27,15,13,0,34,318,101,0,29,814
747,716,31,500,216,1984,816,123900,698,49,93.44,6.56,82,346,258,0,0,0,101,142,0,0,11,419,13,0,0,815
703,663,40,566,97,1978,0,170600,598,105,85.06,14.94,319,72,113,23,116,33,0,0,20,0,103,183,80,26,92,816
471,408,63,301,107,1980,610,98500,356,115,75.58,24.42,105,69,200,66,68,32,37,0,0,0,135,167,36,0,14,817
291,259,32,232,27,1961,542,125800,288,3,98.97,1.03,61,18,65,5,166,0,10,0,0,0,59,108,27,11,11,818
687,641,46,497,144,1992,0,165300,486,201,70.74,29.26,246,102,303,32,146,15,99,7,0,0,132,307,151,11,12,819
778,639,139,542,97,1979,473,157800,649,129,83.42,16.58,315,58,149,41,263,0,122,0,0,0,66,253,81,54,129,820
380,351,29,326,25,1972,723,112200,368,12,96.84,3.16,71,67,37,30,72,0,30,0,0,0,112,135,0,0,0,821
614,572,42,456,116,1978,685,145100,554,60,90.23,9.77,144,65,229,86,137,29,72,43,0,0,197,254,58,8,0,822
785,686,99,324,362,1959,762,114900,499,286,63.57,36.43,76,51,197,0,586,12,229,48,0,0,17,451,53,0,0,823
500,457,43,353,104,1977,998,208100,439,61,87.80,12.20,172,19,125,21,122,0,41,0,0,0,47,162,141,10,19,824
1081,859,222,0,859,2003,900,0,857,224,79.28,20.72,664,73,26,145,248,0,315,25,18,0,0,0,0,0,0,825
339,339,0,301,38,1979,833,203400,281,58,82.89,17.11,74,80,110,0,59,18,16,0,0,0,97,64,84,18,13,826
444,389,55,326,63,1969,919,99500,409,35,92.12,7.88,38,32,121,103,180,27,9,0,0,0,102,199,40,0,0,827
955,955,0,550,405,1994,1144,198200,820,135,85.86,14.14,822,120,72,0,0,0,92,166,0,0,16,493,158,12,0,828
387,328,59,190,138,1961,317,128200,256,131,66.15,33.85,26,22,41,36,282,29,79,3,0,0,45,201,4,0,0,829
511,511,0,273,238,1993,836,14900,73,438,14.29,85.71,202,82,104,11,0,0,79,0,0,0,107,75,0,0,17,830
479,451,28,288,163,1985,1321,132000,394,85,82.25,17.75,284,13,69,57,114,19,24,0,0,0,111,209,95,9,23,831
463,373,90,196,177,1961,739,79500,315,148,68.03,31.97,34,30,64,41,257,10,50,0,0,0,136,161,10,0,0,832
405,356,49,262,94,1978,828,102100,308,97,76.05,23.95,134,44,66,55,180,16,57,13,0,0,113,138,16,15,12,833
664,619,45,240,379,1973,596,101900,498,166,75.00,25.00,63,19,188,85,185,0,147,0,0,0,165,129,0,0,0,834
801,636,165,504,132,1976,855,151800,732,69,91.39,8.61,153,44,142,59,263,55,132,13,0,0,174,182,21,0,0,835
1329,1329,0,1086,243,1996,1020,123400,1209,120,90.97,9.03,910,29,141,0,75,0,83,73,0,0,97,839,34,0,0,836
587,587,0,546,41,1955,0,124900,544,43,92.67,7.33,11,28,59,38,266,0,0,0,0,0,91,245,18,0,16,837
410,404,6,355,49,1978,0,109000,257,153,62.68,37.32,45,46,146,32,32,2,0,0,0,0,60,107,10,0,0,838
673,570,103,509,61,1990,829,193400,610,63,90.64,9.36,415,61,18,10,110,9,45,7,0,0,107,301,92,0,9,839
534,484,50,366,118,1974,809,121600,447,87,83.71,16.29,221,20,155,10,280,4,37,11,0,0,157,281,62,28,3,840
556,489,67,363,126,1939,640,117900,482,74,86.69,13.31,80,23,67,32,288,34,62,0,0,0,121,175,13,0,9,841
600,565,35,458,107,1971,0,166900,538,62,89.67,10.33,151,27,157,30,264,41,101,0,0,0,75,314,44,0,0,842
1416,1416,0,419,997,1994,718,0,206,1210,14.55,85.45,738,206,291,46,53,49,723,85,0,0,295,36,58,33,0,843
922,788,134,629,159,1980,687,155700,655,267,71.04,28.96,265,50,252,36,105,18,108,0,0,0,120,345,55,0,8,844
656,589,67,488,101,1982,849,166000,536,120,81.71,18.29,183,93,97,33,218,10,81,0,0,0,91,374,52,16,0,845
3270,3147,123,2433,714,2003,1279,156200,2586,684,79.08,20.92,2547,150,96,0,12,17,323,485,29,0,300,863,466,81,87,846
542,446,96,286,160,1974,659,94200,339,203,62.55,37.45,107,131,262,11,98,67,105,0,0,0,104,308,0,0,0,847
757,624,133,451,173,1988,876,165500,504,253,66.58,33.42,509,98,224,92,132,13,15,29,0,0,168,424,277,0,68,848
734,676,58,389,287,2001,714,197100,403,331,54.90,45.10,663,70,87,10,141,42,341,63,0,0,62,168,105,0,40,849
1324,1207,117,774,433,1996,907,167500,1090,234,82.33,17.67,967,13,62,24,52,0,104,124,14,0,33,657,139,0,0,850
771,364,407,301,63,1977,714,158700,562,209,72.89,27.11,133,38,101,63,253,21,27,20,0,0,51,149,50,0,0,851
919,891,28,829,62,1989,1348,366100,892,27,97.06,2.94,652,266,5,0,0,0,51,0,36,0,0,43,226,151,401,852
336,300,36,56,244,1960,606,118300,88,248,26.19,73.81,13,56,73,44,264,202,234,0,0,0,0,14,0,0,0,853
300,300,0,145,155,1980,621,196900,211,89,70.33,29.67,48,21,102,77,150,17,36,7,0,0,54,79,63,0,37,854
599,446,153,357,89,1992,0,284800,495,104,82.64,17.36,304,49,100,34,158,0,47,40,0,0,58,144,115,12,112,855
635,568,67,432,136,1975,723,120200,526,109,82.83,17.17,133,88,283,111,264,81,61,12,0,0,108,467,68,0,0,856
359,333,26,259,74,1975,579,163400,277,82,77.16,22.84,66,28,67,78,101,18,26,0,0,0,98,129,62,0,0,857
860,813,47,379,434,1989,333,192100,450,410,52.33,47.67,307,201,156,43,131,187,182,21,0,0,0,180,91,13,0,858
807,646,161,232,414,1989,704,183300,175,632,21.69,78.31,314,113,76,18,261,69,372,30,0,45,0,214,0,0,0,859
3125,3125,0,2356,769,2003,1002,146700,3066,59,98.11,1.89,2230,65,123,59,66,0,102,208,12,0,23,1444,336,83,101,860
512,428,84,354,74,1985,879,147100,426,86,83.20,16.80,134,20,105,20,152,0,16,0,0,0,80,260,15,0,2,861
518,470,48,407,63,1968,491,122000,351,167,67.76,32.24,99,91,112,71,53,0,35,0,0,0,219,77,83,12,0,862
403,375,28,200,175,1953,632,93300,339,64,84.12,15.88,0,28,71,50,322,49,85,0,0,0,127,153,0,0,0,863
1093,481,612,431,50,1975,1009,485600,1090,3,99.73,0.27,278,201,180,68,198,0,4,6,0,0,3,50,112,60,264,864
509,488,21,117,371,1976,509,120500,104,405,20.43,79.57,115,31,149,9,95,146,174,0,0,0,0,71,0,0,8,865
719,648,71,420,228,1950,653,116200,455,264,63.28,36.72,89,85,112,150,363,186,243,10,0,0,77,215,15,0,0,866
335,296,39,173,123,1970,799,124700,175,160,52.24,47.76,64,45,91,103,33,0,65,0,0,0,186,85,0,0,0,867
519,432,87,326,106,1978,803,152800,376,143,72.45,27.55,221,57,136,50,76,54,110,10,0,0,78,206,47,0,10,868
676,676,0,395,281,1995,820,179600,432,244,63.91,36.09,339,109,125,42,35,25,105,25,0,12,65,305,31,0,31,869
493,454,39,350,104,1978,681,172000,405,88,82.15,17.85,246,25,73,72,91,0,36,4,0,0,35,162,101,13,35,870
786,648,138,368,280,1965,497,294700,602,184,76.59,23.41,109,18,164,61,273,131,89,0,0,0,105,108,118,0,12,871
2743,2690,53,1945,745,2002,635,178800,2148,595,78.31,21.69,2077,142,185,0,65,27,348,203,16,0,106,1402,165,99,63,872
588,524,64,427,97,1984,1048,167800,388,200,65.99,34.01,225,97,225,120,96,34,31,46,0,0,260,249,128,10,5,873
566,508,58,396,112,1982,0,165800,526,40,92.93,7.07,189,134,134,72,99,0,41,0,0,0,58,345,49,0,48,874
357,336,21,244,92,1974,593,193200,316,41,88.52,11.48,38,0,112,44,71,0,33,26,0,0,14,111,36,0,45,875
405,359,46,278,81,1958,627,169100,337,68,83.21,16.79,43,17,14,54,221,15,59,0,0,0,106,116,53,0,0,876
398,398,0,220,178,1978,0,232800,275,123,69.10,30.90,135,18,12,15,152,0,105,18,0,20,0,56,59,45,29,877
729,449,280,392,57,1969,463,146400,694,35,95.20,4.80,103,160,58,135,180,43,4,0,0,0,144,192,14,0,23,878
325,291,34,278,13,1974,0,127100,271,54,83.38,16.62,94,67,39,29,132,0,0,0,0,0,146,127,31,0,0,879
272,259,13,242,17,1978,0,124600,244,28,89.71,10.29,161,42,69,36,88,23,56,11,0,0,46,145,15,0,0,880
520,456,64,324,132,1977,712,122200,355,165,68.27,31.73,210,77,230,18,113,67,29,0,0,0,160,234,74,0,0,881
620,459,161,353,106,1973,706,151900,407,213,65.65,34.35,177,29,203,87,216,28,46,8,0,9,115,325,55,27,17,882
509,492,17,380,112,1967,635,183300,480,29,94.30,5.70,143,103,66,55,81,53,13,0,0,0,88,183,29,0,6,883
224,205,19,103,102,1947,708,112900,201,23,89.73,10.27,18,6,7,11,245,12,144,0,0,0,33,53,4,0,6,884
814,728,86,199,529,1995,709,163300,253,561,31.08,68.92,658,231,106,13,26,189,332,0,29,51,24,332,44,0,0,885
437,437,0,417,20,1979,0,140500,363,74,83.07,16.93,70,28,136,14,103,14,18,10,0,0,149,124,17,0,0,886
407,356,51,76,280,1944,621,89100,280,127,68.80,31.20,12,10,43,49,204,47,150,0,0,0,45,22,0,0,11,887
931,854,77,705,149,1978,725,154400,559,372,60.04,39.96,449,73,222,83,269,66,220,0,0,0,184,333,114,0,0,888
789,643,146,578,65,1987,0,152900,632,157,80.10,19.90,250,109,81,47,122,29,10,0,0,0,54,293,129,15,58,889
639,539,100,486,53,1975,818,158000,512,127,80.13,19.87,107,106,252,55,177,11,49,0,0,0,102,372,63,34,17,890
959,480,479,382,98,1975,777,236300,878,81,91.55,8.45,217,65,142,38,254,2,40,9,0,0,70,170,63,14,44,891
288,288,0,106,182,1977,706,102800,202,86,70.14,29.86,5,6,26,90,164,9,58,26,0,0,44,121,0,0,0,892
505,505,0,383,122,1972,535,132200,410,95,81.19,18.81,104,9,61,8,130,0,66,0,0,0,9,183,19,12,10,893
227,215,12,103,112,1980,755,180000,201,26,88.55,11.45,35,60,152,0,51,12,0,0,0,0,20,87,0,11,20,894
1335,446,889,293,153,1978,1029,0,833,502,62.40,37.60,387,189,391,340,229,0,104,119,57,0,23,0,40,0,295,895
579,478,101,412,66,1979,497,311500,530,49,91.54,8.46,193,16,194,55,126,0,84,0,0,0,42,221,107,35,48,896
385,385,0,347,38,1978,756,221700,372,13,96.62,3.38,67,56,150,83,77,0,66,10,0,0,21,280,27,9,0,897
649,498,151,415,83,1982,434,208500,432,217,66.56,33.44,193,73,47,68,249,0,26,0,0,0,58,186,150,45,6,898
346,316,30,293,23,1987,0,265700,288,58,83.24,16.76,147,48,45,8,97,8,0,0,0,0,76,124,97,0,40,899
584,486,98,249,237,1976,510,95000,407,177,69.69,30.31,213,45,127,84,160,134,87,24,0,0,111,109,65,0,13,900
504,461,43,336,125,1941,640,141000,476,28,94.44,5.56,55,55,68,47,239,10,28,24,0,0,103,182,37,0,0,901
889,839,50,598,241,1991,679,175600,678,211,76.27,23.73,498,26,98,19,259,7,58,3,0,0,91,276,132,36,64,902
384,323,61,287,36,1978,527,208800,363,21,94.53,5.47,108,38,47,71,90,0,0,9,0,0,62,161,67,0,18,903
469,377,92,218,159,1954,581,0,293,176,62.47,37.53,36,14,94,24,279,110,90,0,0,0,133,85,0,0,0,904
698,644,54,322,322,1976,436,79200,419,279,60.03,39.97,173,136,190,32,133,67,35,0,0,0,271,205,0,46,0,905
1108,1076,32,753,323,1990,1059,154600,874,234,78.88,21.12,528,451,107,0,23,15,212,78,0,0,87,585,38,0,0,906
1175,1102,73,1021,81,1983,1185,355000,1158,17,98.55,1.45,471,210,318,49,75,0,15,23,0,0,0,146,354,168,282,907
438,405,33,315,90,1978,659,165600,316,122,72.15,27.85,106,33,172,44,126,24,57,18,0,0,64,224,20,4,0,908
388,365,23,271,94,1944,1043,158900,348,40,89.69,10.31,0,63,44,15,299,47,153,26,0,0,7,122,36,0,0,909
251,238,13,201,37,1993,831,232800,247,4,98.41,1.59,92,17,99,109,94,0,60,9,0,0,70,169,25,0,12,910
459,407,52,180,227,1964,773,82000,215,244,46.84,53.16,33,85,71,63,90,31,77,0,0,0,165,10,0,0,0,911
1083,995,88,873,122,1990,1273,137300,872,211,80.52,19.48,458,91,248,122,117,14,207,0,0,0,297,374,58,0,6,912
1597,1566,31,1302,264,1997,640,214200,1370,227,85.79,14.21,728,69,286,105,173,37,45,48,0,0,43,649,298,68,73,913
434,421,13,229,192,1978,863,185200,317,117,73.04,26.96,142,87,129,30,95,4,68,43,24,0,30,76,135,27,27,914
403,375,28,291,84,1976,712,158500,365,38,90.57,9.43,129,35,85,4,185,12,21,0,0,0,72,241,30,0,0,915
429,357,72,271,86,1982,0,193500,342,87,79.72,20.28,106,167,89,108,20,0,0,9,0,0,67,231,102,0,0,916
2151,2084,67,1697,387,2003,1078,195800,2033,118,94.51,5.49,1078,47,389,4,24,16,28,131,13,0,0,822,284,94,46,917
382,382,0,328,54,1979,0,130700,364,18,95.29,4.71,111,30,92,42,41,0,0,0,0,0,11,291,14,0,0,918
401,375,26,329,46,1982,608,174800,348,53,86.78,13.22,204,0,114,36,75,0,41,0,0,0,42,205,52,44,24,919
2376,2376,0,2294,82,2001,0,190900,2294,82,96.55,3.45,1817,160,15,0,12,0,17,259,0,0,42,1028,583,13,0,920
856,856,0,471,385,1990,819,192500,604,252,70.56,29.44,443,146,134,0,33,0,203,67,0,0,0,161,173,64,66,921
1622,1622,0,1459,163,1999,1422,303600,1616,6,99.63,0.37,1366,0,87,0,0,0,0,51,0,0,58,252,429,331,325,922
680,640,40,596,44,1980,831,251900,603,77,88.68,11.32,218,88,240,21,101,0,58,0,0,0,35,312,147,19,42,923
1488,1401,87,957,444,2001,1032,134300,1348,140,90.59,9.41,1149,129,128,0,114,86,281,206,0,0,40,596,95,33,55,924
2062,1987,75,1217,770,1999,938,116800,1784,278,86.52,13.48,1452,163,128,82,16,0,501,129,0,0,162,932,61,0,0,925
1725,1622,103,1384,238,2002,920,181000,1725,0,100.00,0.00,1267,58,87,16,75,12,56,144,0,0,39,703,256,67,56,926
366,366,0,205,161,1956,627,125200,258,108,70.49,29.51,113,13,74,23,234,27,163,0,0,0,31,150,0,0,0,927
787,787,0,566,221,1969,617,116400,751,36,95.43,4.57,266,0,29,31,248,10,57,29,0,0,54,373,21,8,11,928
405,394,11,278,116,1974,741,153500,324,81,80.00,20.00,188,6,95,24,206,20,69,10,0,0,78,200,10,0,37,929
503,438,65,196,242,1975,559,69200,359,144,71.37,28.63,106,55,166,42,141,87,116,0,0,0,154,80,0,0,0,930
205,205,0,195,10,1962,0,115200,175,30,85.37,14.63,21,55,43,69,74,6,0,0,0,0,143,57,8,0,0,931
426,379,47,233,146,1964,651,98100,287,139,67.37,32.63,44,11,110,19,208,35,61,9,0,0,119,124,4,0,0,932
398,358,40,342,16,1955,0,178500,382,16,95.98,4.02,85,22,27,59,249,42,164,0,0,0,67,157,0,0,0,933
363,322,41,211,111,1970,817,165100,210,153,57.85,42.15,82,63,24,23,245,0,104,66,0,0,55,203,9,0,0,934
526,475,51,351,124,1986,929,142400,435,91,82.70,17.30,232,69,163,33,3,46,0,29,1,0,110,194,75,16,0,935
371,371,0,371,0,1999,0,178500,371,0,100.00,0.00,316,10,0,29,25,15,0,8,0,0,10,250,49,0,0,936
434,403,31,226,177,1972,570,213900,326,108,75.12,24.88,122,16,79,36,235,11,33,0,0,0,68,169,49,23,21,937
336,303,33,236,67,1981,843,118200,207,129,61.61,38.39,131,60,135,15,25,0,57,0,0,0,121,117,18,0,0,938
2352,2304,48,1867,437,2002,1065,192800,2277,75,96.81,3.19,1557,79,47,0,146,0,82,130,8,0,33,682,356,39,340,939
514,478,36,370,108,1973,489,202000,464,50,90.27,9.73,72,28,89,40,298,20,73,9,0,3,106,164,23,14,0,940
402,385,17,274,111,1969,696,113000,395,7,98.26,1.74,33,36,85,43,225,36,94,0,0,0,155,106,9,0,0,941
950,817,133,170,647,1980,701,147900,348,602,36.63,63.37,590,201,269,32,390,98,874,106,13,0,78,181,24,0,0,942
1938,1810,128,1035,775,1995,778,188400,1470,468,75.85,24.15,1395,42,217,33,168,0,162,144,75,17,97,675,355,59,36,943
669,532,137,259,273,1972,718,120000,467,202,69.81,30.19,164,75,88,73,387,53,205,133,0,0,37,310,9,0,0,944
961,909,52,742,167,1979,896,144000,786,175,81.79,18.21,293,156,484,11,16,0,71,34,0,0,194,513,98,14,0,945
382,360,22,281,79,1954,928,107700,370,12,96.86,3.14,9,4,94,62,253,20,42,0,0,0,34,255,28,0,0,946
907,907,0,738,169,1984,1044,263200,803,104,88.53,11.47,504,159,134,48,61,0,20,21,0,0,0,176,188,156,288,947
466,299,167,247,52,1979,714,214400,336,130,72.10,27.90,79,78,145,32,35,33,22,2,0,0,20,108,50,8,41,948
294,253,41,157,96,1973,583,87300,173,121,58.84,41.16,64,53,110,60,102,53,31,0,0,0,67,103,7,0,15,949
684,608,76,432,176,1976,694,33500,291,393,42.54,57.46,265,79,245,26,80,66,152,0,0,0,251,126,0,0,9,950
759,733,26,628,105,1988,0,168100,599,160,78.92,21.08,336,79,117,11,157,0,40,35,0,0,85,205,95,64,72,951
1239,892,347,459,433,1997,835,174200,769,470,62.07,37.93,747,259,146,50,266,110,345,206,9,0,59,122,201,56,3,952
209,176,33,143,33,1983,969,238800,180,29,86.12,13.88,29,60,79,0,40,0,0,0,0,0,33,103,48,0,0,953
658,620,38,355,265,1959,758,85400,493,165,74.92,25.08,20,18,166,98,423,180,89,5,0,0,229,149,0,0,0,954
549,549,0,271,278,1965,538,155700,313,236,57.01,42.99,31,68,127,72,90,141,52,0,0,0,35,116,13,0,0,955
595,546,49,469,77,1988,775,167000,443,152,74.45,25.55,256,75,169,29,82,9,69,19,0,0,93,261,83,17,20,956
1252,1142,110,969,173,1994,929,196000,1192,60,95.21,4.79,710,97,331,26,62,0,213,29,0,0,75,655,197,44,13,957
633,633,0,340,293,1995,805,165600,344,289,54.34,45.66,278,46,104,63,34,10,143,38,0,0,68,120,60,0,18,958
521,440,81,340,100,1979,734,187500,428,93,82.15,17.85,127,25,49,82,141,16,10,0,0,0,38,179,39,4,0,959
371,316,55,161,155,1974,533,0,223,148,60.11,39.89,58,0,82,47,223,18,175,14,16,0,129,9,0,0,0,960
693,591,102,403,188,1987,1102,401700,497,196,71.72,28.28,332,97,147,60,28,0,40,11,15,0,11,61,137,89,192,961
1135,1020,115,737,283,1993,1002,267300,874,261,77.00,23.00,516,283,97,93,60,0,229,74,37,0,13,195,255,96,100,962
948,858,90,687,171,1984,1184,374400,855,93,90.19,9.81,375,126,122,60,219,3,36,45,10,20,3,98,239,90,238,963
709,690,19,563,127,1965,1219,217800,627,82,88.43,11.57,119,67,102,132,354,0,165,60,23,0,19,281,198,9,19,964
618,578,40,487,91,1997,1734,253600,612,6,99.03,0.97,384,91,21,0,36,0,0,18,86,0,0,43,259,40,53,965
1022,929,93,539,390,2000,1580,225300,719,303,70.35,29.65,906,36,0,45,0,10,0,129,86,11,31,242,343,0,75,966
382,340,42,309,31,1992,0,339100,294,88,76.96,23.04,153,34,72,18,67,0,0,8,0,0,0,24,128,66,64,967
507,482,25,380,102,1958,972,192300,449,58,88.56,11.44,82,15,33,101,236,0,144,24,0,11,11,199,73,0,0,968
704,654,50,347,307,1983,1100,82100,87,617,12.36,87.64,164,335,178,25,34,0,140,163,24,0,249,65,70,0,0,969
425,393,32,291,102,1973,0,357200,383,42,90.12,9.88,52,22,57,175,201,0,83,13,11,0,17,106,129,29,46,970
528,485,43,237,248,1968,1164,248200,299,229,56.63,43.37,40,49,70,154,124,0,99,125,45,0,0,15,116,0,8,971
978,862,116,611,251,1990,1504,345200,854,124,87.32,12.68,323,132,127,57,190,0,34,28,0,0,14,119,198,127,53,972
383,343,40,81,262,1974,668,217000,76,307,19.84,80.16,30,67,180,121,17,79,84,0,0,0,0,17,90,0,20,973
484,484,0,417,67,2000,1277,215300,469,15,96.90,3.10,482,26,9,0,0,0,9,78,0,0,0,289,135,6,0,974
448,262,186,229,33,1995,0,473500,393,55,87.72,12.28,153,141,84,63,0,0,0,0,0,0,24,34,30,21,36,975
264,210,54,139,71,1949,1228,183700,264,0,100.00,0.00,0,25,7,0,304,0,32,9,0,0,0,191,74,0,0,976
1356,1302,54,449,853,1982,880,211900,535,821,39.45,60.55,345,160,224,154,398,47,558,201,0,6,28,187,149,0,26,977
424,413,11,203,210,1975,831,297500,269,155,63.44,36.56,59,66,75,87,123,0,83,25,16,0,42,24,126,45,0,978
577,577,0,320,257,1993,0,231900,419,158,72.62,27.38,196,76,25,57,0,0,22,0,7,0,11,87,161,54,12,979
913,913,0,242,671,1984,1319,420000,157,756,17.20,82.80,178,161,103,56,217,0,155,213,73,0,0,11,65,73,125,980
694,664,30,225,439,1955,861,488300,315,379,45.39,54.61,26,0,42,14,560,0,133,80,12,27,0,0,80,97,129,981
245,207,38,176,31,1950,0,144400,245,0,100.00,0.00,0,0,0,0,246,0,15,0,0,0,12,219,0,0,0,982
667,607,60,499,108,1996,1089,240900,572,95,85.76,14.24,258,44,81,60,87,21,0,61,0,0,33,216,186,13,0,983
557,515,42,100,415,1973,923,615900,208,349,37.34,62.66,171,158,154,58,118,0,315,120,24,0,0,30,42,14,44,984
245,223,22,78,145,1977,762,0,50,195,20.41,79.59,90,17,107,85,50,0,277,8,0,0,52,0,12,0,0,985
315,276,39,184,92,1939,1118,158300,291,24,92.38,7.62,31,0,12,0,341,0,23,68,26,0,15,170,45,0,0,986
583,583,0,462,121,1976,898,137400,445,138,76.33,23.67,87,50,197,40,76,0,26,0,0,0,63,294,32,0,0,987
621,621,0,593,28,1992,1844,392200,621,0,100.00,0.00,404,154,54,16,4,0,0,0,12,2,7,6,138,175,267,988
742,742,0,560,182,1990,849,178700,516,226,69.54,30.46,337,19,91,91,72,0,77,64,0,0,9,429,19,0,0,989
880,880,0,682,198,1988,1435,250300,773,107,87.84,12.16,468,190,139,27,60,0,78,156,17,0,0,183,324,43,0,990
677,657,20,409,248,1957,709,102800,607,70,89.66,10.34,52,11,119,58,448,49,210,6,0,0,189,197,0,0,0,991
395,395,0,230,165,1986,1782,252200,395,0,100.00,0.00,27,179,124,0,8,0,22,28,0,0,20,115,153,0,0,992
621,593,28,276,317,1945,888,265300,367,254,59.10,40.90,0,77,65,143,326,23,252,0,0,20,0,102,132,0,0,993
373,326,47,207,119,1955,534,172000,290,83,77.75,22.25,10,30,153,30,281,16,182,21,0,0,15,199,28,0,0,994
238,238,0,65,173,1939,946,183000,112,126,47.06,52.94,0,12,31,60,133,0,103,0,0,0,0,42,56,0,0,995
364,336,28,286,50,1968,1086,188200,345,19,94.78,5.22,78,41,64,53,64,0,41,74,13,0,9,112,51,0,0,996
274,274,0,88,186,1959,1214,286800,156,118,56.93,43.07,25,45,19,22,55,9,42,74,0,0,11,0,20,0,0,997
418,377,41,154,223,1939,908,223900,219,199,52.39,47.61,16,0,54,0,316,37,88,32,0,0,0,43,102,67,0,998
944,852,92,111,741,2001,1059,237500,15,929,1.59,98.41,149,19,48,137,409,33,362,120,31,0,0,12,21,8,0,999
495,477,18,385,92,1984,983,200400,459,36,92.73,7.27,144,133,90,55,22,0,10,28,0,0,0,250,83,0,0,1000
438,438,0,383,55,1969,2207,568200,429,9,97.95,2.05,39,86,141,206,8,0,0,0,9,75,16,0,33,45,272,1001
663,641,22,342,299,1980,1278,189300,538,125,81.15,18.85,286,51,133,27,53,0,78,133,0,0,20,165,57,0,0,1002
1065,1028,37,796,232,1996,809,256100,840,225,78.87,21.13,679,313,43,11,21,0,202,22,0,0,0,354,420,58,0,1003
331,310,21,217,93,1958,1149,268000,309,22,93.35,6.65,0,8,14,106,199,0,0,24,60,0,0,53,161,8,13,1004
294,294,0,207,87,1947,1236,169900,275,19,93.54,6.46,0,0,41,0,313,0,44,26,13,0,0,241,30,0,0,1005
819,747,72,420,327,1990,1269,158400,745,74,90.96,9.04,321,204,14,55,105,0,122,141,7,0,0,250,107,0,0,1006
559,498,61,116,382,1942,712,342900,177,382,31.66,68.34,83,92,92,0,293,68,205,18,47,0,0,102,25,41,0,1007
444,427,17,252,175,1968,1118,453400,346,98,77.93,22.07,56,78,30,42,202,0,32,33,0,23,16,0,108,46,141,1008
394,364,30,324,40,1976,1479,185200,394,0,100.00,0.00,49,0,250,54,0,0,20,0,0,0,0,255,78,0,0,1009
883,773,110,36,737,1975,894,0,36,847,4.08,95.92,21,262,245,212,125,0,726,79,0,0,0,0,0,0,0,1010
882,839,43,757,82,1996,1176,192800,863,19,97.85,2.15,431,167,85,9,23,0,0,42,8,11,41,294,252,0,0,1011
667,667,0,52,615,1960,740,228100,123,544,18.44,81.56,47,51,104,139,430,120,512,73,0,0,8,24,0,0,0,1012
323,323,0,286,37,1956,0,504600,323,0,100.00,0.00,7,0,20,74,194,0,0,0,12,0,0,9,22,65,187,1013
1155,1087,68,735,352,2002,1218,184000,769,386,66.58,33.42,897,29,227,0,0,57,90,104,20,0,11,668,28,12,10,1014
537,529,8,411,118,1968,958,230200,490,47,91.25,8.75,104,50,104,98,21,0,20,31,0,0,0,83,135,44,27,1015
450,450,0,393,57,1964,1836,253400,450,0,100.00,0.00,10,31,38,216,188,4,0,20,55,0,0,132,244,0,0,1016
1610,613,997,505,108,1987,1159,269900,1401,209,87.02,12.98,465,393,311,16,67,17,22,0,0,0,66,294,131,28,61,1017
405,397,8,332,65,1954,1531,135800,397,8,98.02,1.98,32,17,0,12,424,34,83,9,0,0,56,265,12,0,0,1018
2817,811,2006,670,141,1992,941,252500,2334,483,82.85,17.15,1018,617,339,255,210,0,13,49,39,0,0,82,190,39,236,1019
544,453,91,8,445,1962,775,0,71,473,13.05,86.95,59,14,135,164,234,26,514,12,0,0,0,15,12,0,0,1020
426,357,69,160,197,1975,1038,191300,254,172,59.62,40.38,90,124,51,66,111,9,60,18,20,6,10,175,23,6,0,1021
534,489,45,376,113,1978,563,166000,382,152,71.54,28.46,119,49,236,34,201,58,103,0,0,0,138,109,78,6,11,1022
361,277,84,135,142,1939,1047,210900,304,57,84.21,15.79,0,0,0,20,273,0,50,55,0,0,9,97,43,0,0,1023
918,918,0,226,692,1970,709,193100,312,606,33.99,66.01,17,30,151,355,313,99,344,58,0,0,0,150,121,0,0,1024
443,443,0,406,37,1939,0,714600,423,20,95.49,4.51,12,0,0,11,494,0,21,23,35,0,0,0,15,24,374,1025
810,533,277,469,64,1981,636,229300,617,193,76.17,23.83,262,76,83,67,80,6,52,0,0,0,36,132,64,18,28,1026
593,565,28,17,548,1970,762,0,89,504,15.01,84.99,69,19,229,172,156,41,452,45,0,0,19,9,0,0,0,1027
439,439,0,354,85,1951,1236,397800,335,104,76.31,23.69,45,27,0,13,370,0,11,45,0,0,14,15,120,137,113,1028
867,729,138,369,360,1975,783,123600,428,439,49.37,50.63,464,99,76,190,198,124,228,101,0,0,106,203,106,11,9,1029
375,351,24,288,63,1966,992,198900,365,10,97.33,2.67,50,23,77,301,57,0,30,9,0,0,0,177,292,0,0,1030
490,442,48,134,308,1984,1098,222100,193,297,39.39,60.61,106,171,77,165,22,0,242,126,50,0,0,24,59,0,7,1031
651,470,181,224,246,1991,1153,169700,288,363,44.24,55.76,262,102,129,0,127,14,84,69,39,25,56,137,12,0,0,1032
538,492,46,330,162,1953,1022,133700,516,22,95.91,4.09,0,0,44,17,374,11,54,69,0,0,73,178,13,0,0,1033
452,397,55,203,194,1984,1871,498000,320,132,70.80,29.20,147,129,72,69,34,0,0,104,68,14,0,0,38,93,103,1034
428,370,58,253,117,1969,1322,272700,347,81,81.07,18.93,142,101,49,163,43,0,59,79,8,0,12,91,163,78,8,1035
951,932,19,69,863,1939,608,250900,11,940,1.16,98.84,378,126,85,20,369,449,145,69,40,33,0,0,42,0,0,1036
311,311,0,150,161,1964,682,90900,218,93,70.10,29.90,63,0,0,0,243,26,31,19,0,0,204,26,0,0,0,1037
408,353,55,258,95,1947,1051,156300,379,29,92.89,7.11,52,14,21,24,219,15,3,11,5,2,3,243,17,0,16,1038
435,385,50,271,114,1955,1119,237500,402,33,92.41,7.59,76,30,48,67,227,0,29,93,0,0,0,95,157,48,9,1039
629,269,360,239,30,1976,785,339200,582,47,92.53,7.47,203,52,129,75,87,0,33,21,6,0,0,51,144,32,5,1040
947,947,0,828,119,1979,1164,189100,835,112,88.17,11.83,282,190,229,88,126,23,195,70,0,0,31,482,8,0,13,1041
702,702,0,71,631,1964,914,227300,111,591,15.81,84.19,0,40,209,349,264,9,558,146,0,23,0,36,44,7,9,1042
31,26,5,0,26,1939,1806,0,31,0,100.00,0.00,33,0,0,0,21,0,0,9,20,14,0,0,0,0,0,1043
534,506,28,455,51,1961,1486,212300,534,0,100.00,0.00,26,27,20,303,194,0,0,36,8,0,0,197,303,20,6,1044
877,861,16,309,552,2003,1005,275800,609,268,69.44,30.56,504,8,0,169,77,149,105,49,0,60,36,4,218,38,16,1045
464,464,0,44,420,1976,1012,0,91,373,19.61,80.39,67,0,75,0,453,36,386,39,27,0,0,25,6,0,0,1046
1110,639,471,504,135,1984,794,190800,650,460,58.56,41.44,320,173,198,165,227,0,70,0,46,0,58,366,73,13,57,1047
347,347,0,250,97,1950,1247,306000,347,0,100.00,0.00,15,0,10,0,231,0,0,0,0,0,0,84,147,10,15,1048
605,541,64,325,216,1939,910,263400,451,154,74.55,25.45,0,25,33,46,434,78,213,48,0,0,0,32,156,11,0,1049
266,230,36,46,184,1972,852,187500,46,220,17.29,82.71,136,72,134,106,22,31,262,55,0,0,10,90,0,0,22,1050
426,426,0,386,40,1943,0,801500,426,0,100.00,0.00,32,0,0,0,448,0,0,0,0,26,21,0,22,48,347,1051
262,218,44,8,210,1939,1325,0,17,245,6.49,93.51,14,42,34,62,385,48,76,30,213,65,0,16,0,0,0,1052
489,489,0,123,366,1975,1391,486400,161,328,32.92,67.08,0,90,170,84,106,11,56,144,166,0,0,9,0,47,17,1053
540,503,37,273,230,1985,972,583600,284,256,52.59,47.41,134,144,133,31,37,0,142,45,0,0,0,0,10,8,239,1054
1659,1201,458,181,1020,1996,1860,453600,29,1630,1.75,98.25,1027,207,0,0,189,25,101,136,222,109,0,15,64,54,184,1055
505,491,14,428,63,1989,1380,243400,483,22,95.64,4.36,538,23,47,0,0,0,0,34,0,0,90,240,133,0,0,1056
683,661,22,345,316,1982,1017,222100,351,332,51.39,48.61,274,168,234,126,80,0,368,138,12,0,27,114,144,11,7,1057
628,628,0,559,69,2003,0,245700,591,37,94.11,5.89,528,54,0,32,37,0,19,120,7,0,0,206,280,18,1,1058
412,412,0,304,108,1984,1398,279000,379,33,91.99,8.01,83,128,105,31,0,0,0,18,22,0,29,21,219,0,0,1059
317,317,0,229,88,1951,1699,230700,317,0,100.00,0.00,0,0,27,30,216,0,27,0,11,0,34,86,115,0,0,1060
639,625,14,513,112,1984,734,347400,590,49,92.33,7.67,162,95,141,37,193,13,46,4,0,4,4,194,193,51,41,1061
313,286,27,218,68,1943,1351,137800,313,0,100.00,0.00,16,0,12,66,195,0,0,49,0,0,70,128,0,13,16,1062
749,675,74,288,387,1984,1013,227200,334,415,44.59,55.41,51,641,80,18,0,0,147,172,0,24,0,70,324,53,0,1063
912,832,80,26,806,1978,922,0,25,887,2.74,97.26,108,222,286,211,161,112,702,92,21,19,0,0,0,0,0,1064
375,318,57,209,109,1944,1060,142100,375,0,100.00,0.00,15,0,12,9,382,8,77,16,0,0,16,239,54,0,0,1065
855,738,117,549,189,1955,598,94900,629,226,73.57,26.43,88,118,122,99,333,19,120,68,0,0,305,189,0,0,0,1066
686,622,64,601,21,1986,0,173400,675,11,98.40,1.60,223,105,161,0,0,7,43,59,0,0,0,163,182,0,7,1067
299,299,0,199,100,1958,1500,300800,264,35,88.29,11.71,85,17,0,87,158,0,0,18,104,0,0,28,159,32,6,1068
906,906,0,370,536,1978,881,38900,166,740,18.32,81.68,31,348,492,130,12,0,506,11,0,0,462,0,34,0,0,1069
774,746,28,379,367,1968,758,246700,516,258,66.67,33.33,106,55,134,152,206,0,147,128,0,0,0,79,196,68,13,1070
219,219,0,139,80,1986,1125,155900,175,44,79.91,20.09,278,56,12,0,36,0,62,36,0,0,0,174,110,0,0,1071
307,307,0,205,102,1946,1275,159900,307,0,100.00,0.00,32,0,12,0,265,0,24,0,0,0,19,194,46,0,0,1072
284,284,0,284,0,1975,0,223100,284,0,100.00,0.00,13,68,187,14,12,0,12,0,0,0,0,33,211,0,0,1073
1127,1076,51,34,1042,1990,1112,133000,9,1118,0.80,99.20,468,62,147,98,291,69,535,187,91,29,0,15,15,0,0,1074
360,318,42,216,102,1939,982,130300,331,29,91.94,8.06,49,15,0,0,388,0,14,38,0,0,26,265,69,0,0,1075
322,308,14,237,71,1994,847,296300,285,37,88.51,11.49,303,13,33,46,41,51,13,33,60,0,0,51,146,11,71,1076
443,361,82,102,259,1974,464,152900,132,311,29.80,70.20,12,84,192,36,120,170,124,23,0,0,0,56,36,0,0,1077
514,514,0,446,68,2000,1375,188800,514,0,100.00,0.00,341,10,31,65,0,0,24,33,5,0,21,167,169,0,0,1078
345,335,10,149,186,1982,1000,161800,345,0,100.00,0.00,16,57,197,28,50,6,57,35,0,0,8,208,15,19,0,1079
401,333,68,165,168,1966,1114,213500,330,71,82.29,17.71,0,0,152,139,78,0,22,57,0,0,0,223,37,9,11,1080
457,364,93,133,231,1974,960,189900,191,266,41.79,58.21,71,79,47,228,87,10,276,53,0,0,7,62,64,0,0,1081
299,299,0,269,30,1968,1292,176600,299,0,100.00,0.00,11,37,19,247,12,0,0,21,0,0,24,201,33,13,0,1082
525,525,0,196,329,1974,1157,275000,235,290,44.76,55.24,113,66,108,49,212,35,110,121,7,0,0,20,154,77,0,1083
700,613,87,407,206,1965,1635,342800,629,71,89.86,10.14,64,69,118,93,116,0,56,50,12,0,0,94,187,51,10,1084
479,479,0,93,386,1939,1360,697000,295,184,61.59,38.41,31,15,72,0,150,0,146,16,0,15,0,0,0,0,91,1085
253,231,22,207,24,1962,1417,138600,253,0,100.00,0.00,36,0,97,9,156,0,0,28,0,0,17,224,13,0,0,1086
882,852,30,587,265,1975,1284,168000,666,216,75.51,24.49,165,35,248,89,230,21,48,55,10,26,53,480,74,0,0,1087
296,296,0,265,31,1979,0,282900,275,21,92.91,7.09,159,7,116,33,24,0,0,23,0,0,11,135,110,27,0,1088
698,657,41,312,345,1949,1152,402400,395,303,56.59,43.41,88,25,15,100,461,14,121,37,25,0,0,28,56,249,41,1089
472,472,0,347,125,1976,1143,191100,428,44,90.68,9.32,88,13,178,15,69,0,41,0,0,0,11,254,17,0,0,1090
483,409,74,207,202,1977,1358,195600,78,405,16.15,83.85,114,113,193,33,56,0,77,30,0,0,0,210,93,29,43,1091
383,326,57,222,104,1941,1038,322800,343,40,89.56,10.44,45,9,26,11,283,14,56,24,9,0,6,44,86,55,37,1092
406,360,46,177,183,1971,393,178700,207,199,50.99,49.01,112,0,69,52,189,83,98,0,0,0,0,169,51,0,0,1093
458,458,0,223,235,1978,826,180800,263,195,57.42,42.58,171,72,89,18,98,0,154,0,0,17,49,135,18,0,0,1094
313,290,23,258,32,1973,0,215700,313,0,100.00,0.00,77,137,21,19,50,37,9,0,9,0,7,198,30,0,14,1095
719,635,84,489,146,1974,1379,163000,652,67,90.68,9.32,115,146,113,157,208,0,34,109,97,16,12,371,100,0,0,1096
539,539,0,335,204,1972,705,281300,365,174,67.72,32.28,33,188,256,143,0,127,27,43,37,11,0,91,222,38,14,1097
633,586,47,265,321,1995,1181,384300,275,358,43.44,56.56,209,102,85,119,110,30,124,142,15,0,0,0,80,65,63,1098
510,499,11,319,180,1979,899,220500,332,178,65.10,34.90,87,18,59,143,40,0,0,39,0,0,0,194,60,33,5,1099
488,411,77,113,298,1975,770,0,41,447,8.40,91.60,67,64,171,153,120,30,354,84,0,0,54,35,0,8,0,1100
287,287,0,161,126,1939,981,161600,261,26,90.94,9.06,64,12,5,11,193,28,58,41,0,0,43,62,17,0,7,1101
486,486,0,295,191,1949,0,391600,396,90,81.48,18.52,70,55,13,20,270,0,57,61,20,0,13,12,45,100,102,1102
769,678,91,634,44,1992,0,224600,437,332,56.83,43.17,405,146,179,13,29,0,76,49,0,13,43,203,224,69,47,1103
853,769,84,577,192,1997,0,259600,648,205,75.97,24.03,556,66,0,8,13,45,25,79,11,22,0,211,169,32,18,1104
878,811,67,758,53,1994,786,258300,694,184,79.04,20.96,398,65,122,108,210,14,107,22,7,0,18,245,207,110,103,1105
300,300,0,201,99,1974,1242,264900,249,51,83.00,17.00,53,14,0,0,123,0,20,25,0,0,0,27,50,19,12,1106
776,720,56,526,194,1980,1319,189700,720,56,92.78,7.22,179,166,365,0,40,0,19,148,53,0,21,372,83,0,10,1107
348,348,0,235,113,1974,1939,288400,334,14,95.98,4.02,44,38,51,24,62,0,0,52,0,0,0,42,85,40,0,1108
369,313,56,150,163,1960,908,233300,237,132,64.23,35.77,9,16,46,94,235,38,44,41,33,6,0,122,46,27,0,1109
635,635,0,445,190,1969,764,154800,485,150,76.38,23.62,158,48,65,42,266,24,122,0,0,0,32,342,19,0,0,1110
973,879,94,346,533,1999,1683,500000,37,936,3.80,96.20,599,66,0,107,51,70,17,292,137,28,0,31,10,26,123,1111
221,197,24,66,131,1939,781,125000,149,72,67.42,32.58,42,7,132,0,171,46,155,0,0,0,9,26,0,0,0,1112
257,257,0,215,42,1985,1120,134200,134,123,52.14,47.86,155,58,68,8,0,0,23,22,0,0,63,49,56,16,0,1113
424,375,49,268,107,1939,1347,273100,393,31,92.69,7.31,0,0,24,39,278,0,76,10,0,0,0,117,121,17,0,1114
452,399,53,0,399,1981,1463,0,59,393,13.05,86.95,147,164,247,45,54,41,178,332,63,0,0,0,0,0,0,1115
418,385,33,273,112,1983,1121,278800,166,252,39.71,60.29,66,82,76,89,81,0,65,8,10,0,8,32,126,70,54,1116
748,715,33,567,148,1992,1205,122200,584,164,78.07,21.93,322,61,45,323,0,12,0,85,61,0,35,355,169,0,0,1117
310,234,76,99,135,1956,596,124600,247,63,79.68,20.32,0,0,28,10,248,29,56,16,12,0,88,85,0,0,0,1118
783,761,22,612,149,1983,1416,207100,780,3,99.62,0.38,284,262,310,36,20,0,8,52,86,2,9,319,387,3,2,1119
766,737,29,579,158,2003,1278,223600,710,56,92.69,7.31,698,0,0,13,0,0,46,52,0,0,0,235,347,11,20,1120
474,389,85,306,83,1962,1438,284600,383,91,80.80,19.20,122,31,66,29,193,0,12,15,0,0,0,46,240,59,9,1121
660,561,99,225,336,1973,754,128300,160,500,24.24,75.76,72,71,455,106,71,110,282,48,0,0,176,113,0,0,0,1122
522,496,26,429,67,1975,2071,316400,522,0,100.00,0.00,44,201,80,98,212,0,0,11,23,31,0,43,299,108,59,1123
481,481,0,419,62,1939,2031,451200,481,0,100.00,0.00,15,14,12,15,486,0,54,0,10,12,0,21,104,130,160,1124
726,622,104,292,330,1955,782,214500,416,310,57.30,42.70,28,91,98,70,485,59,265,86,30,0,32,144,77,8,20,1125
890,763,127,168,595,1994,1128,179500,234,656,26.29,73.71,368,218,72,44,183,0,238,285,42,0,67,87,52,33,4,1126
471,442,29,304,138,1939,803,161300,321,150,68.15,31.85,118,28,32,43,311,10,64,77,0,0,8,205,27,0,6,1127
329,329,0,146,183,1939,917,213900,226,103,68.69,31.31,17,10,19,39,280,29,110,74,0,0,26,89,37,0,0,1128
660,660,0,524,136,1976,647,80500,264,396,40.00,60.00,69,116,231,129,0,40,68,0,0,0,197,209,31,0,0,1129
623,580,43,210,370,1973,935,210200,353,270,56.66,43.34,221,0,57,83,152,27,51,16,62,37,0,250,9,20,0,1130
553,383,170,250,133,1967,494,234100,419,134,75.77,24.23,174,106,130,60,203,97,45,0,0,0,0,67,19,72,58,1131
571,571,0,198,373,1982,1348,240400,340,231,59.54,40.46,307,22,48,213,70,0,104,167,37,84,0,67,166,0,8,1132
631,546,85,312,234,1992,908,161500,389,242,61.65,38.35,396,46,24,34,6,0,27,27,4,0,24,326,73,0,0,1133
834,708,126,612,96,1975,714,183100,693,141,83.09,16.91,201,55,118,27,261,28,47,0,0,0,94,268,93,31,52,1134
553,452,101,217,235,1997,1212,238700,396,157,71.61,28.39,231,23,27,14,32,0,139,24,0,0,0,35,90,14,25,1135
290,267,23,214,53,1984,1798,259600,290,0,100.00,0.00,41,105,29,169,0,0,0,0,47,0,0,106,152,0,24,1136
288,200,88,159,41,1975,433,398200,176,112,61.11,38.89,71,54,38,52,55,0,0,30,0,0,35,109,41,0,0,1137
661,646,15,429,217,1939,1614,562500,567,94,85.78,14.22,23,23,12,23,577,0,12,40,57,0,13,18,51,100,306,1138
546,481,65,297,184,1978,712,124300,270,276,49.45,50.55,128,40,108,75,95,28,98,0,0,0,72,86,20,32,0,1139
597,522,75,318,204,1957,944,155600,492,105,82.41,17.59,51,6,110,125,415,52,258,53,12,0,0,255,6,0,0,1140
281,281,0,246,35,1981,0,437300,281,0,100.00,0.00,113,33,44,70,117,0,0,0,15,0,0,10,179,60,113,1141
995,891,104,136,755,1974,1056,229200,104,891,10.45,89.55,203,181,122,135,333,31,411,313,22,0,0,93,0,28,0,1142
387,347,40,347,0,1955,0,247500,387,0,100.00,0.00,0,34,14,33,251,0,0,0,0,0,0,97,194,29,0,1143
440,440,0,197,243,1956,1256,549800,187,253,42.50,57.50,235,33,9,19,223,0,71,150,0,42,0,0,19,20,191,1144
657,657,0,499,158,1939,1577,490100,581,76,88.43,11.57,50,0,0,33,635,0,14,34,15,0,21,18,165,242,209,1145
1216,1085,131,38,1047,1999,1127,166700,486,730,39.97,60.03,359,362,185,15,217,12,595,273,0,0,0,48,15,0,0,1146
395,374,21,325,49,1974,0,386900,376,19,95.19,4.81,22,34,139,163,35,0,0,0,0,0,29,10,129,79,146,1147
598,598,0,522,76,1993,500,233100,379,219,63.38,36.62,422,148,100,20,0,0,49,0,0,0,34,212,156,111,55,1148
577,577,0,370,207,1947,1239,665600,423,154,73.31,26.69,32,28,0,34,544,0,43,16,94,0,0,0,26,45,375,1149
375,327,48,52,275,1965,1056,118300,246,129,65.60,34.40,0,27,13,0,242,0,87,42,36,0,13,104,0,0,0,1150
252,224,28,151,73,1977,1305,168900,206,46,81.75,18.25,108,0,85,23,7,0,38,64,0,0,0,105,16,0,0,1151
642,572,70,244,328,1939,648,91100,354,288,55.14,44.86,14,0,17,0,555,0,255,31,0,0,41,211,0,0,0,1152
815,770,45,731,39,1976,0,201300,815,0,100.00,0.00,311,43,397,34,97,0,7,51,0,0,17,576,199,0,0,1153
516,516,0,386,130,1995,1484,286500,440,76,85.27,14.73,427,111,22,19,0,0,44,35,58,36,19,13,224,150,0,1154
606,531,75,284,247,1939,1355,444500,400,206,66.01,33.99,47,10,0,17,409,0,40,92,65,0,10,12,94,106,40,1155
574,471,103,149,322,1939,1090,203600,419,155,73.00,27.00,69,0,15,109,339,84,100,74,0,0,9,147,118,0,0,1156
768,734,34,251,483,1977,1506,454300,273,495,35.55,64.45,271,26,83,34,285,102,85,192,12,33,0,0,128,51,96,1157
520,520,0,501,19,1979,0,618700,520,0,100.00,0.00,160,160,98,27,39,0,0,14,8,6,0,0,14,32,308,1158
628,559,69,196,363,1985,879,0,48,580,7.64,92.36,331,337,180,0,0,61,267,247,0,0,188,85,0,0,0,1159
570,475,95,162,313,1939,495,96600,173,397,30.35,69.65,0,46,44,28,381,104,243,0,0,0,127,25,0,0,0,1160
613,487,126,412,75,1963,1813,535000,404,209,65.91,34.09,184,60,105,76,94,0,20,0,14,0,0,0,141,46,236,1161
944,880,64,781,99,1991,1766,265400,923,21,97.78,2.22,623,173,116,0,55,0,0,71,43,29,19,118,401,150,110,1162
388,388,0,356,32,1974,0,428700,388,0,100.00,0.00,16,56,115,114,0,0,0,0,16,11,0,0,74,90,110,1163
485,445,40,208,237,1945,1184,180300,322,163,66.39,33.61,35,23,0,29,465,19,110,20,18,0,17,193,94,0,17,1164
806,700,106,323,377,1951,993,0,170,636,21.09,78.91,9,42,87,58,616,52,38,111,62,76,0,0,104,26,170,1165
923,777,146,454,323,1986,892,182100,549,374,59.48,40.52,409,84,91,0,16,0,112,37,0,0,129,221,52,0,0,1166
334,334,0,296,38,1958,0,162900,314,20,94.01,5.99,11,10,63,86,182,13,32,0,0,0,11,254,42,0,0,1167
782,611,171,343,268,1958,1033,228300,550,232,70.33,29.67,131,25,88,77,207,0,68,92,0,0,13,212,92,0,35,1168
694,680,14,531,149,2004,1414,258000,489,205,70.46,29.54,651,0,25,0,0,0,0,0,0,0,10,173,332,41,32,1169
701,693,8,597,96,2002,1843,380500,701,0,100.00,0.00,292,220,42,0,0,0,0,23,16,23,0,31,165,206,88,1170
696,520,176,348,172,1982,1170,423400,627,69,90.09,9.91,232,102,156,133,160,0,32,62,35,34,26,41,110,66,174,1171
384,331,53,158,173,1939,904,130600,338,46,88.02,11.98,34,0,39,48,273,0,118,34,0,0,32,147,27,0,0,1172
767,709,58,35,674,1939,293,265600,17,750,2.22,97.78,0,10,165,20,474,524,62,7,0,0,0,0,12,0,14,1173
439,439,0,98,341,1992,1243,225000,119,320,27.11,72.89,286,70,103,19,139,23,277,76,0,75,0,53,84,0,0,1174
640,598,42,334,264,2000,1397,320400,397,243,62.03,37.97,352,24,13,50,70,0,15,109,48,0,0,45,183,94,0,1175
661,640,21,313,327,1986,964,152700,161,500,24.36,75.64,206,199,404,0,28,54,171,115,0,62,108,276,16,0,0,1176
766,628,138,569,59,1993,1346,340200,670,96,87.47,12.53,426,66,77,0,16,0,0,0,0,0,0,33,323,58,87,1177
322,322,0,129,193,1974,1006,176800,204,118,63.35,36.65,117,33,101,0,149,41,133,16,0,0,0,101,0,26,19,1178
680,680,0,602,78,1955,1614,374600,671,9,98.68,1.32,56,48,49,152,422,0,25,35,36,0,0,0,201,165,203,1179
506,444,62,204,240,1976,1032,355600,187,319,36.96,63.04,70,109,22,194,127,31,155,49,0,0,0,110,57,30,60,1180
282,229,53,101,128,1950,625,86500,202,80,71.63,28.37,13,0,13,2,103,0,0,20,0,0,61,50,0,0,0,1181
901,836,65,326,510,2005,1068,181900,335,566,37.18,62.82,382,0,7,0,47,0,161,79,0,0,0,74,0,0,0,1182
604,557,47,198,359,1956,930,246000,328,276,54.30,45.70,128,115,74,147,425,277,199,55,33,0,0,47,81,43,0,1183
915,813,102,494,319,1947,901,130600,827,88,90.38,9.62,21,22,26,65,839,51,223,67,0,0,138,368,12,0,0,1184
465,376,89,330,46,1959,1219,164900,465,0,100.00,0.00,87,0,16,130,173,0,27,29,20,11,8,198,96,0,0,1185
843,718,125,334,384,1982,1168,325700,408,435,48.40,51.60,319,333,49,132,27,8,208,218,49,0,0,37,228,55,24,1186
344,344,0,222,122,1987,1446,244900,268,76,77.91,22.09,144,54,17,87,12,0,47,27,42,0,0,14,150,0,0,1187
614,546,68,457,89,1958,903,185600,507,107,82.57,17.43,103,54,60,44,241,7,37,3,0,0,62,154,82,16,6,1188
730,724,6,543,181,1979,1033,296500,613,117,83.97,16.03,233,146,189,83,110,0,71,53,22,0,113,90,204,108,64,1189
655,634,21,383,251,1941,710,157600,497,158,75.88,24.12,58,35,91,17,296,32,94,8,0,8,112,162,19,4,6,1190
448,411,37,307,104,1947,734,148400,436,12,97.32,2.68,31,101,10,59,323,14,13,0,49,0,14,342,41,0,11,1191
335,335,0,209,126,1954,763,112500,297,38,88.66,11.34,41,22,0,19,114,0,18,18,0,0,74,54,0,0,0,1192
363,363,0,310,53,1941,928,162800,363,0,100.00,0.00,0,0,0,0,377,0,11,128,0,0,28,196,0,0,0,1193
585,585,0,327,258,1982,961,202600,286,299,48.89,51.11,425,76,160,21,33,60,172,71,0,38,81,141,112,0,11,1194
417,417,0,352,65,1970,1664,269300,389,28,93.29,6.71,121,15,71,178,20,0,11,0,13,0,11,111,207,33,7,1195
661,612,49,430,182,1987,1664,484400,557,104,84.27,15.73,157,123,107,120,122,0,35,62,23,0,11,24,91,179,151,1196
884,884,0,292,592,1985,1188,388400,332,552,37.56,62.44,240,96,72,56,277,0,194,216,0,0,0,13,99,94,125,1197
716,716,0,598,118,1963,2355,846500,626,90,87.43,12.57,285,30,54,25,350,0,0,0,0,66,0,0,14,40,593,1198
386,373,13,180,193,1941,745,240900,229,157,59.33,40.67,10,0,16,30,291,22,49,46,0,0,0,119,59,24,0,1199
593,531,62,298,233,1939,1175,566900,301,292,50.76,49.24,43,23,11,28,463,37,96,29,41,41,0,21,11,73,191,1200
980,874,106,8,866,1980,1087,0,8,972,0.82,99.18,155,110,215,164,192,61,297,204,58,57,0,17,0,0,0,1201
606,570,36,315,255,1989,1190,213200,318,288,52.48,47.52,195,154,101,16,0,8,79,20,66,0,0,140,108,13,0,1202
741,660,81,490,170,2002,1573,218000,646,95,87.18,12.82,552,25,52,73,89,0,13,29,24,10,26,305,357,27,0,1203
32,32,0,19,13,1961,0,206300,22,10,68.75,31.25,84,69,109,63,26,0,12,13,0,0,184,73,69,0,0,1204
381,381,0,299,82,1965,1371,186300,363,18,95.28,4.72,85,45,54,227,15,0,0,55,42,0,30,139,99,0,18,1205
341,314,27,289,25,1968,0,227600,325,16,95.31,4.69,0,26,124,115,0,0,31,20,16,0,15,84,69,18,12,1206
996,986,10,583,403,1965,860,161500,828,168,83.13,16.87,242,144,237,86,329,109,347,7,0,0,57,399,63,0,16,1207
515,515,0,235,280,1983,749,211300,215,300,41.75,58.25,170,122,213,32,75,0,172,17,0,0,17,156,128,16,0,1208
351,351,0,273,78,1959,0,269400,332,19,94.59,5.41,56,45,55,68,206,0,20,17,54,12,36,37,148,33,16,1209
707,707,0,472,235,1950,890,108900,610,97,86.28,13.72,16,12,95,76,446,110,85,0,0,0,133,226,0,0,0,1210
1789,1181,608,1066,115,1987,887,372800,1613,176,90.16,9.84,685,208,176,219,347,31,13,3,0,0,52,98,373,118,344,1211
789,737,52,36,701,1985,1131,0,34,755,4.31,95.69,161,225,323,109,17,0,419,317,12,0,0,13,21,16,0,1212
637,613,24,222,391,1974,1007,206900,327,310,51.33,48.67,153,22,159,98,180,0,243,116,0,0,0,92,103,28,0,1213
311,311,0,223,88,1971,1473,286100,311,0,100.00,0.00,71,15,16,115,19,0,0,0,0,0,19,48,158,11,0,1214
1176,1000,176,202,798,2003,1077,189700,327,849,27.81,72.19,488,36,70,10,38,0,125,118,78,18,0,73,62,0,0,1215
245,245,0,133,112,1955,941,189000,218,27,88.98,11.02,0,22,26,0,204,0,19,38,16,0,0,61,108,10,0,1216
690,675,15,561,114,2005,1328,182500,677,13,98.12,1.88,530,12,0,0,0,0,20,113,0,0,0,284,32,0,12,1217
840,764,76,15,749,1986,1074,0,59,781,7.02,92.98,247,121,119,71,159,47,224,198,84,21,12,26,0,0,0,1218
388,342,46,257,85,1991,1201,165600,351,37,90.46,9.54,200,47,122,14,29,13,52,30,59,0,0,227,31,0,0,1219
487,406,81,280,126,1939,656,371700,301,186,61.81,38.19,65,107,26,35,218,89,55,10,0,0,0,37,89,13,42,1220
1296,1170,126,822,348,1988,1430,242000,1138,158,87.81,12.19,497,382,282,21,19,0,69,38,38,0,64,447,294,101,75,1221
370,312,58,172,140,1982,936,246600,185,185,50.00,50.00,24,106,38,136,23,9,123,17,0,11,0,89,63,15,0,1222
708,708,0,401,307,1978,1518,381000,302,406,42.66,57.34,316,237,103,41,254,0,145,255,40,14,0,50,86,79,91,1223
993,979,14,236,743,1993,1312,234900,261,732,26.28,73.72,770,86,93,77,0,0,146,506,177,0,0,77,101,0,19,1224
728,681,47,264,417,1978,982,129500,232,496,31.87,68.13,65,208,250,95,83,105,212,50,0,20,90,99,33,19,0,1225
894,783,111,301,482,1993,737,245600,193,701,21.59,78.41,267,176,223,77,143,77,316,69,39,0,143,96,62,16,11,1226
487,402,85,284,118,1939,1539,155400,457,30,93.84,6.16,0,0,19,26,345,0,0,73,0,0,19,267,16,0,0,1227
671,619,52,302,317,1976,1046,175000,491,180,73.17,26.83,227,154,125,126,167,25,248,14,0,0,13,271,107,0,12,1228
787,706,81,529,177,1992,1317,289000,692,95,87.93,12.07,542,156,102,46,99,0,101,70,20,0,0,94,364,134,109,1229
602,589,13,219,370,1967,1004,365300,284,318,47.18,52.82,9,97,88,244,121,22,142,79,18,0,0,7,168,84,9,1230
656,570,86,303,267,1960,971,182900,433,223,66.01,33.99,116,0,76,143,372,65,124,93,12,0,102,124,98,0,0,1231
503,503,0,242,261,1948,786,100700,469,34,93.24,6.76,73,0,115,101,318,7,339,22,0,0,90,85,0,0,8,1232
537,452,85,213,239,1941,1288,159200,486,51,90.50,9.50,20,0,22,136,274,0,33,47,23,0,27,241,43,0,0,1233
460,384,76,302,82,1983,725,184100,386,74,83.91,16.09,187,65,186,35,86,19,0,23,0,0,73,207,24,60,23,1234
904,796,108,409,387,1980,1166,185700,641,263,70.91,29.09,314,56,330,105,68,105,200,76,15,16,27,288,98,0,0,1235
891,852,39,508,344,1972,851,198600,510,381,57.24,42.76,95,88,380,52,311,57,269,15,42,0,113,322,108,0,0,1236
618,618,0,467,151,1992,1183,372300,530,88,85.76,14.24,237,93,45,15,11,0,29,11,0,30,0,43,98,73,117,1237
546,546,0,424,122,1956,1850,320000,513,33,93.96,6.04,104,23,55,112,439,16,46,12,0,0,0,38,293,208,111,1238
550,550,0,332,218,1955,871,119900,550,0,100.00,0.00,0,0,0,15,477,0,41,15,0,0,73,247,0,0,30,1239
727,652,75,186,466,1992,1482,517400,405,322,55.71,44.29,539,186,42,28,115,0,28,233,224,41,0,0,136,0,115,1240
829,777,52,382,395,1967,715,151900,599,230,72.26,27.74,393,75,111,14,256,122,249,0,0,0,203,251,0,0,0,1241
447,296,151,168,128,1981,675,0,115,332,25.73,74.27,92,132,291,12,100,71,217,24,0,0,107,37,0,0,35,1242
1191,1081,110,23,1058,1977,769,0,23,1168,1.93,98.07,169,119,522,283,107,33,1021,25,0,0,11,0,0,0,0,1243
296,273,23,163,110,1954,1434,158800,296,0,100.00,0.00,0,12,52,53,183,0,14,32,9,0,12,144,89,0,0,1244
982,967,15,212,755,1992,1059,222000,245,737,24.95,75.05,800,192,58,61,35,0,291,382,20,0,0,104,121,0,66,1245
695,602,93,281,321,1990,974,0,300,395,43.17,56.83,369,90,132,0,16,40,242,29,0,0,95,158,29,0,0,1246
502,473,29,369,104,1995,1255,257000,397,105,79.08,20.92,360,11,0,0,25,0,0,12,14,0,0,88,167,25,0,1247
479,439,40,401,38,1988,1158,175200,340,139,70.98,29.02,280,206,57,13,26,0,73,11,14,0,0,316,153,15,0,1248
831,831,0,176,655,1968,829,319600,65,766,7.82,92.18,166,72,85,17,460,265,269,19,80,0,17,62,29,10,0,1249
398,398,0,201,197,1959,926,499000,221,177,55.53,44.47,68,0,20,215,352,91,153,28,0,0,0,62,101,54,137,1250
334,334,0,239,95,1996,1201,174100,334,0,100.00,0.00,439,0,19,0,0,0,19,0,16,0,0,248,137,0,0,1251
393,370,23,305,65,1959,1809,456500,384,9,97.71,2.29,15,45,32,125,103,12,0,0,0,9,0,0,101,67,131,1252
441,412,29,391,21,1986,1675,274100,441,0,100.00,0.00,83,308,62,0,0,0,0,42,0,0,0,66,238,64,29,1253
273,251,22,104,147,1974,833,0,114,159,41.76,58.24,8,116,216,68,0,11,201,16,11,0,0,49,42,0,0,1254
483,483,0,234,249,1964,998,131300,418,65,86.54,13.46,120,21,87,87,281,47,65,56,43,0,14,313,51,7,0,1255
585,585,0,227,358,1977,879,188300,239,346,40.85,59.15,105,51,111,109,115,87,195,30,0,0,0,42,54,25,0,1256
370,315,55,191,124,1979,773,166500,246,124,66.49,33.51,125,65,174,23,68,0,177,15,0,0,8,161,47,7,0,1257
496,496,0,125,371,1950,880,133400,220,276,44.35,55.65,9,32,171,0,354,29,183,18,0,0,48,198,0,0,0,1258
758,690,68,516,174,1939,790,232900,670,88,88.39,11.61,0,0,21,21,671,0,38,63,0,0,15,386,123,24,27,1259
403,378,25,211,167,1959,1163,150800,336,67,83.37,16.63,32,0,27,34,296,0,80,17,0,0,65,154,47,0,0,1260
330,330,0,168,162,1951,660,102600,237,93,71.82,28.18,0,23,119,0,267,110,165,7,0,0,32,85,10,0,0,1261
532,511,21,402,109,1945,850,133100,525,7,98.68,1.32,19,8,40,44,609,36,113,11,0,0,85,421,14,0,0,1262
954,899,55,220,679,1993,1130,366700,336,618,35.22,64.78,449,77,75,34,204,0,193,207,16,0,0,80,136,64,82,1263
979,616,363,341,275,1975,604,139600,572,407,58.43,41.57,83,147,232,144,217,13,167,18,0,0,119,190,18,0,17,1264
931,863,68,441,422,1995,1260,208300,619,312,66.49,33.51,525,38,69,99,67,24,139,224,25,0,0,147,147,54,26,1265
404,291,113,186,105,1955,1060,160200,394,10,97.52,2.48,27,0,133,53,77,0,14,63,0,0,0,84,100,29,0,1266
364,291,73,151,140,1972,0,112300,191,173,52.47,47.53,0,11,52,23,237,45,87,11,0,0,88,0,14,0,0,1267
454,418,36,194,224,1966,1100,450900,305,149,67.18,32.82,134,0,70,58,315,0,69,91,77,13,0,14,131,97,37,1268
1086,1016,70,564,452,1996,803,175800,662,424,60.96,39.04,590,127,46,88,12,0,139,49,34,0,19,435,27,36,0,1269
754,656,98,186,470,2001,1362,417400,61,693,8.09,91.91,437,58,17,12,90,31,120,266,42,0,0,32,8,15,0,1270
539,506,33,345,161,1939,1401,734200,380,159,70.50,29.50,9,0,28,33,332,0,49,39,26,28,0,0,0,40,206,1271
713,652,61,398,254,1983,1015,357100,539,174,75.60,24.40,194,93,51,170,160,34,67,81,29,0,51,37,166,112,74,1272
807,807,0,655,152,1995,1452,250300,775,32,96.03,3.97,656,30,0,0,77,0,10,33,22,12,0,114,485,29,20,1273
413,390,23,65,325,2001,1026,282500,136,277,32.93,67.07,256,69,50,56,112,157,108,0,35,0,0,13,60,28,11,1274
543,534,9,465,69,1963,0,314200,532,11,97.97,2.03,54,31,76,74,139,0,10,14,0,29,0,33,151,90,47,1275
638,638,0,509,129,1995,988,150800,293,345,45.92,54.08,427,312,55,15,14,0,193,88,24,0,207,151,145,0,15,1276
333,303,30,152,151,1939,911,285000,185,148,55.56,44.44,0,0,33,48,166,0,80,16,0,8,0,27,42,27,13,1277
506,486,20,371,115,1951,1526,167800,496,10,98.02,1.98,40,0,21,65,472,0,12,11,58,0,8,319,94,0,0,1278
408,315,93,127,188,1993,1197,129000,107,301,26.23,73.77,278,61,20,60,0,0,43,168,0,0,0,108,100,0,0,1279
479,420,59,407,13,1992,0,365900,445,34,92.90,7.10,148,113,50,147,27,0,0,61,20,9,16,22,176,100,70,1280
387,343,44,164,179,1943,1034,269700,292,95,75.45,24.55,0,0,40,14,324,14,77,32,17,0,0,46,168,12,0,1281
461,373,88,266,107,1939,1228,257700,404,57,87.64,12.36,0,6,26,0,476,0,102,6,54,31,0,70,132,35,31,1282
795,380,415,273,107,1970,824,283100,655,140,82.39,17.61,208,97,86,80,254,4,35,3,0,0,15,136,49,30,47,1283
802,802,0,285,517,1981,1165,508500,387,415,48.25,51.75,221,124,65,17,351,0,224,56,16,131,0,13,125,103,95,1284
744,726,18,19,707,1998,708,0,0,744,0.00,100.00,627,33,15,0,0,34,546,28,0,0,0,15,0,0,0,1285
816,760,56,462,298,1972,1743,443500,645,171,79.04,20.96,139,89,70,108,232,0,43,91,12,9,0,0,36,141,236,1286
1529,1210,319,860,350,1983,709,149600,1066,463,69.72,30.28,423,263,236,90,206,13,72,53,0,0,128,314,47,48,37,1287
528,483,45,255,228,1978,527,152200,299,229,56.63,43.37,98,77,326,15,86,70,87,0,0,0,49,52,28,21,47,1288
689,571,118,127,444,1949,757,71700,449,240,65.17,34.83,58,7,69,20,513,148,273,31,0,0,73,93,6,0,0,1289
460,432,28,235,197,1965,1056,142900,341,119,74.13,25.87,39,13,114,33,222,78,69,17,0,0,64,165,13,0,0,1290
534,534,0,418,116,2000,1238,158800,507,27,94.94,5.06,626,20,0,0,0,0,0,48,0,0,0,558,6,0,0,1291
490,396,94,172,224,1982,808,119000,152,338,31.02,68.98,55,88,79,0,115,53,29,0,30,84,0,87,40,14,0,1292
528,520,8,469,51,1991,1644,298000,485,43,91.86,8.14,141,53,127,40,35,0,21,0,48,0,0,52,158,55,42,1293
471,434,37,409,25,1960,1277,263500,452,19,95.97,4.03,103,22,65,81,275,0,0,20,14,0,50,119,159,80,50,1294
511,451,60,214,237,0,1076,156000,356,155,69.67,30.33,8,0,0,24,500,0,158,14,0,0,11,224,0,0,0,1295
484,484,0,245,239,1971,780,321800,193,291,39.88,60.12,119,23,111,260,58,6,185,9,0,8,0,70,89,55,111,1296
488,390,98,309,81,2003,1882,244900,462,26,94.67,5.33,219,88,18,0,0,0,0,0,51,0,0,38,171,65,0,1297
482,482,0,321,161,1966,912,177800,354,128,73.44,26.56,43,52,42,187,223,11,20,86,12,0,0,203,154,0,17,1298
322,322,0,282,40,1987,1357,241500,322,0,100.00,0.00,96,56,42,36,80,0,13,63,3,0,0,40,138,30,23,1299
1008,967,41,38,929,1975,1395,0,0,1008,0.00,100.00,103,0,162,13,467,38,175,295,61,25,0,0,27,40,13,1300
618,570,48,412,158,1955,1103,213900,523,95,84.63,15.37,92,5,10,107,277,0,50,37,22,0,0,107,183,21,0,1301
296,296,0,296,0,1965,0,184600,217,79,73.31,26.69,0,30,46,68,125,0,0,0,16,0,0,159,94,0,0,1302
700,677,23,334,343,1967,954,197700,503,197,71.86,28.14,11,16,280,377,29,22,199,32,8,13,7,224,172,0,0,1303
918,918,0,155,763,1986,839,162300,105,813,11.44,88.56,224,248,206,78,131,220,295,54,15,133,0,113,0,9,0,1304
562,562,0,384,178,1988,1048,262200,189,373,33.63,66.37,93,173,61,0,0,0,38,0,0,0,37,93,111,27,21,1305
675,610,65,509,101,1995,1430,188000,599,76,88.74,11.26,324,68,53,0,37,0,0,40,36,0,0,277,97,0,32,1306
293,293,0,281,12,1982,0,309400,293,0,100.00,0.00,45,57,162,0,11,0,0,0,26,12,8,0,188,41,0,1307
433,420,13,221,199,1972,0,174700,297,136,68.59,31.41,60,21,100,29,120,51,16,25,0,0,27,114,63,0,12,1308
298,270,28,146,124,1948,1335,210800,272,26,91.28,8.72,10,45,173,13,227,23,131,33,42,0,0,173,55,0,0,1309
358,358,0,312,46,1978,0,432500,358,0,100.00,0.00,97,128,165,10,12,0,0,0,42,0,0,12,77,170,65,1310
765,765,0,334,431,1979,1135,175000,730,35,95.42,4.58,116,98,108,23,156,10,46,0,0,0,23,286,136,0,0,1311
502,482,20,299,183,1993,1125,292800,366,136,72.91,27.09,205,44,31,34,173,17,84,60,34,0,0,0,124,68,0,1312
318,318,0,250,68,1970,0,221200,318,0,100.00,0.00,0,12,34,132,153,0,0,33,0,0,13,285,0,0,0,1313
409,409,0,353,56,1968,0,276200,362,47,88.51,11.49,32,0,52,190,151,0,0,30,39,78,0,48,186,24,20,1314
929,806,123,242,564,1978,885,181100,167,762,17.98,82.02,290,345,214,14,14,0,424,27,0,0,35,137,59,35,14,1315
320,315,5,217,98,1983,950,151400,163,157,50.94,49.06,46,104,40,61,29,0,53,24,11,0,36,104,34,18,0,1316
778,702,76,393,309,1966,859,283000,452,326,58.10,41.90,55,95,88,114,360,14,197,47,0,0,0,94,238,15,14,1317
572,572,0,291,281,1941,625,110900,572,0,100.00,0.00,12,34,49,14,396,0,94,52,0,0,132,138,0,0,0,1318
829,791,38,587,204,1997,1682,234800,721,108,86.97,13.03,588,11,102,15,56,0,71,15,24,0,0,227,310,0,0,1319
1017,963,54,543,420,1989,1758,674700,596,421,58.60,41.40,459,548,236,0,11,0,32,335,257,33,0,23,45,58,374,1320
283,283,0,147,136,1942,1296,227700,242,41,85.51,14.49,24,0,17,35,293,0,0,89,0,0,0,88,177,0,15,1321
476,380,96,266,114,1981,644,142300,345,131,72.48,27.52,314,103,109,25,55,51,44,28,0,0,78,120,75,20,0,1322
725,562,163,468,94,1978,0,358800,497,228,68.55,31.45,117,97,144,50,217,10,78,11,0,0,40,88,122,55,136,1323
984,840,144,30,810,1979,742,159400,13,971,1.32,98.68,131,131,452,136,127,76,710,63,34,0,11,57,0,0,0,1324
579,537,42,358,179,1983,920,211400,396,183,68.39,31.61,260,186,57,0,95,11,106,130,82,11,0,81,152,0,0,1325
424,424,0,350,74,1981,1545,224300,378,46,89.15,10.85,21,200,301,10,0,0,79,55,0,0,9,257,132,0,0,1326
555,510,45,70,440,1984,872,109200,96,459,17.30,82.70,398,218,71,52,0,10,470,88,0,0,18,97,9,0,0,1327
713,713,0,243,470,1969,747,163900,310,403,43.48,56.52,15,46,154,149,284,97,126,32,14,0,20,218,16,0,23,1328
285,274,11,106,168,1945,599,107800,163,122,57.19,42.81,0,0,18,0,290,10,92,44,0,0,46,61,0,0,0,1329
711,691,20,283,408,1994,1112,259000,231,480,32.49,67.51,448,44,36,69,150,30,310,54,12,0,17,72,92,68,8,1330
424,408,16,174,234,1963,892,195800,227,197,53.54,46.46,10,0,70,183,215,34,255,19,0,0,0,110,53,0,7,1331
389,371,18,300,71,1953,1426,529700,339,50,87.15,12.85,16,0,65,30,385,0,46,0,10,0,10,0,52,124,245,1332
454,454,0,359,95,1939,2471,646600,413,41,90.97,9.03,52,98,23,0,329,0,33,69,13,0,16,0,0,59,277,1333
242,242,0,199,43,1962,0,623800,242,0,100.00,0.00,0,73,37,36,137,0,0,0,0,0,0,0,70,35,104,1334
747,694,53,145,549,1989,896,194700,364,383,48.73,51.27,213,314,168,0,67,53,413,44,0,14,0,109,38,17,26,1335
503,485,18,94,391,1987,1109,0,0,503,0.00,100.00,150,252,105,16,93,103,157,277,0,0,55,13,0,0,0,1336
447,427,20,144,283,1976,868,234400,252,195,56.38,43.62,60,69,226,78,39,78,138,58,41,0,0,86,61,0,0,1337
341,324,17,280,44,1954,1925,268500,329,12,96.48,3.52,33,0,17,69,293,0,16,51,14,14,0,133,164,20,0,1338
539,516,23,440,76,1985,0,397900,436,103,80.89,19.11,88,221,62,23,102,0,25,0,0,38,0,36,127,110,104,1339
833,766,67,418,348,1978,1146,398800,374,459,44.90,55.10,155,92,108,168,352,141,192,186,17,30,17,13,84,60,135,1340
264,182,82,75,107,1939,1298,179400,178,86,67.42,32.58,55,0,77,37,322,16,87,32,38,15,16,271,16,0,0,1341
1341,1242,99,255,987,1961,1021,266300,51,1290,3.80,96.20,135,127,136,231,502,152,563,164,0,16,0,15,172,15,0,1342
1200,1133,67,810,323,1986,1251,27100,249,951,20.75,79.25,370,336,376,81,38,15,179,55,9,0,710,76,82,0,0,1343
442,376,66,219,157,1973,725,125400,228,214,51.58,48.42,53,68,113,83,123,47,48,2,0,0,179,68,37,0,0,1344
537,439,98,333,106,1958,558,158400,401,136,74.67,25.33,96,33,65,44,298,28,47,10,0,0,157,131,72,0,0,1345
832,832,0,620,212,1993,1349,161000,704,128,84.62,15.38,587,36,181,10,12,0,68,149,93,0,78,200,226,0,0,1346
438,438,0,395,43,1981,1519,286200,424,14,96.80,3.20,114,110,117,122,15,0,0,0,0,0,11,17,272,124,54,1347
595,538,57,200,338,1953,759,87900,463,132,77.82,22.18,52,0,40,41,467,57,218,0,0,0,160,106,0,0,0,1348
552,552,0,279,273,1984,907,9999,58,494,10.51,89.49,236,72,179,107,0,8,441,12,10,0,123,0,0,0,0,1349
249,249,0,238,11,2004,0,628600,249,0,100.00,0.00,149,12,0,0,0,0,0,0,0,0,0,0,0,9,139,1350
417,392,25,241,151,1972,972,304300,327,90,78.42,21.58,107,96,156,84,68,0,62,10,25,0,45,28,186,73,20,1351
605,550,55,340,210,2002,1663,233400,482,123,79.67,20.33,428,15,59,81,101,31,23,40,16,11,43,104,314,10,21,1352
848,808,40,225,583,1970,1315,0,169,679,19.93,80.07,71,31,519,244,134,0,141,425,84,18,0,95,110,12,114,1353
596,543,53,231,312,1959,890,360100,255,341,42.79,57.21,138,114,57,60,318,0,193,165,0,0,0,0,128,86,29,1354
868,726,142,202,524,1968,781,143900,226,642,26.04,73.96,252,105,82,122,357,133,391,192,0,48,16,103,14,0,7,1355
639,541,98,430,111,1946,836,187000,523,116,81.85,18.15,61,0,35,36,211,7,16,35,0,0,33,115,88,0,0,1356
912,862,50,370,492,1974,768,208900,507,405,55.59,44.41,428,85,436,108,344,118,482,164,0,15,14,162,296,0,0,1357
518,490,28,319,171,1951,1033,300600,387,131,74.71,25.29,65,12,19,34,334,0,71,23,47,0,11,29,124,90,11,1358
267,258,9,167,91,1945,996,186900,257,10,96.25,3.75,36,0,10,0,417,0,140,22,0,0,10,171,120,0,0,1359
428,326,102,163,163,1939,958,184000,240,188,56.07,43.93,29,69,0,0,279,21,129,101,5,0,0,91,30,0,0,1360
676,633,43,212,421,1994,1438,198900,53,623,7.84,92.16,682,58,36,0,0,0,81,304,12,8,0,92,109,7,13,1361
364,364,0,301,63,1947,854,156100,336,28,92.31,7.69,0,19,10,29,324,0,26,12,0,0,24,320,0,0,0,1362
475,475,0,355,120,1939,1833,564200,435,40,91.58,8.42,0,12,59,11,592,0,23,62,21,10,0,13,53,123,369,1363
424,424,0,283,141,1951,1683,324200,414,10,97.64,2.36,61,42,0,72,329,0,13,16,0,0,0,51,252,73,38,1364
386,302,84,260,42,1939,1580,236000,386,0,100.00,0.00,8,0,0,8,262,0,10,8,0,0,18,53,145,20,12,1365
445,391,54,112,279,1976,840,187500,133,312,29.89,70.11,33,185,109,275,0,72,343,0,5,0,0,79,71,0,0,1366
235,235,0,235,0,1996,0,248200,235,0,100.00,0.00,284,0,0,0,0,0,28,0,0,0,0,94,93,0,0,1367
310,291,19,106,185,1974,866,170800,136,174,43.87,56.13,0,18,122,64,150,13,178,11,0,0,23,93,27,0,0,1368
353,309,44,89,220,1971,666,80900,185,168,52.41,47.59,74,14,15,64,248,135,54,46,0,0,0,120,17,0,0,1369
697,671,26,450,221,1939,1781,532900,655,42,93.97,6.03,8,6,15,15,604,0,9,47,101,75,0,33,29,76,201,1370
402,351,51,155,196,1954,1009,135800,301,101,74.88,25.12,30,0,23,44,316,0,96,38,0,0,40,167,9,0,0,1371
530,471,59,266,205,1959,811,94800,378,152,71.32,28.68,70,90,34,42,280,79,102,0,0,0,181,154,0,0,0,1372
982,910,72,567,343,1990,1235,223200,597,385,60.79,39.21,425,253,200,22,39,0,92,62,48,0,45,242,391,0,0,1373
619,619,0,285,334,1964,288,280600,319,300,51.53,48.47,0,64,89,86,70,39,19,7,19,23,0,72,102,17,11,1374
1558,1408,150,474,934,2001,1139,277500,461,1097,29.59,70.41,848,246,142,157,26,24,302,203,14,45,287,63,296,76,0,1375
542,517,25,321,196,1964,759,185500,379,163,69.93,30.07,79,0,82,163,206,0,125,40,60,0,0,158,147,0,0,1376
422,349,73,324,25,1939,637,243800,391,31,92.65,7.35,58,7,0,0,252,0,14,22,31,0,15,70,100,29,36,1377
395,308,87,181,127,1939,1125,142400,356,39,90.13,9.87,17,0,25,15,272,0,47,10,0,0,48,168,31,0,0,1378
756,713,43,328,385,1973,1085,345500,414,342,54.76,45.24,85,142,285,90,181,51,124,51,0,54,11,110,73,117,71,1379
291,279,12,256,23,1979,0,378900,291,0,100.00,0.00,0,114,231,11,10,0,0,0,43,18,13,0,131,89,28,1380
594,594,0,413,181,1939,1418,637000,456,138,76.77,23.23,49,12,27,88,377,0,177,79,0,23,0,0,26,37,200,1381
418,356,62,304,52,1968,0,362500,404,14,96.65,3.35,69,27,62,21,100,0,13,8,0,0,0,27,13,92,126,1382
792,685,107,564,121,1973,1280,352400,696,96,87.88,12.12,121,95,234,40,243,13,91,12,15,0,68,142,183,42,88,1383
445,445,0,349,96,1988,1119,253000,312,133,70.11,29.89,273,22,108,0,50,42,0,0,0,13,0,52,129,163,12,1384
586,586,0,509,77,1979,1201,283300,586,0,100.00,0.00,218,119,203,27,9,0,0,11,9,0,0,83,340,67,35,1385
374,307,67,277,30,1982,0,212000,220,154,58.82,41.18,163,117,89,14,0,0,13,46,0,0,39,104,138,20,6,1386
464,424,40,156,268,1967,638,98500,226,238,48.71,51.29,60,56,26,13,321,64,86,0,0,0,156,157,0,0,0,1387
571,518,53,166,352,1965,1174,596200,261,310,45.71,54.29,164,176,51,64,240,0,179,165,81,0,0,0,32,33,142,1388
881,723,158,56,667,1977,748,99300,89,792,10.10,89.90,159,266,231,12,91,38,411,0,0,0,30,52,12,0,0,1389
558,489,69,216,273,1980,898,240500,241,317,43.19,56.81,153,77,257,131,87,0,277,72,0,34,0,159,54,28,26,1390
496,496,0,459,37,1976,0,162900,478,18,96.37,3.63,115,23,205,74,56,0,16,0,0,0,78,335,30,14,0,1391
982,931,51,288,643,1951,622,90100,565,417,57.54,42.46,9,68,180,130,619,222,472,37,0,0,199,39,8,0,0,1392
700,614,86,269,345,1986,1036,118800,186,514,26.57,73.43,267,115,172,33,25,0,157,102,11,0,0,219,44,25,0,1393
479,442,37,382,60,1986,1110,384300,430,49,89.77,10.23,112,95,96,57,123,0,12,166,0,20,7,68,39,30,113,1394
398,281,117,241,40,1976,0,429800,319,79,80.15,19.85,23,125,119,22,22,0,84,54,0,0,0,54,75,34,10,1395
842,822,20,706,116,2004,1468,206600,645,197,76.60,23.40,511,21,33,10,0,0,9,36,19,0,49,232,201,16,13,1396
505,459,46,414,45,1986,1740,342600,479,26,94.85,5.15,147,130,213,51,31,0,0,20,9,0,11,62,135,179,124,1397
542,542,0,482,60,1976,779,308900,434,108,80.07,19.93,100,40,112,52,131,0,40,16,0,0,0,31,168,58,77,1398
495,495,0,415,80,1968,0,243000,390,105,78.79,21.21,42,143,76,84,49,0,13,0,0,0,0,167,101,16,36,1399
535,526,9,388,138,2001,1693,269200,509,26,95.14,4.86,344,0,0,0,0,0,0,31,10,0,0,88,207,8,0,1400
494,494,0,157,337,1939,857,387700,172,322,34.82,65.18,29,0,109,56,385,19,286,0,0,0,0,29,79,0,64,1401
475,475,0,475,0,1977,0,397700,475,0,100.00,0.00,85,84,169,141,45,0,0,50,28,0,0,83,61,105,180,1402
366,303,63,90,213,1980,1072,363000,185,181,50.55,49.45,59,0,76,12,200,0,116,55,42,0,0,0,24,0,41,1403
304,304,0,201,103,1948,1642,418100,273,31,89.80,10.20,9,0,29,29,233,6,0,18,19,0,0,21,179,57,0,1404
810,772,38,113,659,1974,910,220600,176,634,21.73,78.27,28,210,301,177,102,0,573,46,30,0,0,32,87,0,0,1405
582,525,57,482,43,1970,1388,234800,566,16,97.25,2.75,162,91,50,137,120,0,8,11,30,0,0,113,238,82,24,1406
335,335,0,301,34,1966,0,271600,335,0,100.00,0.00,14,0,104,80,160,0,0,11,58,0,0,42,138,95,14,1407
913,913,0,112,801,1966,1143,484000,297,616,32.53,67.47,221,125,158,110,245,9,271,224,0,32,0,15,53,60,135,1408
1266,1180,86,501,679,1979,852,186700,596,670,47.08,52.92,412,32,413,39,9,0,330,44,0,0,0,432,8,11,0,1409
463,421,42,179,242,1952,817,94600,402,61,86.83,13.17,42,24,122,15,227,70,51,20,0,13,76,200,0,0,0,1410
774,717,57,53,664,1967,1078,411700,117,657,15.12,84.88,182,139,159,167,326,15,545,219,50,61,0,0,14,14,11,1411
732,732,0,493,239,1976,1098,224800,571,161,78.01,21.99,253,95,232,118,108,25,94,51,3,0,121,136,250,61,52,1412
396,329,67,204,125,1967,766,169800,324,72,81.82,18.18,89,17,44,79,203,0,92,0,15,0,23,283,9,0,10,1413
998,975,23,821,154,2002,1663,402600,828,170,82.97,17.03,289,53,184,118,66,0,43,54,39,0,117,23,133,51,220,1414
508,472,36,406,66,1964,797,241800,404,104,79.53,20.47,77,62,26,79,275,0,0,44,34,0,99,90,163,20,31,1415
169,169,0,148,21,1967,0,384800,102,67,60.36,39.64,0,0,119,162,15,38,16,0,0,15,0,65,32,70,60,1416
267,243,24,140,103,1975,575,163200,193,74,72.28,27.72,34,23,182,12,22,0,0,23,0,0,0,157,42,15,0,1417
431,344,87,333,11,1986,0,228200,320,111,74.25,25.75,114,100,79,114,39,0,0,10,23,0,0,91,146,91,0,1418
393,393,0,344,49,1959,1330,144500,393,0,100.00,0.00,0,0,12,89,118,0,0,15,49,0,0,88,0,0,0,1419
645,645,0,349,296,1939,1361,576900,423,222,65.58,34.42,53,52,29,22,555,12,71,38,99,34,9,11,49,51,280,1420
369,358,11,211,147,1963,470,0,183,186,49.59,50.41,82,95,109,0,184,79,47,17,0,0,215,31,0,0,17,1421
440,73,367,57,16,1977,1182,0,404,36,91.82,8.18,119,29,136,35,97,0,0,18,0,0,0,0,0,0,15,1422
730,730,0,472,258,1957,634,131300,603,127,82.60,17.40,133,53,181,43,525,132,250,0,17,0,98,317,64,0,0,1423
430,383,47,30,353,1958,631,118800,289,141,67.21,32.79,138,23,34,74,241,172,216,9,8,0,27,49,0,0,0,1424
570,570,0,483,87,1954,964,118000,570,0,100.00,0.00,0,0,0,53,373,0,130,0,0,0,134,151,0,0,0,1425
1046,1002,44,493,509,1984,645,110200,453,593,43.31,56.69,294,148,167,43,378,179,214,30,0,0,227,233,45,0,11,1426
1025,974,51,632,342,1993,915,207500,702,323,68.49,31.51,747,43,89,44,212,15,260,68,12,0,0,437,221,0,0,1427
490,414,76,212,202,1939,932,158500,355,135,72.45,27.55,7,11,20,24,362,76,135,11,0,0,0,102,57,0,10,1428
509,462,47,197,265,1971,807,180100,268,241,52.65,47.35,83,122,72,16,163,37,141,68,0,0,19,77,16,0,0,1429
4,4,0,4,0,0,0,0,4,0,100.00,0.00,12,0,0,0,0,0,12,0,0,0,0,0,0,0,0,1430
608,556,52,226,330,1973,834,246000,245,363,40.30,59.70,161,82,158,15,36,24,154,26,0,0,0,121,64,0,29,1431
419,353,66,235,118,1944,0,116800,317,102,75.66,24.34,60,12,16,93,338,138,117,0,0,0,37,93,0,0,0,1432
207,148,59,102,46,1968,738,150000,123,84,59.42,40.58,52,19,32,33,56,12,16,3,0,0,36,23,0,0,17,1433
352,307,45,284,23,2005,0,269500,352,0,100.00,0.00,217,23,12,40,0,0,0,14,0,0,0,153,77,0,12,1434
1271,1227,44,877,350,1997,1092,116200,811,460,63.81,36.19,562,52,146,0,69,35,78,41,0,0,215,395,0,0,9,1435
580,510,70,74,436,1965,496,66300,177,403,30.52,69.48,111,7,145,128,313,352,80,45,0,0,98,88,0,0,0,1436
668,633,35,370,263,1958,781,126500,555,113,83.08,16.92,29,38,51,183,376,8,84,42,0,0,94,415,0,7,0,1437
390,375,15,187,188,1956,844,147300,258,132,66.15,33.85,0,13,137,107,180,26,110,30,0,0,8,190,0,0,0,1438
411,314,97,205,109,1948,1246,185600,388,23,94.40,5.60,110,0,14,0,254,14,21,84,0,0,13,121,9,0,0,1439
309,309,0,282,27,1949,0,238300,309,0,100.00,0.00,31,0,15,19,315,0,0,15,0,0,0,66,209,0,15,1440
595,549,46,293,256,1980,1649,329500,414,181,69.58,30.42,157,196,93,83,22,10,24,44,12,51,10,74,160,72,33,1441
294,265,29,180,85,1939,1456,209300,266,28,90.48,9.52,12,0,0,12,267,14,12,49,13,0,37,121,12,0,0,1442
412,367,45,250,117,1945,771,153400,308,104,74.76,25.24,0,0,38,55,321,0,63,71,0,0,46,169,25,0,0,1443
278,278,0,278,0,1946,0,239500,278,0,100.00,0.00,12,18,21,0,219,19,0,31,0,0,0,112,91,17,0,1444
601,601,0,532,69,1993,1486,236100,445,156,74.04,25.96,531,68,125,10,19,0,0,62,8,10,145,106,336,41,45,1445
441,406,35,182,224,1982,1262,131600,85,356,19.27,80.73,55,136,232,49,39,0,110,111,0,13,39,121,31,0,0,1446
566,532,34,425,107,1980,866,333500,466,100,82.33,17.67,159,91,79,62,120,0,34,11,0,0,9,148,103,105,57,1447
270,270,0,229,41,1970,0,324400,236,34,87.41,12.59,43,10,94,19,84,0,10,0,0,0,9,64,73,28,18,1448
467,422,45,164,258,1996,1007,192200,245,222,52.46,47.54,344,20,40,53,19,0,197,24,0,0,0,164,41,0,0,1449
771,726,45,429,297,1980,934,245600,537,234,69.65,30.35,161,70,261,120,50,34,154,64,0,0,0,227,145,0,26,1450
415,415,0,366,49,1981,0,198700,415,0,100.00,0.00,170,162,304,0,14,0,61,88,19,0,0,339,143,0,0,1451
927,894,33,254,640,1982,961,188100,425,502,45.85,54.15,361,370,281,22,0,0,408,225,66,77,52,154,52,0,0,1452
772,772,0,303,469,1978,1123,187000,612,160,79.27,20.73,102,84,466,13,0,39,77,169,0,0,0,348,32,0,0,1453
602,588,14,257,331,1962,928,153800,456,146,75.75,24.25,99,26,103,86,275,0,122,107,0,0,25,212,71,12,0,1454
986,959,27,842,117,1999,1940,307500,971,15,98.48,1.52,815,0,0,11,11,0,0,23,10,0,14,60,219,170,281,1455
309,287,22,205,82,1947,879,174500,270,39,87.38,12.62,11,42,57,35,143,0,100,22,0,0,0,123,43,0,0,1456
756,710,46,268,442,1992,999,163800,355,401,46.96,53.04,468,160,158,0,31,11,265,122,11,0,37,293,15,0,0,1457
932,915,17,791,124,1984,1464,268300,895,37,96.03,3.97,140,77,567,34,10,0,29,55,64,0,13,285,292,27,30,1458
342,313,29,240,73,1963,0,192000,315,27,92.11,7.89,69,0,18,66,214,57,60,18,0,0,39,167,26,0,0,1459
582,554,28,508,46,1994,0,315600,564,18,96.91,3.09,337,89,96,0,0,0,0,0,0,0,0,244,144,92,42,1460
601,532,69,359,173,1980,872,208500,306,295,50.92,49.08,328,74,145,0,89,16,58,75,0,0,113,224,105,0,0,1461
488,405,83,250,155,1974,1241,144000,364,124,74.59,25.41,42,62,115,65,92,0,88,7,0,131,0,144,6,0,0,1462
382,382,0,343,39,1955,717,117000,354,28,92.67,7.33,33,0,64,44,298,0,56,8,0,0,119,199,36,21,0,1463
876,841,35,506,335,1974,861,189600,446,430,50.91,49.09,74,42,417,118,43,43,143,10,14,0,138,297,39,10,0,1464
326,238,88,183,55,1983,0,0,56,270,17.18,82.82,124,170,104,0,13,0,27,0,0,0,154,158,0,0,21,1465
863,863,0,428,435,1963,728,143500,494,369,57.24,42.76,25,39,330,74,367,70,361,0,0,0,11,293,0,0,0,1466
258,258,0,214,44,1960,712,157400,200,58,77.52,22.48,7,8,188,102,65,0,57,32,0,0,15,170,44,0,17,1467
348,348,0,287,61,1963,950,187300,348,0,100.00,0.00,0,36,109,168,94,0,66,0,0,0,53,212,27,0,20,1468
1045,888,157,86,802,1975,702,136400,109,936,10.43,89.57,128,272,440,120,120,161,656,18,0,73,0,34,0,0,0,1469
407,407,0,265,142,1972,862,158400,380,27,93.37,6.63,0,0,250,59,106,0,35,35,0,0,11,334,0,0,0,1470
496,448,48,57,391,1973,708,129200,57,439,11.49,88.51,23,60,345,0,93,46,332,5,0,0,23,51,0,0,0,1471
314,314,0,203,111,1974,674,0,134,180,42.68,57.32,128,101,99,56,9,31,103,0,0,0,196,24,0,9,0,1472
480,417,63,164,253,1973,624,137500,213,267,44.38,55.63,45,97,167,89,72,131,115,0,0,0,31,155,0,0,10,1473
979,979,0,248,731,1979,758,183700,271,708,27.68,72.32,65,281,470,86,29,29,635,25,0,0,0,92,110,0,0,1474
1191,1080,111,217,863,1997,1060,121900,211,980,17.72,82.28,823,75,295,0,10,0,619,195,0,0,0,185,177,10,0,1475
517,464,53,317,147,1978,960,191600,396,121,76.60,23.40,57,118,277,10,23,0,145,0,0,0,12,233,86,0,9,1476
825,815,10,375,440,1972,1039,167300,497,328,60.24,39.76,80,50,320,67,230,33,270,33,23,0,13,273,14,0,0,1477
313,282,31,219,63,1985,0,195200,313,0,100.00,0.00,22,310,53,0,0,0,15,81,24,0,0,155,110,0,0,1478
790,766,24,303,463,1963,771,142000,415,375,52.53,47.47,40,85,224,230,344,10,592,19,27,0,26,132,0,0,0,1479
542,516,26,284,232,1960,749,141200,370,172,68.27,31.73,59,0,167,43,255,12,255,0,0,0,0,216,23,0,8,1480
396,396,0,264,132,1947,1287,212000,363,33,91.67,8.33,23,0,18,0,452,0,31,62,0,0,0,144,113,0,0,1481
298,281,17,142,139,1939,822,223000,222,76,74.50,25.50,8,8,56,18,228,8,100,0,0,0,0,57,123,6,0,1482
293,286,7,221,65,1961,1170,230700,274,19,93.52,6.48,11,14,83,87,170,0,22,25,0,0,16,119,76,56,51,1483
478,392,86,242,150,1945,662,150000,367,111,76.78,23.22,122,11,49,32,237,22,2,20,0,0,38,92,38,0,6,1484
474,466,8,201,265,1939,590,223400,250,224,52.74,47.26,0,7,81,0,437,80,91,0,32,0,30,117,39,23,39,1485
348,330,18,11,319,1982,788,0,86,262,24.71,75.29,139,163,29,47,84,42,366,14,0,0,0,17,0,23,0,1486
612,540,72,95,445,1961,643,163200,204,408,33.33,66.67,13,20,55,38,455,90,248,114,11,0,8,36,15,8,8,1487
1476,561,915,451,110,1983,688,182400,1058,418,71.68,28.32,329,224,359,202,136,15,87,0,0,0,89,174,107,59,72,1488
586,574,12,496,78,1984,1534,299200,565,21,96.42,3.58,58,393,51,57,24,0,8,18,9,0,0,37,354,35,66,1489
792,726,66,335,391,1981,1052,42900,86,706,10.86,89.14,255,231,60,132,71,0,284,78,37,0,176,68,46,0,12,1490
1032,915,117,111,804,1980,1084,114600,186,846,18.02,81.98,144,243,246,102,17,25,496,97,27,10,0,33,20,10,0,1491
546,480,66,448,32,1987,0,565600,546,0,100.00,0.00,130,371,0,0,0,0,0,0,0,0,18,0,0,73,410,1492
631,631,0,528,103,1978,1430,218800,619,12,98.10,1.90,125,72,192,0,100,0,12,47,15,0,0,134,281,0,0,1493
611,475,136,458,17,1975,0,381300,579,32,94.76,5.24,163,69,54,82,23,0,0,0,0,0,68,42,144,29,102,1494
545,545,0,307,238,1983,992,195300,426,119,78.17,21.83,198,163,48,153,6,0,157,22,0,0,8,185,130,10,0,1495
528,518,10,417,101,2004,1763,258600,465,63,88.07,11.93,299,46,42,8,28,0,0,62,26,0,11,87,189,28,20,1496
832,749,83,549,200,2000,1462,276600,803,29,96.51,3.49,464,151,36,99,30,0,63,59,10,0,0,77,418,24,17,1497
788,734,54,644,90,1990,1231,221200,510,278,64.72,35.28,324,307,158,7,3,7,21,141,13,0,40,177,238,78,39,1498
511,454,57,396,58,2004,1953,241100,499,12,97.65,2.35,259,12,16,0,0,0,12,0,15,0,0,23,204,17,16,1499
1209,1121,88,129,992,1996,881,250400,129,1080,10.67,89.33,772,141,331,21,11,130,492,267,9,0,92,29,121,0,0,1500
572,542,30,379,163,1990,1190,182500,527,45,92.13,7.87,237,136,121,31,36,12,48,23,0,0,71,222,86,24,24,1501
388,388,0,324,64,1993,1170,235900,388,0,100.00,0.00,384,24,81,51,26,0,49,46,26,23,0,197,163,43,4,1502
414,414,0,389,25,1993,0,176000,269,145,64.98,35.02,207,146,0,13,0,0,0,33,0,0,66,222,0,0,0,1503
445,445,0,385,60,1981,1130,376800,440,5,98.88,1.12,137,73,103,76,116,0,31,4,0,0,0,15,35,48,209,1504
1343,1256,87,897,359,1996,1233,200200,1030,313,76.69,23.31,887,107,71,0,14,0,26,28,30,37,0,226,386,69,20,1505
486,486,0,216,270,2000,1354,0,386,100,79.42,20.58,93,11,122,15,0,15,72,5,0,0,24,71,0,17,0,1506
707,666,41,626,40,1985,0,364600,697,10,98.59,1.41,477,83,88,35,101,0,20,0,0,0,17,25,164,144,305,1507
1022,948,74,738,210,1994,1270,216300,817,205,79.94,20.06,499,151,197,21,28,0,79,59,0,0,13,358,290,11,11,1508
515,515,0,313,202,1980,1338,165000,504,11,97.86,2.14,217,46,230,29,0,0,0,123,0,0,0,243,156,0,0,1509
875,861,14,188,673,1969,675,145000,308,567,35.20,64.80,120,37,359,161,379,154,517,81,0,0,17,235,0,0,0,1510
274,237,37,237,0,1978,0,230200,274,0,100.00,0.00,122,38,29,33,0,0,0,66,0,0,0,26,130,0,0,1511
475,475,0,397,78,1984,1417,194700,475,0,100.00,0.00,252,65,118,64,94,0,17,47,0,0,16,381,132,0,0,1512
386,386,0,329,57,1984,777,324200,325,61,84.20,15.80,91,51,111,17,101,0,41,0,0,0,14,29,82,83,51,1513
419,398,21,119,279,1940,677,196400,143,276,34.13,65.87,104,29,0,8,239,19,203,10,0,0,11,34,30,0,19,1514
290,209,81,115,94,1939,928,120300,272,18,93.79,6.21,0,0,0,35,344,0,82,44,0,0,75,99,0,0,0,1515
209,152,57,53,99,1939,646,116000,168,41,80.38,19.62,0,7,27,9,249,14,63,0,0,0,72,32,9,0,0,1516
292,237,55,57,180,1939,808,68400,258,34,88.36,11.64,28,0,68,6,259,32,142,0,0,0,31,100,0,0,0,1517
780,780,0,715,65,2005,1419,194200,780,0,100.00,0.00,410,0,14,0,0,0,56,61,15,0,0,247,29,0,0,1518
707,507,200,367,140,1958,596,178100,655,52,92.64,7.36,164,71,41,62,235,0,68,0,0,0,118,141,47,4,53,1519
674,665,9,595,70,1981,1859,397800,654,20,97.03,2.97,211,161,269,0,53,0,14,11,0,24,22,58,140,126,281,1520
759,759,0,644,115,2002,1701,227500,759,0,100.00,0.00,710,29,19,0,58,0,0,35,52,0,32,84,530,27,27,1521
812,786,26,696,90,2005,1826,277500,812,0,100.00,0.00,294,25,72,0,87,39,0,42,52,6,0,84,146,95,14,1522
988,944,44,300,644,1990,1336,466700,338,650,34.21,65.79,419,383,221,0,0,0,175,355,70,0,0,99,45,64,75,1523
344,344,0,201,143,1939,1172,203700,245,99,71.22,28.78,63,11,28,29,224,0,84,15,0,0,0,79,98,0,0,1524
379,379,0,246,133,2002,1455,391000,268,111,70.71,29.29,220,75,32,18,31,0,0,82,36,0,0,0,109,61,30,1525
485,485,0,423,62,1995,1464,298800,485,0,100.00,0.00,384,13,191,0,0,0,48,26,0,0,0,16,279,152,0,1526
567,560,7,376,184,1978,1120,239500,505,62,89.07,10.93,137,37,112,97,250,10,79,56,0,0,32,239,217,0,0,1527
343,317,26,260,57,2000,2115,258500,343,0,100.00,0.00,369,16,14,0,0,0,0,0,133,0,0,39,206,21,0,1528
441,390,51,370,20,1997,0,254700,422,19,95.69,4.31,435,11,0,14,0,0,0,44,8,20,0,129,245,14,0,1529
893,782,111,297,485,1951,1153,277500,668,225,74.80,25.20,17,95,80,64,537,46,107,90,0,19,0,217,193,47,74,1530
754,703,51,579,124,2004,1958,282500,572,182,75.86,24.14,471,17,19,32,36,0,0,164,0,0,0,149,102,160,0,1531
566,470,96,376,94,1981,0,217500,553,13,97.70,2.30,548,30,164,64,0,0,40,103,72,0,20,205,259,0,22,1532
394,364,30,173,191,1939,946,298600,267,127,67.77,32.23,9,0,0,8,378,45,58,10,18,0,7,26,114,32,31,1533
705,705,0,126,579,1996,899,269500,151,554,21.42,78.58,450,78,48,77,40,85,369,137,0,0,0,12,17,0,0,1534
736,642,94,163,479,1978,841,158600,48,688,6.52,93.48,195,169,307,123,18,38,589,23,0,0,0,90,34,0,0,1535
360,304,56,213,91,1980,929,257400,179,181,49.72,50.28,127,84,118,19,34,0,25,0,0,0,64,77,82,78,14,1536
694,597,97,516,81,1995,1345,227600,630,64,90.78,9.22,300,0,24,116,0,0,12,61,28,0,0,144,138,47,10,1537
705,629,76,95,534,2003,1078,351400,151,554,21.42,78.58,454,53,0,0,71,0,202,175,31,0,0,0,28,0,37,1538
399,373,26,297,76,1969,1151,828100,356,43,89.22,10.78,10,121,22,23,139,0,0,0,10,0,11,5,31,17,211,1539
1255,965,290,292,673,2001,1688,474100,64,1191,5.10,94.90,606,53,86,11,44,70,67,141,72,0,0,15,143,138,30,1540
740,740,0,593,147,1950,1707,719100,480,260,64.86,35.14,64,24,0,182,457,0,37,94,123,27,0,0,0,33,366,1541
1463,1380,83,657,723,1990,1531,379100,586,877,40.05,59.95,601,277,147,40,34,0,54,413,88,41,14,52,156,145,86,1542
713,632,81,138,494,1985,1333,330600,231,482,32.40,67.60,158,127,119,10,152,56,190,158,11,0,0,43,72,36,0,1543
825,825,0,71,754,1991,1305,245500,92,733,11.15,88.85,144,500,308,0,21,9,242,491,27,0,0,0,27,7,0,1544
2273,1981,292,147,1834,2005,1642,0,0,2273,0.00,100.00,1148,12,0,0,0,0,453,309,70,0,0,0,72,19,0,1545
1758,1388,370,211,1177,2005,1973,361300,13,1745,0.74,99.26,421,29,30,118,23,0,105,88,46,23,0,13,70,0,53,1546
523,523,0,455,68,1987,1959,492600,510,13,97.51,2.49,255,244,47,67,53,0,0,27,61,0,0,0,122,104,268,1547
447,408,39,341,67,1965,1672,209500,447,0,100.00,0.00,21,33,66,283,72,0,0,11,50,13,24,175,202,0,0,1548
605,506,99,0,506,1988,1070,0,34,571,5.62,94.38,199,298,13,0,0,0,325,77,0,0,0,0,0,0,0,1549
895,792,103,333,459,1939,1067,218500,542,353,60.56,39.44,31,41,32,20,658,19,178,106,29,49,12,110,193,5,0,1550
710,710,0,322,388,1970,980,272400,463,247,65.21,34.79,98,54,96,76,200,23,126,40,0,0,15,83,129,47,11,1551
607,505,102,342,163,1990,1256,208800,591,16,97.36,2.64,167,135,72,45,47,0,42,24,0,0,0,137,178,16,0,1552
1122,792,330,574,218,1981,1397,326200,972,150,86.63,13.37,337,34,48,86,228,0,42,65,0,0,0,110,167,109,103,1553
368,355,13,192,163,1951,610,85700,261,107,70.92,29.08,59,45,40,11,102,32,61,0,0,0,72,46,0,0,0,1554
310,292,18,114,178,1964,771,141700,167,143,53.87,46.13,43,32,93,14,121,14,23,32,0,0,15,166,0,0,0,1555
556,556,0,177,379,2001,1659,243200,69,487,12.41,87.59,537,403,51,0,0,15,318,218,86,59,12,51,71,6,0,1556
372,372,0,322,50,1985,0,247000,372,0,100.00,0.00,72,199,101,12,25,0,0,39,36,0,0,67,176,8,7,1557
588,588,0,54,534,1994,959,303600,127,461,21.60,78.40,160,65,177,115,0,0,322,54,14,0,0,63,52,0,0,1558
259,259,0,248,11,1991,0,276300,259,0,100.00,0.00,169,173,9,0,0,0,0,0,0,0,0,141,210,0,0,1559
706,657,49,364,293,1988,1110,139400,363,343,51.42,48.58,332,293,100,58,0,0,196,127,0,0,140,143,177,0,0,1560
306,269,37,234,35,2002,1697,327200,306,0,100.00,0.00,332,23,29,0,0,0,0,0,29,0,0,33,189,95,38,1561
863,851,12,573,278,2000,1851,615600,529,334,61.30,38.70,627,160,62,13,12,0,17,87,97,40,13,0,78,52,360,1562
693,631,62,433,198,1996,1885,464000,479,214,69.12,30.88,801,87,0,29,0,0,0,15,106,199,0,8,63,247,113,1563
859,833,26,320,513,1940,1462,734600,344,515,40.05,59.95,109,6,40,36,444,0,104,178,52,0,2,0,6,28,214,1564
783,783,0,415,368,1954,1134,367700,542,241,69.22,30.78,35,60,92,52,488,0,176,73,29,11,14,14,197,181,32,1565
648,648,0,544,104,1958,2220,724400,648,0,100.00,0.00,70,15,174,48,381,0,0,22,34,18,0,16,46,25,527,1566
532,502,30,370,132,1943,1758,410600,462,70,86.84,13.16,53,15,0,14,516,0,31,64,12,0,0,62,203,125,74,1567
538,538,0,391,147,1957,1451,382700,532,6,98.88,1.12,129,26,29,23,347,31,77,12,10,16,9,48,149,116,76,1568
1311,581,730,514,67,1979,706,190200,1073,238,81.85,18.15,341,200,125,179,463,41,58,0,0,0,74,340,90,51,17,1569
707,681,26,398,283,1973,639,122400,496,211,70.16,29.84,130,133,121,54,384,84,316,0,0,0,65,273,8,0,0,1570
328,321,7,158,163,1978,658,74800,156,172,47.56,52.44,68,48,45,25,93,42,60,0,0,0,113,17,10,0,8,1571
681,635,46,473,162,1964,1007,164800,580,101,85.17,14.83,20,24,140,102,340,25,90,13,0,0,36,408,24,0,0,1572
367,299,68,85,214,1953,774,88100,190,177,51.77,48.23,21,118,14,0,229,0,203,21,0,0,33,125,0,0,0,1573
329,287,42,213,74,1974,950,177300,292,37,88.75,11.25,54,39,159,19,120,8,66,35,0,0,41,90,33,0,22,1574
572,546,26,413,133,1964,1925,450000,572,0,100.00,0.00,31,39,92,294,130,0,0,39,57,16,0,0,131,166,173,1575
700,700,0,449,251,1958,1617,422600,626,74,89.43,10.57,29,107,8,15,633,0,0,52,75,45,0,15,259,277,69,1576
460,460,0,318,142,1957,1610,211700,460,0,100.00,0.00,0,0,95,118,365,0,47,16,21,0,0,246,230,12,0,1577
427,427,0,374,53,1975,0,266700,284,143,66.51,33.49,0,53,300,92,0,0,36,9,22,0,0,79,121,100,22,1578
349,285,64,146,139,1954,1238,158000,320,29,91.69,8.31,25,31,41,39,266,50,72,44,32,0,0,133,53,0,0,1579
544,463,81,187,276,1958,599,128200,339,205,62.32,37.68,96,0,111,70,291,37,292,15,0,0,0,58,22,0,5,1580
867,860,7,595,265,1992,1042,160900,552,315,63.67,36.33,357,136,168,14,27,32,87,12,0,0,125,166,179,20,0,1581
383,287,96,0,287,1977,1231,0,241,142,62.92,37.08,107,116,60,60,29,0,88,74,65,6,0,0,0,0,0,1582
397,397,0,0,397,1996,1430,0,261,136,65.74,34.26,218,19,90,0,0,0,12,297,9,9,0,0,0,0,0,1583
1226,952,274,88,864,1995,1214,312000,225,1001,18.35,81.65,715,164,117,0,0,9,190,442,80,0,11,74,57,0,14,1584
512,512,0,410,102,1979,1358,213900,492,20,96.09,3.91,48,137,266,13,21,19,0,14,0,0,30,229,185,0,8,1585
738,626,112,140,486,1992,982,211500,208,530,28.18,71.82,301,155,89,117,42,147,177,176,0,0,0,38,42,0,0,1586
619,545,74,469,76,1987,1356,289500,559,60,90.31,9.69,252,210,127,16,0,0,0,0,0,0,0,263,244,66,32,1587
1150,929,221,289,640,1955,727,159600,470,680,40.87,59.13,245,38,62,42,732,48,345,88,57,12,0,185,55,24,10,1588
722,685,37,539,146,1994,649,65300,233,489,32.27,67.73,475,0,157,68,16,18,100,59,9,0,209,202,55,0,0,1589
565,500,65,324,176,1939,1069,177600,456,109,80.71,19.29,24,0,45,50,518,16,94,100,22,0,0,134,120,18,11,1590
510,465,45,262,203,1997,1035,192600,242,268,47.45,52.55,463,36,0,24,11,0,90,55,0,156,60,73,68,0,0,1591
593,593,0,482,111,1981,1703,321400,536,57,90.39,9.61,389,82,127,151,12,0,0,12,41,0,0,28,299,160,142,1592
1122,979,143,693,286,2000,706,166300,558,564,49.73,50.27,779,60,205,0,31,15,410,22,0,0,248,293,46,0,9,1593
821,821,0,627,194,1993,1158,224000,676,145,82.34,17.66,421,167,177,13,165,0,108,17,41,0,14,384,220,78,81,1594
421,388,33,207,181,1978,341,183500,207,214,49.17,50.83,230,97,157,93,75,277,120,45,0,0,14,129,0,0,0,1595
937,784,153,117,667,1990,850,121500,146,791,15.58,84.42,614,80,60,69,118,49,418,111,36,0,12,171,12,0,0,1596
640,522,118,430,92,1943,950,268100,613,27,95.78,4.22,69,20,43,21,539,46,23,55,27,0,42,129,168,86,70,1597
594,566,28,491,75,1939,1143,283700,576,18,96.97,3.03,0,0,26,37,645,0,50,68,14,0,10,132,216,53,98,1598
90,90,0,90,0,2009,0,284500,90,0,100.00,0.00,31,0,30,0,34,0,0,0,0,0,0,20,41,0,34,1599
766,766,0,661,105,1991,1277,177800,766,0,100.00,0.00,432,16,280,13,20,0,0,58,0,0,0,635,0,0,0,1600
245,193,52,173,20,1990,1050,133800,78,167,31.84,68.16,202,11,18,0,0,0,6,0,0,0,61,119,17,0,0,1601
752,665,87,558,107,1995,1141,239700,698,54,92.82,7.18,467,21,80,9,49,10,46,25,23,0,19,276,174,24,15,1602
741,725,16,60,665,2003,698,158600,107,634,14.44,85.56,665,0,14,0,0,29,186,175,38,26,0,173,14,0,0,1603
1055,993,62,756,237,1990,1522,188500,754,301,71.47,28.53,445,503,226,0,0,0,79,30,0,0,113,477,200,64,22,1604
818,763,55,527,236,1997,1968,194400,549,269,67.11,32.89,562,143,122,0,0,32,126,106,93,25,9,339,36,0,19,1605
1520,1458,62,729,729,1992,957,233300,676,844,44.47,55.53,478,122,519,0,0,0,300,19,20,0,23,433,153,33,0,1606
242,229,13,195,34,1995,1250,184600,223,19,92.15,7.85,78,12,84,33,10,0,0,88,0,0,0,119,0,10,0,1607
692,692,0,548,144,1993,965,205300,503,189,72.69,27.31,219,167,43,37,26,0,12,24,77,0,37,224,71,27,0,1608
1053,1032,21,2,1030,1984,1428,0,387,666,36.75,63.25,158,44,36,11,139,0,0,243,57,0,0,0,0,0,0,1609
438,430,8,386,44,1976,1226,408100,411,27,93.84,6.16,94,97,147,70,68,0,11,36,3,3,0,45,96,36,232,1610
673,602,71,547,55,1979,1353,168100,673,0,100.00,0.00,150,98,374,57,102,31,0,115,0,0,0,383,186,0,0,1611
845,805,40,638,167,1996,1335,205300,828,17,97.99,2.01,636,88,96,0,17,0,11,112,5,0,26,477,175,0,19,1612
762,744,18,574,170,1996,1538,242300,744,18,97.64,2.36,527,50,0,0,0,0,33,69,59,0,0,60,290,19,13,1613
277,277,0,192,85,1974,884,158300,277,0,100.00,0.00,29,0,189,64,0,0,71,31,13,0,0,142,25,0,0,1614
525,515,10,79,436,1983,894,175500,121,404,23.05,76.95,36,243,89,32,0,0,281,18,0,0,0,47,0,0,0,1615
606,572,34,524,48,1993,1684,265600,603,3,99.50,0.50,317,97,90,55,7,0,17,43,0,0,10,163,182,140,11,1616
1774,1680,94,1380,300,1996,1075,254600,1551,223,87.43,12.57,890,291,230,11,153,29,157,24,50,28,69,326,606,117,118,1617
242,213,29,96,117,1985,629,12700,79,163,32.64,67.36,135,89,41,0,0,0,98,0,0,0,76,9,36,0,0,1618
503,428,75,343,85,1990,1269,361500,433,70,86.08,13.92,263,209,81,3,7,0,48,46,14,7,6,43,113,60,116,1619
603,578,25,382,196,1954,946,207200,461,142,76.45,23.55,52,0,115,50,472,25,158,36,5,0,10,213,116,71,30,1620
737,692,45,499,193,1987,1176,161800,606,131,82.23,17.77,195,243,98,27,0,0,0,46,25,7,164,266,55,0,0,1621
399,399,0,198,201,1952,1010,215100,348,51,87.22,12.78,14,15,44,29,401,15,154,61,15,0,0,207,51,0,0,1622
1200,992,208,309,683,1956,921,199800,611,589,50.92,49.08,40,110,304,117,449,8,501,80,46,13,0,206,79,11,0,1623
628,596,32,331,265,1970,863,171500,414,214,65.92,34.08,93,36,103,56,127,0,160,13,0,0,19,184,39,0,0,1624
529,515,14,447,68,1969,1711,302600,511,18,96.60,3.40,148,67,67,114,143,0,44,34,12,15,0,176,107,90,61,1625
1057,966,91,775,191,1994,1506,271300,966,91,91.39,8.61,839,260,66,0,67,0,40,32,62,16,0,299,628,120,35,1626
309,309,0,143,166,1973,984,180100,199,110,64.40,35.60,157,164,68,55,0,0,117,2,16,0,0,149,69,0,0,1627
1123,1082,41,188,894,1992,813,237800,436,687,38.82,61.18,651,100,169,82,18,0,414,218,16,12,0,80,157,0,0,1628
1309,1215,94,876,339,1960,1156,515500,763,546,58.29,41.71,125,174,250,140,895,70,221,72,94,0,17,81,260,130,485,1629
943,862,81,80,782,1989,868,345500,218,725,23.12,76.88,416,312,75,28,254,102,623,176,63,0,0,18,34,0,0,1630
1207,1114,93,109,1005,1978,818,182200,305,902,25.27,74.73,281,274,407,81,203,54,656,142,17,0,0,88,107,0,0,1631
375,375,0,297,78,1976,0,260200,297,78,79.20,20.80,70,101,214,50,0,0,24,26,25,0,16,78,173,56,0,1632
749,537,212,451,86,1983,871,412200,718,31,95.86,4.14,264,45,161,64,177,0,10,32,20,0,19,107,125,122,164,1633
470,422,48,345,77,1991,1099,258300,368,102,78.30,21.70,167,86,136,97,76,14,51,11,0,0,31,138,154,72,61,1634
497,382,115,95,287,1980,992,157800,211,286,42.45,57.55,56,189,145,5,62,49,159,26,20,10,18,116,11,0,0,1635
677,580,97,268,312,1973,896,215500,323,354,47.71,52.29,85,113,116,41,230,0,152,37,11,0,58,183,65,0,0,1636
281,281,0,120,161,1970,608,201200,202,79,71.89,28.11,33,0,31,10,144,29,83,12,0,0,25,24,12,11,22,1637
345,238,107,164,74,1978,566,155200,243,102,70.43,29.57,123,73,213,46,68,35,49,0,0,0,91,120,10,4,0,1638
473,473,0,328,145,1966,794,173600,363,110,76.74,23.26,114,29,121,135,153,13,94,0,0,0,37,247,79,38,0,1639
273,250,23,101,149,1945,761,74700,205,68,75.09,24.91,28,15,54,67,136,0,148,14,0,0,83,15,16,0,0,1640
387,360,27,215,145,1944,714,88400,318,69,82.17,17.83,28,28,64,75,201,0,60,35,0,0,44,224,15,9,0,1641
518,462,56,374,88,1976,720,122000,270,248,52.12,47.88,153,97,220,40,33,0,51,9,0,0,213,173,43,11,0,1642
434,291,143,245,46,1972,595,185600,321,113,73.96,26.04,109,88,62,0,80,39,0,0,0,0,23,95,51,0,9,1643
650,585,65,206,379,1980,659,126000,294,356,45.23,54.77,49,40,174,54,40,7,123,52,0,0,0,134,24,12,5,1644
508,454,54,274,180,1979,548,220700,400,108,78.74,21.26,123,77,59,26,86,0,51,46,0,8,14,87,88,0,8,1645
698,610,88,199,411,1954,628,175300,344,354,49.28,50.72,32,48,0,96,397,130,125,20,0,0,0,131,88,6,9,1646
844,800,44,27,773,1987,761,0,118,726,13.98,86.02,337,178,352,30,18,69,613,22,0,0,73,103,0,0,0,1647
374,343,31,317,26,1953,913,136900,374,0,100.00,0.00,17,14,64,35,231,0,45,10,0,9,10,254,0,0,8,1648
539,528,11,434,94,1945,967,133400,487,52,90.35,9.65,19,16,25,72,359,19,39,0,0,0,56,324,53,0,0,1649
743,656,87,366,290,1974,619,105400,400,343,53.84,46.16,66,177,173,101,387,35,230,110,0,0,192,241,19,0,0,1650
989,942,47,778,164,2000,1379,174800,928,61,93.83,6.17,339,115,48,42,207,17,56,9,0,0,13,496,103,0,17,1651
500,500,0,398,102,1969,1100,203800,431,69,86.20,13.80,55,57,126,185,71,15,86,55,29,0,25,234,41,9,0,1652
996,877,119,331,546,1973,654,148000,501,495,50.30,49.70,71,262,346,116,218,269,365,49,9,23,25,244,16,0,0,1653
348,326,22,265,61,1953,961,150600,335,13,96.26,3.74,44,21,21,40,183,0,59,29,0,0,26,195,0,0,0,1654
311,295,16,243,52,1967,967,179800,294,17,94.53,5.47,10,20,131,148,48,0,44,0,28,0,0,195,90,0,0,1655
984,895,89,316,579,1970,819,160200,546,438,55.49,44.51,340,76,111,33,309,52,354,12,11,0,73,272,13,0,0,1656
418,418,0,306,112,1973,617,167500,320,98,76.56,23.44,0,52,201,179,30,21,105,26,8,0,8,219,33,13,0,1657
268,268,0,235,33,1965,1257,195900,268,0,100.00,0.00,0,37,80,59,163,0,0,0,0,0,0,270,69,0,0,1658
568,543,25,352,191,1953,808,109600,544,24,95.77,4.23,26,22,72,38,452,9,110,49,0,0,127,276,0,0,9,1659
459,381,78,227,154,1951,919,110500,449,10,97.82,2.18,26,10,23,104,367,0,131,18,0,0,69,237,0,0,11,1660
580,516,64,162,354,1947,646,137500,342,238,58.97,41.03,24,12,223,18,279,118,156,46,0,0,12,70,24,0,0,1661
579,496,83,414,82,1972,808,171600,386,193,66.67,33.33,75,53,184,79,94,12,34,0,0,0,98,193,43,0,48,1662
643,600,43,543,57,1973,785,178100,484,159,75.27,24.73,185,77,122,44,184,4,61,21,0,0,31,293,81,19,24,1663
1399,1235,164,1125,110,1979,927,223600,1147,252,81.99,18.01,406,79,327,89,262,34,143,0,0,0,47,468,267,36,64,1664
406,406,0,157,249,1965,721,169100,232,174,57.14,42.86,41,0,130,39,168,140,115,34,0,0,0,89,0,0,0,1665
437,388,49,213,175,1939,632,418100,250,187,57.21,42.79,119,54,28,15,306,55,121,9,0,0,0,41,52,11,117,1666
628,551,77,381,170,1965,1198,319700,582,46,92.68,7.32,179,48,54,89,197,59,52,13,9,0,12,43,115,50,119,1667
592,529,63,358,171,1986,854,199400,427,165,72.13,27.87,171,26,155,18,169,25,103,26,0,0,8,218,115,21,0,1668
672,642,30,332,310,1976,718,143000,526,146,78.27,21.73,160,172,110,11,182,177,64,0,0,0,111,216,32,0,0,1669
369,245,124,178,67,1986,0,341700,337,32,91.33,8.67,124,5,78,0,44,15,11,5,0,0,0,34,43,28,37,1670
367,301,66,213,88,1950,1353,146300,367,0,100.00,0.00,0,0,35,43,291,0,49,34,14,0,54,218,0,0,0,1671
489,462,27,359,103,1942,1196,156800,489,0,100.00,0.00,0,0,8,10,424,0,15,50,0,0,66,277,22,0,0,1672
916,827,89,382,445,1954,888,126700,759,157,82.86,17.14,23,10,25,38,754,14,261,24,0,0,153,322,10,0,0,1673
300,300,0,204,96,1939,890,126800,283,17,94.33,5.67,39,50,75,12,175,26,168,36,0,0,54,53,0,0,0,1674
467,467,0,392,75,1980,1071,137100,456,11,97.64,2.36,63,230,56,9,88,0,37,55,0,0,12,342,0,0,0,1675
374,355,19,195,160,1939,894,105600,320,54,85.56,14.44,37,0,27,31,335,28,59,36,0,0,87,185,0,0,0,1676
346,310,36,153,157,1942,775,110900,281,65,81.21,18.79,17,0,13,13,414,33,95,32,0,0,52,177,0,0,0,1677
391,344,47,69,275,1939,0,163000,158,233,40.41,59.59,0,17,82,44,303,90,109,0,0,0,37,95,16,20,0,1678
339,304,35,62,242,1955,565,102200,155,184,45.72,54.28,56,37,22,50,296,59,78,27,0,0,117,84,0,0,0,1679
259,229,30,139,90,1972,925,0,136,123,52.51,47.49,39,138,104,0,55,0,50,0,0,0,142,78,66,0,0,1680
430,395,35,380,15,1995,0,334400,415,15,96.51,3.49,349,9,70,116,72,9,33,56,0,0,0,54,236,69,80,1681
457,457,0,424,33,1975,1391,213500,409,48,89.50,10.50,92,8,189,62,59,0,8,0,0,0,14,240,123,8,9,1682
438,438,0,398,40,1978,850,234900,425,13,97.03,2.97,58,170,136,18,11,0,43,38,0,0,10,163,95,8,0,1683
385,364,21,214,150,1952,675,133400,284,101,73.77,26.23,0,10,21,10,300,0,88,10,0,0,12,162,40,0,0,1684
402,402,0,307,95,1953,981,133700,402,0,100.00,0.00,69,14,17,24,229,9,66,23,0,0,15,181,0,0,0,1685
362,297,65,220,77,1947,1073,136600,362,0,100.00,0.00,7,0,17,0,354,0,30,0,0,0,52,296,0,0,0,1686
254,254,0,221,33,1953,0,154500,254,0,100.00,0.00,0,0,15,0,226,0,0,40,0,0,15,186,0,0,0,1687
338,303,35,251,52,1979,857,182200,142,196,42.01,57.99,175,67,79,0,33,9,42,0,0,0,84,121,26,31,0,1688
375,314,61,211,103,1964,715,115800,318,57,84.80,15.20,40,22,54,0,209,0,32,0,0,0,38,217,9,0,0,1689
896,664,232,535,129,1985,725,170000,680,216,75.89,24.11,243,154,126,76,301,39,27,2,0,0,134,274,98,13,81,1690
626,574,52,0,574,1992,712,0,0,626,0.00,100.00,291,33,0,0,106,117,283,0,0,0,0,22,0,0,0,1691
662,620,42,415,205,1999,1330,226200,420,242,63.44,36.56,191,51,59,0,92,0,37,45,51,0,86,69,105,0,0,1692
739,507,232,423,84,1967,0,405800,683,56,92.42,7.58,114,137,81,177,162,0,86,0,0,0,42,83,85,59,104,1693
436,376,60,77,299,1981,984,238500,184,252,42.20,57.80,153,48,145,15,147,0,276,0,0,13,0,94,72,11,0,1694
219,187,32,139,48,1978,0,152700,146,73,66.67,33.33,20,0,79,50,100,0,81,57,0,0,50,46,0,0,15,1695
599,403,196,329,74,1987,579,164900,462,137,77.13,22.87,180,40,97,27,192,34,67,0,0,0,101,82,52,6,76,1696
264,232,32,118,114,1952,989,113100,247,17,93.56,6.44,12,16,40,0,260,38,80,48,0,0,23,110,17,12,0,1697
266,246,20,128,118,1965,825,161900,207,59,77.82,22.18,14,12,89,90,75,34,0,14,0,0,7,180,0,0,11,1698
573,514,59,332,182,1965,956,166400,453,120,79.06,20.94,189,32,32,75,146,11,53,35,0,0,69,166,11,0,9,1699
776,216,560,202,14,1984,0,437300,745,31,96.01,3.99,166,167,160,126,146,0,12,3,0,0,22,84,58,30,121,1700
335,223,112,156,67,1980,786,167900,232,103,69.25,30.75,39,60,87,58,109,0,55,0,0,0,0,75,88,0,14,1701
367,129,238,84,45,1971,588,179200,290,77,79.02,20.98,28,30,166,65,48,3,11,0,0,0,47,66,2,0,0,1702
180,169,11,153,16,1972,0,212500,138,42,76.67,23.33,119,21,26,0,154,0,0,0,0,0,51,143,38,10,48,1703
809,153,656,134,19,1998,0,460000,750,59,92.71,7.29,132,136,103,0,45,0,27,0,0,0,0,50,0,41,24,1704
673,353,320,322,31,1988,0,310900,575,98,85.44,14.56,175,200,116,66,75,4,9,0,0,0,52,88,143,14,25,1705
327,184,143,143,41,1991,0,428700,301,26,92.05,7.95,28,46,77,12,165,0,15,0,0,0,41,110,27,0,22,1706
512,457,55,283,174,1957,734,203500,386,126,75.39,24.61,65,100,123,24,288,0,209,0,0,0,46,259,15,0,0,1707
480,275,205,185,90,1968,0,97000,388,92,80.83,19.17,115,57,72,39,177,59,38,0,0,0,42,74,32,0,55,1708
720,395,325,341,54,1990,0,189800,538,182,74.72,25.28,131,126,91,134,72,0,21,0,0,0,136,45,12,0,0,1709
850,809,41,361,448,1946,1002,240700,782,68,92.00,8.00,92,50,73,76,404,23,110,94,0,0,32,247,122,0,0,1710
658,632,26,485,147,2001,0,297200,582,76,88.45,11.55,356,106,58,44,0,0,0,22,0,0,0,115,122,91,110,1711
1010,937,73,58,879,1983,857,171600,184,826,18.22,81.78,141,99,325,185,233,112,534,77,0,0,0,129,11,0,0,1712
499,424,75,311,113,1947,425,114200,428,71,85.77,14.23,20,36,64,20,366,34,33,0,0,0,158,93,32,0,5,1713
1108,1095,13,824,271,1997,1742,224300,1068,40,96.39,3.61,503,87,368,0,45,0,0,91,84,0,0,259,411,15,45,1714
726,726,0,367,359,1978,1319,275700,535,191,73.69,26.31,337,64,101,43,198,18,254,136,28,17,15,104,171,0,0,1715
873,691,182,254,437,1982,905,0,132,741,15.12,84.88,455,165,98,155,88,0,357,79,24,0,225,74,68,44,0,1716
554,528,26,209,319,1977,942,291700,218,336,39.35,60.65,184,62,75,104,39,0,194,45,0,0,31,12,120,12,14,1717
723,624,99,430,194,1952,971,164800,633,90,87.55,12.45,53,117,85,14,616,9,177,86,0,0,27,441,48,16,40,1718
836,526,310,452,74,1988,587,196800,662,174,79.19,20.81,135,165,121,62,179,27,42,0,21,0,115,57,129,0,36,1719
1787,663,1124,490,173,1986,956,467900,1663,124,93.06,6.94,576,341,283,203,226,9,41,9,0,0,11,83,114,101,242,1720
323,285,38,167,118,1972,956,236700,230,93,71.21,28.79,81,33,68,22,117,3,50,55,18,11,2,61,65,15,21,1721
681,538,143,171,367,1992,1120,219800,359,322,52.72,47.28,294,24,142,30,83,0,163,90,0,76,15,153,47,14,0,1722
454,392,62,207,185,1970,1213,269800,286,168,63.00,37.00,239,62,27,33,170,78,87,32,18,28,3,50,63,41,54,1723
834,834,0,232,602,1978,927,204500,255,579,30.58,69.42,242,171,177,41,152,0,314,9,0,0,14,186,154,14,16,1724
397,397,0,250,147,1940,856,200000,319,78,80.35,19.65,0,17,23,0,247,0,44,54,0,0,24,54,62,0,0,1725
318,272,46,166,106,1961,1260,223300,231,87,72.64,27.36,0,42,81,71,182,0,58,35,0,0,0,196,10,0,11,1726
307,307,0,216,91,1971,1098,174300,212,95,69.06,30.94,78,33,90,81,136,0,74,55,0,0,96,98,54,0,9,1727
462,348,114,139,209,1940,726,166600,215,247,46.54,53.46,0,26,84,29,413,103,210,59,0,0,0,87,59,0,0,1728
339,291,48,198,93,1939,839,237100,229,110,67.55,32.45,0,0,36,12,311,32,38,0,0,0,0,120,88,6,4,1729
884,873,11,794,79,1959,1347,283300,884,0,100.00,0.00,45,18,177,78,471,0,10,41,0,0,31,279,208,75,112,1730
859,765,94,444,321,1975,0,166100,740,119,86.15,13.85,120,70,190,30,268,66,122,20,0,0,43,427,0,0,0,1731
440,440,0,320,120,1958,834,135400,375,65,85.23,14.77,19,0,27,125,248,24,47,36,0,0,40,255,17,0,0,1732
1357,1249,108,1077,172,1993,1088,270600,1207,150,88.95,11.05,472,114,437,43,11,0,9,0,0,0,0,320,573,81,66,1733
441,441,0,354,87,1986,608,249100,345,96,78.23,21.77,160,142,142,0,20,0,12,0,0,0,30,250,81,0,49,1734
653,616,37,526,90,1979,0,172300,636,17,97.40,2.60,206,65,304,15,46,0,0,28,0,0,44,427,91,0,0,1735
635,537,98,386,151,1978,394,168500,471,164,74.17,25.83,70,79,180,52,151,18,113,9,0,0,20,247,19,21,0,1736
943,869,74,483,386,1982,864,164000,666,277,70.63,29.37,141,389,345,0,0,32,159,142,8,0,0,470,13,0,0,1737
423,356,67,51,305,1966,703,0,142,281,33.57,66.43,60,28,103,128,122,145,172,22,0,0,0,56,9,0,0,1738
16,16,0,0,16,0,0,0,0,16,0.00,100.00,0,0,20,0,69,28,10,34,17,0,0,0,0,0,0,1739
869,830,39,512,318,1968,738,156900,664,205,76.41,23.59,56,55,112,128,421,48,76,40,0,0,11,443,57,0,0,1740
493,345,148,227,118,1966,880,158900,412,81,83.57,16.43,112,74,24,74,255,0,10,11,0,0,26,210,97,0,0,1741
1496,1076,420,857,219,1983,899,160700,1100,396,73.53,26.47,249,148,172,144,235,25,49,3,0,0,170,351,97,3,9,1742
491,413,78,377,36,1974,1088,172200,491,0,100.00,0.00,74,66,76,46,125,0,9,58,0,0,23,287,10,0,0,1743
677,677,0,557,120,1978,1581,318400,626,51,92.47,7.53,181,68,338,75,50,13,53,28,0,0,131,138,116,105,23,1744
1449,1354,95,1043,311,1996,1348,283900,1099,350,75.85,24.15,951,134,63,35,98,47,12,120,32,89,17,183,470,86,137,1745
409,383,26,256,127,1958,724,80600,261,148,63.81,36.19,52,30,142,41,193,18,110,45,0,0,163,86,0,0,0,1746
701,649,52,51,598,1955,610,156900,95,606,13.55,86.45,41,58,108,13,402,202,179,14,0,13,0,85,0,0,0,1747
508,508,0,409,99,1977,966,176100,348,160,68.50,31.50,101,58,214,66,204,0,110,0,3,0,214,306,0,0,10,1748
814,716,98,462,254,1970,745,142000,494,320,60.69,39.31,33,12,203,179,122,0,89,0,0,0,13,368,0,10,0,1749
535,506,29,423,83,1970,879,178600,502,33,93.83,6.17,0,95,96,126,201,34,34,22,0,0,50,245,44,0,8,1750
565,516,49,340,176,1977,771,179600,417,148,73.81,26.19,51,92,123,31,191,16,178,53,0,0,12,153,67,0,0,1751
440,386,54,280,106,1969,489,102300,355,85,80.68,19.32,103,73,61,41,170,53,23,0,0,0,119,215,0,0,0,1752
601,552,49,261,291,1945,582,127100,458,143,76.21,23.79,15,40,52,0,323,65,130,15,0,0,45,175,0,0,0,1753
319,263,56,248,15,1977,0,179200,302,17,94.67,5.33,10,73,83,0,115,23,101,0,0,0,47,45,24,0,0,1754
883,789,94,590,199,1979,996,216300,691,192,78.26,21.74,416,75,152,140,291,0,181,64,0,0,53,538,129,33,11,1755
572,572,0,149,423,1979,901,142400,255,317,44.58,55.42,73,78,79,50,357,0,308,52,34,0,17,208,0,0,0,1756
805,805,0,344,461,1968,1225,158700,333,472,41.37,58.63,171,49,156,152,321,0,124,197,37,61,39,356,0,0,0,1757
254,254,0,239,15,1946,0,184500,250,4,98.43,1.57,26,0,6,48,212,0,36,13,0,0,0,182,38,0,23,1758
764,764,0,159,605,1963,669,98900,412,352,53.93,46.07,76,221,145,138,194,179,364,21,0,0,137,22,0,0,0,1759
600,549,51,322,227,1951,844,121600,441,159,73.50,26.50,18,0,31,85,535,52,218,0,0,0,123,161,0,0,0,1760
346,316,30,296,20,1981,0,627000,346,0,100.00,0.00,109,74,26,45,78,0,0,0,18,0,0,0,33,56,218,1761
546,463,83,357,106,1993,1750,288800,506,40,92.67,7.33,160,20,81,195,59,0,0,0,0,0,26,118,227,90,43,1762
905,837,68,497,340,1982,949,197700,633,272,69.94,30.06,234,97,216,22,121,23,141,46,0,0,0,258,126,8,21,1763
587,525,62,390,135,1976,1550,188700,463,124,78.88,21.12,169,98,113,50,116,0,60,88,9,0,6,171,144,0,13,1764
563,521,42,318,203,1953,1486,206000,437,126,77.62,22.38,36,0,121,149,245,82,108,92,9,0,0,64,108,15,49,1765
391,391,0,89,302,1975,813,192500,173,218,44.25,55.75,86,28,38,157,89,65,211,15,12,0,0,69,26,0,0,1766
560,542,18,21,521,1991,754,173900,38,522,6.79,93.21,227,44,42,90,169,86,375,18,11,0,0,27,31,0,0,1767
853,810,43,476,334,2003,1383,275300,521,332,61.08,38.92,656,12,36,63,99,0,28,301,64,0,0,99,144,114,104,1768
608,608,0,109,499,1989,1296,206400,142,466,23.36,76.64,84,318,92,52,0,31,329,51,0,0,0,21,48,0,0,1769
344,290,54,258,32,1985,1300,245000,344,0,100.00,0.00,208,123,0,56,14,0,0,0,50,0,0,190,141,0,20,1770
407,407,0,282,125,1982,1095,283100,298,109,73.22,26.78,0,252,256,0,0,0,41,43,37,0,21,14,251,21,25,1771
927,919,8,178,741,1981,960,166700,232,695,25.03,74.97,106,131,249,146,0,0,379,0,17,0,0,77,82,12,0,1772
777,629,148,440,189,1969,1639,223300,777,0,100.00,0.00,101,46,136,250,77,0,25,60,0,0,14,108,223,93,12,1773
426,426,0,392,34,1970,0,444000,426,0,100.00,0.00,152,0,84,72,46,0,0,35,0,0,15,0,147,69,43,1774
438,438,0,406,32,1966,3083,988600,438,0,100.00,0.00,133,36,105,73,195,0,0,9,0,43,0,17,0,9,431,1775
637,557,80,205,352,1979,1248,95200,68,569,10.68,89.32,0,124,279,98,13,14,101,121,0,0,41,121,29,14,0,1776
460,460,0,201,259,1975,1218,451400,288,172,62.61,37.39,101,81,108,45,16,0,110,87,0,0,0,5,28,40,55,1777
931,931,0,322,609,1981,1140,250000,164,767,17.62,82.38,297,340,401,12,13,66,250,282,0,0,0,216,88,13,47,1778
537,417,120,210,207,1947,1289,193800,421,116,78.40,21.60,29,15,85,10,332,0,124,59,0,0,16,125,100,0,0,1779
316,287,29,257,30,1993,0,597700,316,0,100.00,0.00,86,139,9,0,0,0,0,0,0,0,8,9,8,27,182,1780
609,565,44,482,83,2004,1978,570100,466,143,76.52,23.48,289,132,21,0,8,0,38,52,0,0,0,0,45,66,223,1781
514,474,40,441,33,1993,0,48500,155,359,30.16,69.84,334,126,70,10,10,0,20,10,49,0,225,93,114,0,0,1782
370,339,31,241,98,1956,1583,236300,337,33,91.08,8.92,12,36,34,105,182,10,39,26,27,0,0,69,135,12,10,1783
593,593,0,215,378,1977,993,204300,185,408,31.20,68.80,96,243,176,100,258,11,335,220,12,0,0,133,61,5,14,1784
755,664,91,273,391,1968,1043,272200,325,430,43.05,56.95,91,90,97,127,355,12,345,17,29,0,14,70,152,78,23,1785
695,658,37,224,434,1969,935,160300,131,564,18.85,81.15,42,227,217,261,158,0,200,185,44,0,0,171,88,39,13,1786
394,342,52,178,164,1952,1194,218200,364,30,92.39,7.61,0,62,0,78,188,47,23,0,14,0,0,86,95,21,0,1787
887,859,28,801,58,2003,1261,398600,862,25,97.18,2.82,444,40,109,132,39,0,0,0,22,24,0,0,157,300,216,1788
381,381,0,202,179,1981,1010,225400,278,103,72.97,27.03,69,112,42,145,92,0,113,0,0,0,15,99,184,0,34,1789
406,395,11,361,34,1974,885,593500,406,0,100.00,0.00,100,25,123,7,23,0,0,0,16,0,0,0,74,14,163,1790
484,484,0,447,37,1989,0,559400,420,64,86.78,13.22,297,12,142,11,10,0,10,0,0,0,0,38,58,39,291,1791
402,341,61,192,149,1968,1155,261800,353,49,87.81,12.19,12,146,48,65,164,0,101,27,16,0,0,18,225,3,9,1792
367,367,0,328,39,1977,0,339700,367,0,100.00,0.00,0,63,199,16,14,0,0,0,0,0,0,14,228,50,0,1793
452,434,18,388,46,1987,2341,364200,452,0,100.00,0.00,281,62,27,106,0,0,0,14,0,46,0,39,160,122,95,1794
934,899,35,314,585,1985,1330,213700,447,487,47.86,52.14,310,33,57,20,29,0,86,109,0,0,0,60,96,13,18,1795
360,286,74,233,53,1969,1317,190600,360,0,100.00,0.00,104,45,16,171,18,0,33,116,0,0,12,49,65,27,0,1796
670,670,0,621,49,1995,0,437800,656,14,97.91,2.09,393,186,0,54,36,0,0,21,33,10,0,28,67,278,232,1797
380,328,52,187,141,1971,1026,399400,271,109,71.32,28.68,70,17,52,125,111,18,52,17,8,12,0,8,96,116,21,1798
447,447,0,368,79,1977,2201,473600,447,0,100.00,0.00,34,133,271,15,45,0,0,0,14,0,0,0,154,79,251,1799
658,621,37,524,97,1978,1875,582100,658,0,100.00,0.00,154,0,315,163,14,0,0,0,0,0,14,0,159,122,351,1800
394,394,0,335,59,1972,1810,587400,394,0,100.00,0.00,48,0,269,62,14,0,0,32,0,48,9,0,16,102,186,1801
619,601,18,35,566,1995,1124,217600,35,584,5.65,94.35,225,198,135,20,62,79,234,153,41,0,0,41,29,0,0,1802
366,366,0,170,196,1992,994,306000,145,221,39.62,60.38,180,234,0,0,0,12,50,65,0,0,0,132,116,0,0,1803
289,289,0,270,19,1983,0,429800,289,0,100.00,0.00,33,144,72,9,14,0,0,13,0,0,13,0,9,147,73,1804
431,431,0,392,39,1970,2325,457100,431,0,100.00,0.00,56,12,199,213,9,0,0,12,22,12,21,0,69,128,225,1805
498,498,0,414,84,1975,1849,413300,498,0,100.00,0.00,44,57,235,90,47,0,0,0,0,0,0,15,91,204,149,1806
421,421,0,407,14,1987,0,643000,414,7,98.34,1.66,86,195,42,12,0,0,10,0,0,0,0,0,11,73,241,1807
417,364,53,304,60,1979,2357,599500,309,108,74.10,25.90,17,99,192,59,27,0,0,0,0,3,9,0,117,20,192,1808
636,565,71,417,148,1978,1427,318400,339,297,53.30,46.70,81,238,232,65,20,0,10,77,10,25,0,70,227,74,103,1809
549,508,41,473,35,1974,0,373700,524,25,95.45,4.55,15,66,508,94,9,0,9,0,58,0,0,29,248,281,67,1810
353,326,27,77,249,1990,1258,372500,104,249,29.46,70.54,86,274,101,24,28,9,56,364,0,0,0,13,21,32,18,1811
600,294,306,222,72,1980,669,222400,294,306,49.00,51.00,155,77,123,67,112,30,12,3,0,0,33,64,41,13,0,1812
310,261,49,139,122,1968,647,123600,171,139,55.16,44.84,48,39,41,96,150,49,123,0,0,0,0,185,17,0,0,1813
774,751,23,515,236,1961,806,86100,418,356,54.01,45.99,102,105,227,14,341,102,159,23,0,0,246,189,10,0,0,1814
676,676,0,350,326,1970,1065,422000,201,475,29.73,70.27,189,82,103,118,182,0,168,117,24,0,0,0,119,97,149,1815
687,606,81,578,28,1991,0,447400,669,18,97.38,2.62,284,151,112,34,48,0,48,12,0,10,0,26,101,97,283,1816
556,518,38,518,0,1968,0,840400,424,132,76.26,23.74,38,13,188,47,239,0,0,13,0,17,0,12,0,35,409,1817
334,307,27,229,78,1946,1545,515300,312,22,93.41,6.59,44,0,37,47,245,0,32,11,23,0,0,8,110,104,68,1818
484,460,24,351,109,1947,1774,416200,484,0,100.00,0.00,38,43,17,35,401,0,11,8,33,27,0,22,126,122,100,1819
720,666,54,214,452,1993,1197,343900,376,344,52.22,47.78,359,137,67,13,219,76,157,241,48,0,0,11,185,17,0,1820
473,473,0,252,221,1964,1734,399100,365,108,77.17,22.83,42,56,58,31,258,0,189,54,16,0,0,28,52,63,22,1821
537,537,0,462,75,1957,2205,687800,537,0,100.00,0.00,21,9,0,45,502,0,0,9,0,14,14,22,12,82,424,1822
681,646,35,364,282,1957,973,369100,419,262,61.53,38.47,44,24,117,47,280,0,126,53,12,0,25,46,116,89,45,1823
370,365,5,156,209,1968,981,374600,189,181,51.08,48.92,111,21,45,37,130,13,68,54,0,0,0,16,63,56,9,1824
452,452,0,334,118,1956,1625,403800,445,7,98.45,1.55,8,22,51,53,398,0,105,59,14,0,6,12,178,89,69,1825
951,931,20,281,650,1975,962,216800,141,810,14.83,85.17,331,139,309,153,102,45,516,199,38,0,0,75,122,0,0,1826
514,501,13,189,312,1977,893,296000,171,343,33.27,66.73,179,275,117,136,83,97,182,154,27,72,0,15,96,60,41,1827
461,389,72,256,133,1970,955,291500,372,89,80.69,19.31,72,165,7,35,197,28,131,70,47,10,0,12,120,58,0,1828
668,668,0,369,299,1973,1093,329200,354,314,52.99,47.01,76,94,150,154,294,0,260,85,72,14,0,15,106,134,36,1829
687,620,67,346,274,1964,1120,331300,481,206,70.01,29.99,67,27,39,79,343,0,75,35,20,10,0,59,276,32,48,1830
454,439,15,317,122,1956,1368,314600,386,68,85.02,14.98,25,131,0,89,220,0,60,0,56,0,0,0,209,74,20,1831
720,699,21,387,312,1980,983,205400,580,140,80.56,19.44,127,58,99,161,64,21,155,56,43,0,35,149,24,8,0,1832
834,803,31,667,136,2005,1347,225600,827,7,99.16,0.84,600,0,16,0,12,0,16,148,13,0,0,213,145,93,0,1833
886,771,115,486,285,1970,1424,171900,886,0,100.00,0.00,293,131,124,45,180,0,32,170,64,0,0,433,28,0,11,1834
732,708,24,178,530,1982,1067,225000,54,678,7.38,92.62,160,203,166,145,34,27,331,101,0,0,22,134,61,22,0,1835
796,756,40,281,475,1961,1142,460300,355,441,44.60,55.40,178,113,117,65,355,0,222,166,56,22,0,15,45,61,129,1836
555,537,18,369,168,1979,1109,402600,409,146,73.69,26.31,61,135,144,113,18,0,54,18,30,0,0,20,113,88,148,1837
649,596,53,200,396,1939,804,188300,253,396,38.98,61.02,58,56,95,48,598,67,367,183,21,0,0,123,70,0,0,1838
818,235,583,173,62,1969,642,179900,767,51,93.77,6.23,56,118,89,63,197,17,48,0,0,0,7,107,20,7,7,1839
717,674,43,311,363,1967,1105,239500,489,228,68.20,31.80,274,54,93,33,371,49,175,98,29,0,14,108,258,28,15,1840
426,363,63,221,142,1974,683,119600,337,89,79.11,20.89,9,38,24,113,251,0,0,60,10,0,88,215,9,0,0,1841
659,623,36,482,141,1967,1768,424800,574,85,87.10,12.90,18,30,191,308,83,0,14,10,134,0,0,58,148,142,93,1842
284,284,0,173,111,1970,0,0,172,112,60.56,39.44,118,4,22,217,0,0,0,39,0,4,22,88,118,22,0,1843
1063,976,87,270,706,1959,1012,345400,22,1041,2.07,97.93,45,223,0,119,628,55,464,93,16,0,0,48,105,45,0,1844
462,395,67,245,150,1954,1031,228900,362,100,78.35,21.65,0,76,84,90,265,0,104,171,0,0,0,67,145,0,15,1845
407,372,35,325,47,1993,1341,272100,369,38,90.66,9.34,308,36,46,13,10,0,27,39,0,0,0,18,306,23,0,1846
501,453,48,103,350,1972,626,37300,47,454,9.38,90.62,73,0,137,60,198,66,175,33,0,0,26,18,0,0,0,1847
711,692,19,287,405,1939,894,373500,302,409,42.48,57.52,79,11,58,30,400,41,73,121,49,0,7,11,48,63,52,1848
390,390,0,16,374,1963,276,0,27,363,6.92,93.08,0,27,90,141,100,238,48,10,0,0,0,0,0,0,0,1849
967,883,84,274,609,1961,991,311400,23,944,2.38,97.62,56,238,61,93,431,168,270,58,0,0,0,31,66,68,51,1850
1040,993,47,489,504,1992,888,380400,0,1040,0.00,100.00,785,262,14,0,149,29,100,331,82,224,0,0,155,63,79,1851
867,867,0,217,650,1982,1065,364300,145,722,16.72,83.28,224,73,15,58,335,82,218,138,54,0,0,38,97,24,54,1852
504,504,0,261,243,1939,1230,633900,370,134,73.41,26.59,195,13,0,0,362,0,77,109,0,35,0,0,37,33,279,1853
578,552,26,229,323,1939,1379,538600,286,292,49.48,50.52,107,8,19,21,411,21,128,126,21,0,0,11,49,56,107,1854
1075,1075,0,224,851,1958,1024,599000,183,892,17.02,82.98,66,137,81,114,512,164,195,282,17,13,0,14,0,67,58,1855
885,885,0,183,702,1963,1180,385600,96,789,10.85,89.15,0,112,108,360,183,0,300,138,14,0,10,22,132,18,34,1856
1050,1029,21,200,829,1973,1361,361100,0,1050,0.00,100.00,201,38,110,173,302,66,218,239,31,0,7,47,92,21,63,1857
650,650,0,215,435,1955,1228,606200,24,626,3.69,96.31,204,21,140,54,499,28,307,171,13,54,0,0,74,65,81,1858
560,560,0,351,209,1939,1201,892500,274,286,48.93,51.07,53,14,44,41,470,0,72,80,26,0,14,22,21,43,293,1859
1259,1166,93,289,877,1967,1452,501300,192,1067,15.25,84.75,140,62,227,279,691,0,660,225,47,45,0,0,67,80,128,1860
540,540,0,436,104,1939,2214,986400,497,43,92.04,7.96,15,0,70,0,581,0,57,0,0,0,0,0,15,97,391,1861
393,393,0,323,70,1939,1693,1115600,337,56,85.75,14.25,0,23,34,0,352,0,24,86,36,38,0,0,0,0,212,1862
1011,905,106,205,700,1962,1210,730100,179,832,17.71,82.29,213,33,75,77,460,0,178,212,55,70,0,14,51,58,103,1863
861,842,19,251,591,1960,1261,524100,334,527,38.79,61.21,31,60,161,203,345,0,252,181,74,43,0,15,28,11,101,1864
979,841,138,344,497,1976,1614,355600,235,744,24.00,76.00,347,209,280,169,119,0,226,153,78,54,0,24,76,37,239,1865
261,261,0,193,68,1939,1435,450000,247,14,94.64,5.36,62,0,0,0,295,0,0,33,38,0,0,11,37,60,155,1866
469,469,0,338,131,1967,886,217300,447,22,95.31,4.69,124,40,57,41,206,0,10,48,0,0,0,154,151,9,0,1867
638,580,58,508,72,1986,1242,206100,638,0,100.00,0.00,133,73,184,79,10,0,0,64,12,0,0,256,139,0,8,1868
521,481,40,204,277,1974,1233,779100,238,283,45.68,54.32,123,146,91,124,160,0,68,76,0,14,0,0,133,97,240,1869
604,563,41,546,17,1949,0,647100,604,0,100.00,0.00,68,14,0,46,391,0,0,14,0,0,0,13,19,45,428,1870
494,464,30,302,162,1939,1313,666700,387,107,78.34,21.66,21,82,22,24,391,39,65,97,57,0,0,9,10,22,228,1871
709,665,44,316,349,1939,1474,551000,399,310,56.28,43.72,95,37,11,10,542,0,137,75,39,21,0,25,20,68,253,1872
553,493,60,272,221,1948,1748,470400,423,130,76.49,23.51,32,55,9,52,499,0,42,159,28,45,15,0,50,219,89,1873
1886,1886,0,235,1651,2004,1356,357100,95,1791,5.04,94.96,233,106,176,183,338,62,339,253,30,22,51,29,118,11,14,1874
362,362,0,274,88,1939,1904,595500,331,31,91.44,8.56,0,32,0,11,371,15,0,8,0,0,0,0,32,52,297,1875
799,760,39,296,464,1953,970,500000,206,593,25.78,74.22,32,45,63,58,534,0,273,85,75,10,0,43,14,13,207,1876
595,545,50,495,50,1939,0,663700,519,76,87.23,12.77,60,13,0,36,545,0,115,0,0,0,0,18,51,52,376,1877
506,479,27,388,91,1972,2389,452500,462,44,91.30,8.70,12,129,0,198,111,0,0,0,0,18,13,12,140,154,68,1878
884,782,102,595,187,1986,1171,164000,678,206,76.70,23.30,452,155,209,81,0,0,83,72,11,0,67,367,242,21,0,1879
610,610,0,577,33,1975,1179,185000,603,7,98.85,1.15,49,78,406,80,8,0,0,78,0,0,8,277,210,19,0,1880
416,401,15,203,198,1958,1088,930600,233,183,56.01,43.99,54,75,61,68,275,0,138,26,0,0,11,0,15,17,283,1881
618,577,41,213,364,1976,1382,686100,257,361,41.59,58.41,400,19,41,37,213,0,106,148,182,0,0,0,11,0,149,1882
497,497,0,278,219,1939,1336,609200,342,155,68.81,31.19,35,11,116,36,361,0,68,83,12,0,9,10,91,74,199,1883
671,640,31,277,363,1969,1067,427000,266,405,39.64,60.36,24,68,164,29,223,0,190,129,31,0,0,32,15,51,28,1884
520,457,63,419,38,1940,1170,686500,435,85,83.65,16.35,57,24,0,12,483,0,12,0,0,30,0,0,59,134,341,1885
489,461,28,374,87,1939,0,523100,422,67,86.30,13.70,21,14,0,0,487,0,8,0,59,0,0,0,100,169,141,1886
725,667,58,411,256,1939,1045,534700,527,198,72.69,27.31,92,26,47,56,483,0,105,42,60,34,11,0,98,113,125,1887
445,381,64,284,97,1939,1225,495000,370,75,83.15,16.85,26,43,56,12,374,0,55,29,13,0,0,26,115,103,159,1888
577,518,59,302,216,1939,1209,545200,411,166,71.23,28.77,65,36,47,11,352,0,36,41,90,12,0,25,17,107,84,1889
364,347,17,335,12,1978,0,332100,364,0,100.00,0.00,56,117,90,102,41,32,26,0,9,6,0,20,217,27,69,1890
232,150,82,99,51,1979,380,76400,188,44,81.03,18.97,66,129,98,61,27,36,33,0,0,0,124,58,23,0,2,1891
876,866,10,760,106,1992,1790,316300,680,196,77.63,22.37,483,244,51,30,13,30,0,0,0,0,161,92,205,178,76,1892
706,670,36,567,103,1984,945,185800,552,154,78.19,21.81,202,88,58,30,181,0,60,36,37,7,34,207,120,6,13,1893
267,267,0,213,54,1967,2065,358800,249,18,93.26,6.74,16,0,45,0,339,0,34,0,49,0,0,31,100,59,16,1894
437,437,0,279,158,2000,0,271300,398,39,91.08,8.92,293,0,0,0,0,0,0,46,81,0,17,79,59,11,0,1895
1172,915,257,359,556,1980,1336,170600,169,1003,14.42,85.58,177,358,521,47,59,26,289,264,50,62,0,248,82,66,17,1896
769,737,32,690,47,1975,0,242700,723,46,94.02,5.98,69,90,371,86,139,0,122,26,0,0,10,255,289,22,0,1897
764,684,80,283,401,1979,785,348300,294,470,38.48,61.52,132,66,224,58,197,78,221,69,68,0,0,0,66,118,28,1898
1288,664,624,285,379,1972,635,160900,671,617,52.10,47.90,311,155,256,88,472,102,189,24,0,0,79,326,40,12,12,1899
392,392,0,319,73,1968,877,172500,368,24,93.88,6.12,85,32,25,69,216,0,23,12,0,0,18,248,97,0,0,1900
396,325,71,308,17,1955,0,334000,396,0,100.00,0.00,15,17,25,34,271,0,0,44,0,7,0,0,232,66,13,1901
370,370,0,327,43,1982,0,354700,370,0,100.00,0.00,28,199,51,33,0,0,0,10,9,0,15,0,196,60,21,1902
573,539,34,410,129,1984,777,35500,84,489,14.66,85.34,327,80,324,45,10,0,137,0,0,0,464,55,98,0,0,1903
439,417,22,248,169,1939,606,107300,361,78,82.23,17.77,0,0,58,11,272,23,98,10,0,0,71,82,34,0,13,1904
658,611,47,438,173,1977,2011,884800,616,42,93.62,6.38,114,73,24,132,253,14,26,111,40,14,12,0,13,24,294,1905
449,449,0,409,40,1960,1630,369800,449,0,100.00,0.00,26,34,34,122,176,0,0,30,0,0,0,35,96,71,160,1906
644,621,23,480,141,1991,968,191800,428,216,66.46,33.54,183,0,159,131,109,0,47,48,0,0,57,269,73,11,0,1907
554,536,18,71,465,1978,761,224200,140,414,25.27,74.73,124,81,226,45,141,134,267,42,9,13,0,28,58,8,3,1908
254,242,12,115,127,1954,0,0,156,98,61.42,38.58,0,28,30,9,86,0,16,58,15,0,0,15,16,0,33,1909
435,300,135,138,162,1939,996,150700,305,130,70.11,29.89,9,76,8,81,218,9,111,68,0,0,31,151,22,0,0,1910
383,383,0,147,236,1989,563,122700,108,275,28.20,71.80,120,21,35,86,88,60,129,0,0,0,50,111,0,0,0,1911
478,447,31,84,363,1993,1085,241300,135,343,28.24,71.76,167,14,44,65,88,12,98,88,9,0,0,37,86,0,0,1912
450,450,0,385,65,1939,682,335800,370,80,82.22,17.78,21,7,11,15,361,0,9,12,0,34,0,95,128,49,0,1913
978,936,42,354,582,1999,631,166400,145,833,14.83,85.17,746,172,29,102,35,120,208,55,0,0,155,245,101,32,0,1914
607,563,44,539,24,1992,0,368400,488,119,80.40,19.60,231,123,123,99,28,19,0,0,0,0,17,64,265,106,78,1915
864,864,0,12,852,1991,936,0,12,852,1.39,98.61,722,152,45,13,55,0,579,242,0,0,0,31,0,0,13,1916
482,482,0,230,252,1944,894,218300,370,112,76.76,23.24,65,35,30,90,214,12,139,53,0,0,0,100,115,0,0,1917
934,883,51,298,585,1980,1187,315200,294,640,31.48,68.52,98,251,210,62,165,0,260,157,15,0,0,16,182,95,14,1918
1086,1030,56,582,448,1996,1106,460900,73,1013,6.72,93.28,405,43,238,68,102,148,130,80,16,16,0,14,96,106,146,1919
822,781,41,392,389,1988,1249,307700,464,358,56.45,43.55,644,301,221,59,13,47,214,158,80,0,0,82,308,178,78,1920
639,620,19,167,453,1992,1294,178800,81,558,12.68,87.32,215,433,110,0,0,0,110,351,19,0,35,89,136,0,0,1921
654,612,42,498,114,1960,1186,374200,598,56,91.44,8.56,95,67,164,99,172,0,46,54,57,0,0,22,279,105,34,1922
227,227,0,176,51,1981,1188,228600,88,139,38.77,61.23,32,96,104,45,14,0,20,49,0,10,0,109,61,26,0,1923
543,494,49,316,178,1970,1165,359800,528,15,97.24,2.76,13,54,46,165,174,0,13,0,79,0,10,10,311,29,0,1924
422,379,43,305,74,1967,0,321500,281,141,66.59,33.41,93,55,140,125,163,0,114,26,16,0,12,61,213,66,12,1925
448,448,0,213,235,1984,1600,337000,343,105,76.56,23.44,107,99,76,81,40,10,99,9,83,0,0,26,48,38,90,1926
528,528,0,409,119,1987,1614,301500,528,0,100.00,0.00,102,197,0,32,0,0,0,0,20,0,0,32,190,80,9,1927
745,745,0,647,98,1971,2120,639400,745,0,100.00,0.00,41,123,132,185,252,0,28,0,67,0,0,0,30,152,456,1928
632,632,0,195,437,1985,1483,427800,239,393,37.82,62.18,249,231,192,83,46,27,116,223,85,48,0,0,105,60,86,1929
475,475,0,322,153,1944,1074,134800,475,0,100.00,0.00,10,0,24,11,401,0,63,47,0,0,110,199,14,0,0,1930
622,530,92,416,114,1949,911,226300,584,38,93.89,6.11,55,29,53,21,539,0,129,20,9,15,19,364,71,14,14,1931
910,807,103,230,577,1993,1174,198900,392,518,43.08,56.92,501,279,9,0,0,0,213,99,19,82,0,132,142,0,12,1932
461,461,0,434,27,2003,0,270100,446,15,96.75,3.25,354,31,0,0,10,0,0,0,20,0,17,221,92,21,24,1933
534,534,0,105,429,1948,544,97400,122,412,22.85,77.15,0,60,10,33,377,162,154,22,0,0,45,41,0,9,0,1934
420,420,0,334,86,1968,1577,249200,380,40,90.48,9.52,97,52,63,177,74,0,0,0,0,0,0,59,229,41,107,1935
494,494,0,399,95,1946,1576,426200,470,24,95.14,4.86,46,14,0,62,441,0,76,0,0,16,0,21,105,119,197,1936
471,381,90,191,190,1940,695,168100,380,91,80.68,19.32,59,82,72,84,320,115,129,112,0,0,10,224,21,0,6,1937
598,586,12,396,190,1979,1207,235600,520,78,86.96,13.04,205,65,82,44,206,0,16,0,64,0,0,241,107,47,61,1938
766,766,0,420,346,1985,408,296700,440,326,57.44,42.56,307,127,32,154,106,228,52,25,0,13,0,179,161,27,0,1939
799,759,40,487,272,1957,1375,577000,662,137,82.85,17.15,28,11,30,118,619,38,134,45,0,5,0,0,168,122,294,1940
340,340,0,216,124,1939,386,134600,279,61,82.06,17.94,0,24,11,8,351,25,23,18,0,0,37,196,0,0,0,1941
477,303,174,234,69,1970,961,248300,411,66,86.16,13.84,143,27,63,64,103,0,31,0,0,0,11,90,100,11,80,1942
360,330,30,304,26,1977,0,302000,360,0,100.00,0.00,22,70,277,11,12,0,0,10,30,0,0,49,275,12,11,1943
316,279,37,267,12,1966,0,356600,316,0,100.00,0.00,25,10,55,205,0,0,0,22,18,0,0,23,119,88,25,1944
418,418,0,186,232,1975,1373,351300,221,197,52.87,47.13,117,26,230,87,14,0,140,58,0,36,0,0,62,105,32,1945
505,505,0,505,0,1995,0,556600,450,55,89.11,10.89,199,90,0,0,10,0,0,0,36,0,0,0,44,61,158,1946
665,665,0,406,259,1978,1349,425000,485,180,72.93,27.07,72,126,165,104,0,14,29,94,68,0,0,53,78,75,26,1947
514,514,0,460,54,1969,1729,486600,514,0,100.00,0.00,37,62,139,225,18,0,0,0,54,0,0,0,100,111,207,1948
363,349,14,145,204,1982,1116,0,20,343,5.51,94.49,76,193,189,0,12,0,90,49,0,13,0,139,23,0,27,1949
1492,1385,107,478,907,2000,1931,596200,214,1278,14.34,85.66,643,75,114,40,107,0,59,269,92,54,0,0,75,48,243,1950
504,441,63,136,305,1953,793,129500,357,147,70.83,29.17,39,84,131,36,236,49,134,115,0,0,0,164,14,0,14,1951
2102,902,1200,730,172,1990,1083,258600,1660,442,78.97,21.03,640,307,469,200,148,0,48,14,0,0,61,223,322,73,227,1952
1621,1472,149,197,1275,1989,736,246400,357,1264,22.02,77.98,951,201,306,194,51,216,909,154,88,0,0,21,64,0,0,1953
404,332,72,115,217,1950,1325,169900,266,138,65.84,34.16,45,92,66,71,406,73,206,150,0,0,10,100,61,16,0,1954
406,406,0,329,77,1966,570,156700,295,111,72.66,27.34,131,16,81,21,149,16,33,14,0,0,20,186,35,0,18,1955
550,550,0,375,175,1979,0,178100,403,147,73.27,26.73,407,99,104,17,54,19,0,24,0,0,0,261,191,28,74,1956
265,265,0,30,235,1955,1050,0,149,116,56.23,43.77,31,0,77,65,111,54,60,0,0,0,0,82,0,0,0,1957
367,325,42,76,249,1949,691,118800,210,157,57.22,42.78,46,0,80,13,296,133,113,21,0,0,49,80,0,0,0,1958
499,464,35,249,215,1954,799,102900,255,244,51.10,48.90,34,15,132,32,99,0,37,0,0,0,80,160,0,0,0,1959
261,241,20,76,165,1956,784,119200,211,50,80.84,19.16,0,24,19,66,145,10,64,33,0,0,45,94,8,0,0,1960
569,535,34,169,366,1939,627,283700,185,384,32.51,67.49,0,13,0,0,543,49,106,81,0,13,0,64,145,59,0,1961
576,537,39,86,451,1972,583,126300,70,506,12.15,87.85,0,32,222,126,65,211,135,0,0,0,38,48,0,0,0,1962
358,337,21,162,175,1973,646,161600,171,187,47.77,52.23,30,6,193,119,0,88,118,0,0,0,0,135,7,0,0,1963
266,266,0,266,0,1964,0,256700,266,0,100.00,0.00,43,43,13,61,128,0,0,0,0,0,0,126,78,46,6,1964
886,819,67,73,746,1968,474,225000,145,741,16.37,83.63,257,67,128,177,222,468,225,36,0,0,0,15,45,0,0,1965
567,512,55,282,230,1939,1130,224400,430,137,75.84,24.16,7,9,8,9,418,0,43,88,0,0,8,90,152,8,21,1966
604,528,76,395,133,1964,829,384800,440,164,72.85,27.15,132,40,20,137,292,0,82,74,17,10,0,47,191,73,92,1967
329,329,0,227,102,1979,1575,262500,285,44,86.63,13.37,127,44,16,12,317,0,10,42,16,0,0,198,210,28,12,1968
722,722,0,170,552,2001,963,220000,334,388,46.26,53.74,622,45,0,58,6,0,367,142,43,0,0,45,31,0,0,1969
901,831,70,78,753,1985,1029,138800,132,769,14.65,85.35,77,214,520,163,137,31,776,67,0,0,0,35,1,0,14,1970
434,394,40,215,179,1978,1326,177400,359,75,82.72,17.28,59,69,198,94,0,0,0,35,73,18,0,78,156,50,10,1971
394,357,37,172,185,1990,0,312800,284,110,72.08,27.92,81,125,29,72,82,44,65,0,11,0,0,54,128,33,34,1972
598,543,55,427,116,1987,1408,304500,491,107,82.11,17.89,287,141,46,26,82,0,4,7,13,0,21,51,117,152,146,1973
488,446,42,285,161,1962,1054,270200,393,95,80.53,19.47,51,78,28,78,256,0,51,47,9,0,8,158,161,22,0,1974
488,460,28,445,15,1995,0,419100,376,112,77.05,22.95,299,59,45,26,28,27,0,0,0,0,67,32,84,58,124,1975
234,234,0,180,54,1979,0,235200,218,16,93.16,6.84,180,15,47,70,18,0,0,19,0,0,8,66,192,15,11,1976
493,468,25,90,378,1974,1059,204700,160,333,32.45,67.55,157,190,119,67,83,79,317,45,0,0,16,58,101,0,0,1977
290,250,40,158,92,1976,1115,328800,212,78,73.10,26.90,33,36,97,15,63,36,13,3,0,0,12,0,70,36,74,1978
412,373,39,289,84,1986,1288,236700,340,72,82.52,17.48,167,236,22,26,34,14,0,206,0,0,0,50,169,11,0,1979
1284,1152,132,63,1089,1990,855,127100,57,1227,4.44,95.56,562,149,170,32,57,36,737,0,0,106,0,58,0,0,0,1980
526,526,0,412,114,1973,0,226200,526,0,100.00,0.00,64,0,176,220,0,0,0,47,68,0,0,130,215,0,0,1981
382,382,0,339,43,1966,0,211900,382,0,100.00,0.00,20,0,27,306,86,0,0,0,0,0,16,157,266,0,0,1982
487,487,0,447,40,1982,1615,262800,487,0,100.00,0.00,54,186,179,57,38,0,12,0,17,0,0,25,407,38,15,1983
671,599,72,366,233,1963,776,223100,456,215,67.96,32.04,18,38,164,231,192,48,115,13,0,35,0,173,140,43,29,1984
698,677,21,139,538,1993,1158,150600,180,518,25.79,74.21,207,98,115,87,0,34,227,109,0,0,20,42,17,3,0,1985
563,563,0,304,259,1960,1113,405200,378,185,67.14,32.86,0,8,193,98,281,16,96,48,0,0,0,11,165,63,116,1986
506,506,0,400,106,1958,1342,345300,506,0,100.00,0.00,0,0,13,13,359,0,0,111,0,0,0,37,205,32,0,1987
583,562,21,209,353,1973,1081,278300,274,309,47.00,53.00,90,100,154,82,120,71,193,25,14,0,0,17,149,54,9,1988
310,310,0,292,18,1966,0,306600,264,46,85.16,14.84,33,0,11,119,102,0,0,0,0,0,10,10,162,51,32,1989
362,362,0,211,151,1958,1296,305800,254,108,70.17,29.83,130,0,12,38,228,0,70,71,0,0,0,77,161,13,16,1990
350,350,0,309,41,1964,0,418100,350,0,100.00,0.00,58,11,81,187,93,0,0,50,0,0,0,0,151,165,64,1991
1108,1055,53,273,782,1982,1118,266100,336,772,30.32,69.68,14,81,148,89,274,160,55,45,14,0,14,104,96,71,0,1992
395,395,0,334,61,1965,1962,366000,395,0,100.00,0.00,48,23,52,83,106,0,0,0,39,0,0,0,128,110,11,1993
390,361,29,333,28,1957,1406,670300,369,21,94.62,5.38,38,21,74,125,156,0,6,11,21,0,0,0,53,65,226,1994
535,535,0,410,125,1950,967,274000,460,75,85.98,14.02,14,16,0,17,577,65,16,11,31,0,0,148,261,42,0,1995
481,442,39,208,234,1985,334,350700,287,194,59.67,40.33,81,32,38,61,149,0,48,29,9,46,0,26,134,41,14,1996
672,629,43,452,177,1952,976,365400,561,111,83.48,16.52,7,33,26,82,560,0,53,42,9,15,9,31,335,152,7,1997
457,414,43,222,192,1952,1571,293600,353,104,77.24,22.76,14,61,42,142,265,16,182,81,13,0,0,22,180,30,0,1998
291,291,0,185,106,1944,1695,260400,291,0,100.00,0.00,37,19,37,63,254,0,47,83,0,0,0,38,148,37,0,1999
392,372,20,117,255,1962,851,279900,144,248,36.73,63.27,49,32,0,40,226,12,196,33,0,9,0,21,65,0,11,2000
987,916,71,153,763,1980,994,124300,100,887,10.13,89.87,178,225,342,75,14,0,268,263,35,0,16,144,0,0,0,2001
674,635,39,482,153,1990,1311,298500,574,100,85.16,14.84,224,241,165,11,0,0,100,107,0,15,0,21,237,96,65,2002
313,271,42,202,69,1985,0,231000,302,11,96.49,3.51,76,141,112,0,0,0,0,0,21,35,0,50,223,0,0,2003
464,446,18,357,89,1984,0,272300,412,52,88.79,11.21,108,152,75,71,42,0,17,8,45,0,0,68,167,72,40,2004
455,455,0,188,267,1986,1054,277900,240,215,52.75,47.25,205,72,31,113,0,131,84,0,11,0,0,9,140,14,32,2005
590,535,55,155,380,1960,923,235800,262,328,44.41,55.59,120,92,105,61,124,14,265,0,0,17,0,47,99,0,0,2006
637,528,109,87,441,1982,894,162500,80,557,12.56,87.44,241,176,232,89,41,11,434,161,0,0,60,0,29,0,11,2007
461,416,45,29,387,1980,749,0,40,421,8.68,91.32,47,125,176,72,54,94,340,12,0,0,0,0,15,0,0,2008
704,649,55,89,560,1975,955,0,77,627,10.94,89.06,46,195,456,170,30,14,483,56,0,0,74,0,0,0,0,2009
490,480,10,397,83,1960,1543,258200,469,21,95.71,4.29,65,11,9,128,197,0,0,41,19,0,0,110,187,9,19,2010
367,367,0,273,94,1960,778,211600,273,94,74.39,25.61,7,0,0,118,224,0,11,0,10,0,0,116,161,11,32,2011
338,338,0,293,45,1983,1313,331500,298,40,88.17,11.83,104,86,132,26,66,0,6,38,0,0,8,38,156,50,111,2012
562,504,58,51,453,1976,907,189100,52,510,9.25,90.75,121,117,208,172,69,72,325,83,17,0,0,62,46,0,0,2013
609,609,0,528,81,1992,1168,323800,609,0,100.00,0.00,361,75,129,27,33,0,0,14,0,12,0,42,351,173,33,2014
704,665,39,583,82,1978,1171,205200,660,44,93.75,6.25,296,0,309,0,16,0,0,52,0,0,18,336,204,11,0,2015
360,351,9,291,60,1960,2188,441500,360,0,100.00,0.00,0,0,0,63,209,0,0,0,0,0,0,0,58,70,111,2016
434,407,27,145,262,1943,0,175300,267,167,61.52,38.48,16,14,53,28,414,87,56,0,15,0,0,193,80,0,11,2017
599,528,71,318,210,1974,862,151000,344,255,57.43,42.57,237,131,103,25,189,12,104,140,0,0,35,182,72,0,26,2018
565,565,0,409,156,1984,1116,256600,495,70,87.61,12.39,152,36,66,157,148,0,23,43,33,0,0,70,305,45,19,2019
303,248,55,248,0,1968,0,331700,303,0,100.00,0.00,143,13,47,109,16,0,0,0,0,0,0,0,158,109,61,2020
689,689,0,256,433,1971,1017,219000,220,469,31.93,68.07,18,68,364,319,60,28,342,175,0,0,63,25,122,0,17,2021
657,657,0,627,30,1971,1222,309000,626,31,95.28,4.72,96,17,330,265,29,0,0,9,33,16,13,81,406,155,24,2022
533,520,13,478,42,1996,854,407600,504,29,94.56,5.44,407,51,92,12,0,0,0,9,0,12,0,64,112,218,147,2023
370,307,63,89,218,1987,1359,237000,176,194,47.57,52.43,173,223,31,76,13,0,149,108,16,0,0,13,133,27,70,2024
447,406,41,301,105,1961,631,177000,375,72,83.89,16.11,156,48,60,12,197,17,27,18,0,0,38,186,73,17,24,2025
435,408,27,76,332,1963,808,285700,116,319,26.67,73.33,32,57,20,143,116,73,114,48,0,0,0,16,49,10,0,2026
731,701,30,451,250,1975,1496,308200,640,91,87.55,12.45,124,56,65,142,361,9,21,43,62,9,14,70,322,74,13,2027
455,455,0,275,180,1950,1271,409800,331,124,72.75,27.25,0,13,57,46,340,0,56,72,16,14,0,0,119,61,44,2028
674,501,173,99,402,1987,1779,303900,119,555,17.66,82.34,42,55,0,46,223,15,107,18,13,27,0,29,48,29,17,2029
960,808,152,234,574,1962,1011,385800,260,700,27.08,72.92,64,48,66,130,356,17,258,17,98,0,0,26,40,28,51,2030
487,487,0,354,133,1942,754,335800,397,90,81.52,18.48,87,43,33,0,308,53,96,28,43,0,12,14,164,10,20,2031
412,412,0,206,206,1998,770,382200,257,155,62.38,37.62,71,20,0,0,67,17,20,14,0,18,0,0,58,20,0,2032
683,613,70,184,429,1939,1034,414500,271,412,39.68,60.32,43,120,28,33,494,0,418,77,24,0,0,24,111,12,15,2033
791,738,53,514,224,1942,1159,308400,597,194,75.47,24.53,219,28,0,66,359,0,32,73,50,0,0,48,191,138,69,2034
399,399,0,272,127,1958,1085,218800,341,58,85.46,14.54,13,44,105,99,218,0,0,35,0,0,18,160,211,14,0,2035
366,336,30,213,123,1964,997,229600,264,102,72.13,27.87,51,84,44,76,227,0,173,15,15,0,0,105,65,43,0,2036
553,509,44,101,408,1977,1004,270500,103,450,18.63,81.37,88,240,68,68,151,72,120,145,29,0,22,60,99,0,0,2037
881,802,79,249,553,1978,979,277800,355,526,40.30,59.70,36,46,232,98,195,0,175,91,25,0,28,67,87,28,39,2038
712,699,13,116,583,1973,802,164300,62,650,8.71,91.29,28,74,155,180,246,12,454,47,13,0,0,111,30,0,0,2039
623,559,64,332,227,1960,856,224300,442,181,70.95,29.05,36,58,39,160,350,74,106,49,12,73,0,146,145,38,0,2040
364,330,34,225,105,1950,1013,209500,336,28,92.31,7.69,0,15,64,45,428,44,10,77,56,0,12,96,195,14,11,2041
973,933,40,296,637,1987,1402,418600,315,658,32.37,67.63,516,281,96,20,0,0,174,264,32,10,0,145,103,139,20,2042
734,704,30,267,437,1994,1671,917300,280,454,38.15,61.85,650,191,20,0,0,0,44,217,113,45,18,12,11,0,247,2043
452,430,22,307,123,1971,1682,523800,445,7,98.45,1.55,11,13,199,9,129,0,0,0,0,16,9,10,22,97,207,2044
397,362,35,295,67,1969,1636,364300,397,0,100.00,0.00,41,18,141,89,21,0,0,10,0,0,0,0,154,63,19,2045
569,569,0,542,27,1979,0,283100,465,104,81.72,18.28,246,46,28,107,27,0,0,13,9,45,0,69,105,108,105,2046
590,590,0,491,99,1939,0,449000,564,26,95.59,4.41,0,35,0,13,474,0,15,25,0,24,0,0,78,116,251,2047
388,388,0,364,24,1953,0,434800,388,0,100.00,0.00,19,19,0,33,417,17,0,0,0,42,7,73,81,76,148,2048
327,223,104,209,14,1974,0,565100,239,88,73.09,26.91,0,67,109,0,254,0,25,0,15,17,0,32,0,56,128,2049
441,387,54,313,74,1962,0,364200,340,101,77.10,22.90,24,31,0,48,376,0,110,0,0,0,37,40,182,41,55,2050
577,532,45,132,400,1974,362,289300,112,465,19.41,80.59,110,21,217,118,40,132,107,73,0,12,0,0,74,6,40,2051
1041,958,83,51,907,1966,773,308900,10,1031,0.96,99.04,385,37,130,27,508,568,218,137,15,0,9,10,12,0,0,2052
604,571,33,251,320,1965,0,420600,283,321,46.85,53.15,179,15,0,69,486,49,146,250,11,4,0,44,128,16,69,2053
981,898,83,363,535,1990,1159,375600,338,643,34.45,65.55,438,46,116,45,99,42,75,173,22,7,0,29,102,88,136,2054
1017,888,129,373,515,1978,1056,225700,565,452,55.56,44.44,272,316,421,124,0,0,365,150,0,0,0,286,225,0,20,2055
619,584,35,430,154,1965,0,249200,542,77,87.56,12.44,94,111,66,75,158,0,52,28,6,0,45,152,126,17,57,2056
447,424,23,161,263,1949,883,138100,258,189,57.72,42.28,14,20,140,59,423,92,203,37,0,0,12,146,37,0,0,2057
954,896,58,245,651,1939,780,154900,555,399,58.18,41.82,0,0,82,152,682,75,338,64,0,0,26,204,41,6,0,2058
557,557,0,245,312,1939,682,157400,425,132,76.30,23.70,0,8,30,39,511,66,53,10,11,0,11,310,42,0,0,2059
639,596,43,427,169,1939,1391,224300,595,44,93.11,6.89,62,46,110,48,266,0,48,53,55,0,14,195,116,9,0,2060
582,538,44,486,52,1982,1658,381800,582,0,100.00,0.00,197,38,72,102,81,0,13,0,0,0,10,52,198,67,150,2061
657,600,57,551,49,1996,2272,279200,657,0,100.00,0.00,532,85,29,6,0,0,0,68,0,0,14,32,433,91,14,2062
759,759,0,601,158,1979,2014,290000,721,38,94.99,5.01,183,58,259,65,47,0,32,13,0,0,14,28,422,103,0,2063
612,571,41,542,29,1998,0,259200,554,58,90.52,9.48,188,56,105,32,18,12,12,25,0,0,0,104,73,61,73,2064
444,419,25,277,142,1984,1204,0,205,239,46.17,53.83,108,104,60,57,79,0,76,37,0,0,110,65,25,8,62,2065
863,816,47,556,260,1994,1158,191600,399,464,46.23,53.77,425,247,82,62,75,0,69,32,62,3,0,153,401,50,41,2066
466,391,75,212,179,1939,689,333300,292,174,62.66,37.34,0,0,84,9,297,18,117,15,0,29,0,59,55,64,33,2067
545,523,22,434,89,1984,2123,311800,536,9,98.35,1.65,121,232,134,0,0,0,0,0,81,13,9,25,198,88,64,2068
643,606,37,474,132,1990,1172,207100,478,165,74.34,25.66,376,107,189,66,0,0,43,40,0,0,11,245,399,0,0,2069
358,358,0,314,44,1986,0,359000,304,54,84.92,15.08,80,75,78,54,0,0,54,0,0,0,10,29,67,70,46,2070
1329,1280,49,354,926,1986,1010,106800,172,1157,12.94,87.06,479,456,322,10,11,0,614,295,10,0,0,141,125,0,0,2071
645,609,36,545,64,2001,2068,346900,630,15,97.67,2.33,505,80,28,0,25,0,0,41,10,9,0,25,294,224,25,2072
620,598,22,149,449,1991,886,250400,243,377,39.19,60.81,248,85,59,13,39,46,147,122,0,0,0,70,30,0,0,2073
899,856,43,545,311,1994,808,159300,565,334,62.85,37.15,377,37,157,102,262,59,154,0,0,0,82,466,50,50,0,2074
632,616,16,392,224,1990,395,125400,182,450,28.80,71.20,207,80,192,57,57,62,76,75,0,0,176,129,56,0,0,2075
421,378,43,129,249,1963,806,125700,240,181,57.01,42.99,19,30,72,58,229,20,125,0,0,0,21,137,18,0,0,2076
519,451,68,376,75,1982,0,240200,385,134,74.18,25.82,145,21,172,12,69,0,10,0,10,0,10,175,139,13,0,2077
613,556,57,388,168,1983,743,164400,402,211,65.58,34.42,188,0,101,18,157,24,34,0,0,0,28,194,72,10,10,2078
705,554,151,199,355,1976,840,0,278,427,39.43,60.57,493,180,46,31,30,135,147,15,0,0,82,249,46,0,0,2079
934,789,145,604,185,1988,1275,242100,855,79,91.54,8.46,362,215,106,19,127,0,20,53,3,3,13,263,177,28,130,2080
456,456,0,373,83,1983,0,533800,456,0,100.00,0.00,12,263,94,18,0,0,0,0,0,0,0,12,56,68,251,2081
1319,1165,154,205,960,1977,1351,238600,159,1160,12.05,87.95,504,468,761,27,0,18,536,694,249,0,11,97,118,0,37,2082
1364,1314,50,302,1012,1986,1567,371800,250,1114,18.33,81.67,409,512,361,65,0,42,156,654,148,0,0,62,179,0,91,2083
444,444,0,397,47,1966,0,485000,444,0,100.00,0.00,12,20,71,358,24,23,10,29,91,11,0,8,67,53,182,2084
1052,930,122,0,930,1985,1403,0,8,1044,0.76,99.24,159,229,551,93,151,0,643,503,0,0,0,0,0,0,0,2085
507,507,0,387,120,1956,1568,357200,494,13,97.44,2.56,33,0,21,147,279,0,16,0,50,21,7,0,164,129,93,2086
465,465,0,453,12,1970,0,613400,446,19,95.91,4.09,57,66,56,153,90,0,0,0,11,0,0,0,7,52,322,2087
516,516,0,424,92,1996,1151,455100,284,232,55.04,44.96,323,13,56,55,25,0,0,11,0,32,0,132,62,14,193,2088
1034,940,94,318,622,1977,1134,802800,225,809,21.76,78.24,203,263,366,255,30,88,231,401,83,0,0,15,57,23,208,2089
549,355,194,212,143,1966,950,196600,386,163,70.31,29.69,90,53,49,47,245,19,251,32,0,0,10,48,76,21,0,2090
667,623,44,278,345,1982,827,210200,317,350,47.53,52.47,184,58,143,67,102,0,57,57,56,0,0,239,110,0,0,2091
596,568,28,374,194,1964,533,355300,420,176,70.47,29.53,58,72,194,27,273,115,10,96,0,0,68,10,172,37,116,2092
554,465,89,388,77,1984,803,183900,352,202,63.54,36.46,135,173,169,25,39,0,42,0,0,0,65,193,95,24,21,2093
632,556,76,390,166,1980,1174,179600,595,37,94.15,5.85,114,73,206,12,7,0,43,92,0,0,0,204,32,0,11,2094
362,362,0,338,24,1973,2273,624000,352,10,97.24,2.76,45,59,200,56,0,0,0,10,24,0,0,20,11,81,214,2095
647,647,0,491,156,1983,1945,498100,633,14,97.84,2.16,310,34,68,104,0,0,0,25,33,5,0,0,61,67,325,2096
404,404,0,307,97,1976,1699,286400,404,0,100.00,0.00,15,125,134,51,31,0,0,0,76,6,18,45,176,10,0,2097
388,333,55,304,29,1963,1775,218800,388,0,100.00,0.00,0,5,11,281,112,0,0,11,31,12,0,109,246,0,0,2098
565,522,43,444,78,1989,1398,473800,418,147,73.98,26.02,200,263,96,18,17,0,11,111,13,42,11,33,43,148,182,2099
491,359,132,342,17,1984,0,286300,340,151,69.25,30.75,144,112,120,116,210,15,34,15,0,0,31,145,100,41,43,2100
621,527,94,402,125,1972,0,311300,543,78,87.44,12.56,175,0,170,58,117,0,32,0,0,0,0,109,158,14,66,2101
509,396,113,155,241,1941,725,191200,397,112,78.00,22.00,42,46,42,37,327,68,148,6,0,0,0,107,68,6,7,2102
238,203,35,129,74,1951,425,213200,165,73,69.33,30.67,24,16,36,75,184,49,93,0,49,0,45,36,51,0,0,2103
1104,713,391,462,251,1984,955,338900,620,484,56.16,43.84,411,443,144,30,181,18,74,28,4,0,22,99,204,171,107,2104
392,392,0,63,329,1945,528,158900,63,329,16.07,83.93,21,0,116,58,324,103,205,0,0,0,0,122,31,0,0,2105
448,367,81,189,178,1943,780,123200,290,158,64.73,35.27,14,11,101,0,379,85,67,0,0,0,21,148,18,0,0,2106
439,395,44,269,126,1979,1135,246600,282,157,64.24,35.76,221,46,54,45,79,0,16,0,16,67,0,132,181,33,0,2107
730,566,164,363,203,1957,1063,185800,444,286,60.82,39.18,69,146,156,188,205,40,64,124,42,12,48,270,81,0,0,2108
528,528,0,466,62,1989,1125,209600,366,162,69.32,30.68,267,137,75,38,0,0,19,0,0,0,47,146,223,29,8,2109
299,273,26,229,44,1964,623,231500,258,41,86.29,13.71,152,28,54,25,63,0,33,29,0,0,15,59,117,0,69,2110
479,479,0,298,181,1950,1263,447200,379,100,79.12,20.88,0,16,44,64,374,0,67,96,0,0,0,12,146,75,80,2111
408,408,0,271,137,1983,1343,199600,395,13,96.81,3.19,157,47,109,70,29,0,8,24,45,0,35,32,193,53,22,2112
275,267,8,213,54,1943,2474,549300,275,0,100.00,0.00,7,0,31,11,271,13,13,0,7,0,0,13,52,20,190,2113
1112,1071,41,823,248,1994,1750,234400,1039,73,93.44,6.56,406,69,164,124,52,0,0,94,0,0,16,158,477,38,0,2114
381,363,18,299,64,1976,775,213800,296,85,77.69,22.31,101,76,57,90,88,8,59,0,0,0,61,133,44,50,19,2115
405,391,14,182,209,2004,377,306200,290,115,71.60,28.40,340,0,0,0,27,171,33,0,0,0,0,52,86,10,0,2116
214,214,0,82,132,1939,794,105000,192,22,89.72,10.28,19,0,0,29,251,64,25,0,0,0,189,21,0,0,0,2117
453,444,9,302,142,1965,1197,247600,351,102,77.48,22.52,12,34,148,19,130,0,33,45,26,0,0,104,71,7,40,2118
584,529,55,186,343,1986,428,336100,201,383,34.42,65.58,59,97,166,15,136,170,110,36,0,0,0,64,93,0,0,2119
703,592,111,284,308,1945,1051,172700,648,55,92.18,7.82,177,0,27,16,401,0,45,13,15,0,30,383,53,0,0,2120
797,718,79,608,110,1992,1310,214600,722,75,90.59,9.41,400,153,130,16,0,0,37,50,0,14,40,279,220,26,8,2121
469,166,303,100,66,1974,683,225000,429,40,91.47,8.53,246,58,44,83,78,0,0,0,0,0,0,38,70,23,43,2122
540,540,0,378,162,1950,1125,213800,469,71,86.85,13.15,44,0,10,0,293,0,20,20,0,0,9,170,99,14,0,2123
442,442,0,277,165,1967,1135,183200,384,58,86.88,13.12,62,70,72,66,57,0,50,50,45,0,0,87,95,0,0,2124
1794,1668,126,770,898,2002,939,259200,1024,770,57.08,42.92,1096,169,116,17,0,0,240,113,35,19,230,372,220,9,0,2125
847,633,214,483,150,1986,816,171100,696,151,82.17,17.83,375,91,196,40,148,24,35,5,0,0,141,239,148,39,38,2126
509,480,29,251,229,1979,1083,246300,283,226,55.60,44.40,20,166,113,96,75,0,148,97,29,0,0,62,125,9,0,2127
518,460,58,239,221,1962,677,208000,352,166,67.95,32.05,198,54,33,24,256,62,58,78,68,0,0,133,123,10,6,2128
659,592,67,301,291,1963,932,401600,311,348,47.19,52.81,65,67,84,107,246,0,170,85,31,0,0,40,85,69,41,2129
523,453,70,305,148,1957,676,115600,450,73,86.04,13.96,44,109,72,27,363,0,70,9,0,0,186,218,21,0,0,2130
272,222,50,174,48,1946,0,253200,272,0,100.00,0.00,0,0,0,0,308,11,23,29,0,26,0,56,89,14,0,2131
622,468,154,145,323,1989,1085,120800,68,554,10.93,89.07,405,93,6,0,12,71,269,161,0,0,0,15,0,0,0,2132
534,534,0,101,433,1978,954,156500,186,348,34.83,65.17,72,27,469,74,24,0,296,116,50,0,27,104,9,0,0,2133
844,844,0,99,745,1981,931,201500,122,722,14.45,85.55,210,280,172,43,66,37,419,72,0,34,0,35,137,0,0,2134
262,262,0,226,36,1953,1188,205400,262,0,100.00,0.00,0,11,11,30,270,0,19,41,0,0,0,164,67,0,0,2135
649,605,44,476,129,1994,1400,306100,521,128,80.28,19.72,539,117,24,12,0,0,0,108,10,3,4,78,263,121,91,2136
344,325,19,240,85,1957,1105,163800,344,0,100.00,0.00,0,0,60,103,186,5,52,73,33,0,0,128,0,0,0,2137
926,771,155,164,607,1955,1504,717400,236,690,25.49,74.51,142,0,106,85,537,0,0,437,149,61,0,17,10,11,127,2138
622,562,60,380,182,1946,964,139400,578,44,92.93,7.07,12,17,21,54,514,5,114,51,0,0,7,402,12,0,0,2139
546,546,0,505,41,1973,1214,373300,521,25,95.42,4.58,44,70,124,105,88,0,63,50,8,0,21,20,121,17,131,2140
327,327,0,216,111,1982,855,159600,318,9,97.25,2.75,149,46,16,0,211,0,13,26,0,0,18,211,30,0,0,2141
405,405,0,259,146,1962,1506,322000,392,13,96.79,3.21,38,9,51,91,151,0,0,11,0,0,0,0,122,93,65,2142
780,664,116,553,111,1984,0,184000,532,248,68.21,31.79,257,280,70,20,62,0,0,79,0,0,79,195,187,37,28,2143
273,229,44,64,165,1976,856,262500,100,173,36.63,63.37,13,54,67,41,121,31,39,8,0,0,8,44,159,7,0,2144
701,674,27,491,183,1990,1655,269200,672,29,95.86,4.14,285,100,79,50,120,0,14,22,15,4,2,136,202,97,129,2145
455,376,79,262,114,1994,998,315900,390,65,85.71,14.29,281,126,54,43,38,0,35,35,0,0,30,35,128,118,25,2146
448,405,43,330,75,1987,857,162700,403,45,89.96,10.04,198,70,142,82,61,0,165,75,0,0,27,210,76,0,0,2147
581,565,16,394,171,2001,844,175700,508,73,87.44,12.56,393,38,75,30,43,41,10,42,0,0,27,429,6,0,9,2148
562,536,26,372,164,1977,850,251600,375,187,66.73,33.27,65,99,189,89,179,0,189,28,0,0,162,93,69,51,0,2149
796,761,35,487,274,1939,1032,275000,757,39,95.10,4.90,34,34,31,0,697,0,118,73,14,0,14,159,278,54,23,2150
708,648,60,121,527,1972,846,155200,189,519,26.69,73.31,12,75,35,116,345,56,246,36,0,0,0,85,72,0,0,2151
584,558,26,440,118,1973,1426,432800,516,68,88.36,11.64,90,62,229,154,0,0,0,30,32,24,0,0,194,120,135,2152
478,478,0,389,89,1996,1088,209500,478,0,100.00,0.00,487,15,0,0,0,0,0,57,0,0,0,367,78,0,0,2153
407,407,0,236,171,1966,1699,455200,291,116,71.50,28.50,71,74,100,196,88,14,34,59,35,31,17,13,91,48,115,2154
678,647,31,228,419,1970,961,260400,319,359,47.05,52.95,108,189,47,130,62,0,100,85,0,0,90,72,66,51,35,2155
869,850,19,759,91,1999,1396,490300,727,142,83.66,16.34,778,0,0,0,42,0,0,10,13,15,9,75,124,96,444,2156
264,264,0,111,153,1939,872,191100,161,103,60.98,39.02,0,0,0,14,358,102,80,29,0,0,48,113,0,0,0,2157
609,538,71,189,349,1976,905,177200,255,354,41.87,58.13,18,152,207,144,161,0,271,96,0,0,13,147,53,15,0,2158
655,619,36,171,448,1976,723,302100,219,436,33.44,66.56,110,12,94,101,129,91,97,14,12,0,0,10,61,0,0,2159
764,726,38,143,583,1982,1163,299200,96,668,12.57,87.43,287,142,83,94,53,26,139,184,46,0,0,54,86,45,25,2160
674,550,124,156,394,1968,694,184200,175,499,25.96,74.04,59,135,230,170,73,65,354,162,17,0,0,69,0,0,0,2161
278,262,16,127,135,1956,865,175900,270,8,97.12,2.88,0,0,0,29,254,29,28,11,0,0,0,74,52,7,0,2162
530,490,40,186,304,1978,871,272600,212,318,40.00,60.00,88,173,158,87,298,64,420,20,19,0,0,98,116,38,29,2163
768,768,0,113,655,1955,1036,292100,63,705,8.20,91.80,0,104,14,70,475,14,343,108,0,54,0,0,78,0,13,2164
349,329,20,176,153,1949,654,207000,211,138,60.46,39.54,0,73,69,28,257,40,110,21,0,0,0,144,38,0,0,2165
265,265,0,0,265,1972,558,0,13,252,4.91,95.09,0,34,265,15,50,131,81,0,0,0,53,0,0,0,0,2166
260,218,42,123,95,1950,813,145600,223,37,85.77,14.23,6,0,39,13,223,12,27,2,0,0,86,133,21,0,0,2167
947,879,68,109,770,1982,907,158800,130,817,13.73,86.27,112,143,42,113,186,13,373,24,0,0,0,70,116,0,0,2168
801,747,54,393,354,1965,1163,393900,318,483,39.70,60.30,189,27,28,35,466,0,208,137,64,0,0,27,120,100,50,2169
455,455,0,248,207,1981,1793,533000,168,287,36.92,63.08,83,54,297,27,58,0,13,112,71,0,0,24,20,42,190,2170
651,651,0,575,76,1975,1625,261200,535,116,82.18,17.82,271,131,115,127,177,0,9,0,15,0,130,50,313,98,148,2171
482,445,37,384,61,1994,1468,167200,455,27,94.40,5.60,228,40,41,23,56,19,59,6,8,0,0,96,100,17,24,2172
761,761,0,578,183,1954,1518,761800,590,171,77.53,22.47,0,27,53,35,645,0,59,0,21,6,27,8,12,71,515,2173
1264,1113,151,173,940,1976,669,173100,232,1032,18.35,81.65,334,36,664,74,38,133,583,21,10,0,24,149,0,0,0,2174
388,388,0,280,108,1939,1073,384600,316,72,81.44,18.56,10,0,19,0,350,0,58,0,0,0,28,11,139,47,96,2175
609,609,0,427,182,1994,0,362200,468,141,76.85,23.15,230,101,172,89,65,10,80,44,27,11,0,145,204,42,87,2176
422,390,32,372,18,1979,0,236200,248,174,58.77,41.23,93,87,187,32,38,0,9,9,0,0,125,105,67,33,54,2177
541,468,73,242,226,2000,839,125000,293,248,54.16,45.84,123,41,99,13,81,17,130,0,0,0,67,88,0,0,11,2178
459,459,0,355,104,1994,1232,188300,452,7,98.47,1.53,273,0,80,19,13,0,0,76,0,0,0,139,140,0,0,2179
552,515,37,394,121,1982,1377,617400,505,47,91.49,8.51,160,247,35,76,69,0,0,112,14,88,0,0,32,85,215,2180
644,602,42,214,388,1977,754,0,72,572,11.18,88.82,55,90,208,214,115,10,342,72,0,0,172,0,0,0,0,2181
230,230,0,116,114,1970,1257,162500,197,33,85.65,14.35,0,21,26,71,83,0,40,0,0,0,44,117,0,0,0,2182
1138,1079,59,738,341,1975,1247,194200,995,143,87.43,12.57,376,79,99,61,279,0,90,112,0,0,0,457,181,0,7,2183
293,293,0,155,138,1952,1024,149800,268,25,91.47,8.53,25,5,46,12,221,0,0,31,0,0,17,228,33,0,0,2184
521,413,108,172,241,1977,859,168300,332,189,63.72,36.28,74,93,132,82,30,46,78,53,13,0,0,181,21,0,0,2185
865,865,0,441,424,1996,1922,364800,413,452,47.75,52.25,589,40,67,12,9,0,0,85,149,129,0,36,55,118,118,2186
594,488,106,225,263,1956,779,119100,533,61,89.73,10.27,63,57,87,127,361,10,32,0,0,0,165,218,51,0,56,2187
761,664,97,346,318,1993,1449,165800,215,546,28.25,71.75,529,170,35,0,0,0,28,214,17,0,0,352,80,0,0,2188
569,516,53,40,476,2001,737,264300,32,537,5.62,94.38,433,10,12,158,0,183,214,51,0,0,12,12,47,0,26,2189
439,439,0,106,333,1961,438,109300,106,333,24.15,75.85,0,0,35,31,389,241,53,0,0,0,64,42,0,0,0,2190
1025,1016,9,284,732,1987,997,86100,283,742,27.61,72.39,367,298,225,82,26,74,279,199,0,12,84,233,47,0,0,2191
339,339,0,192,147,1939,1084,158600,282,57,83.19,16.81,20,0,0,6,344,0,41,95,43,0,23,117,21,0,0,2192
489,467,22,262,205,1953,1514,342700,450,39,92.02,7.98,58,8,105,53,313,0,39,16,62,0,0,21,313,35,13,2193
262,262,0,251,11,1982,0,270800,262,0,100.00,0.00,78,77,10,42,65,0,0,3,7,7,13,44,134,21,0,2194
317,289,28,229,60,1955,1705,376700,317,0,100.00,0.00,0,45,20,39,262,0,32,13,0,0,9,48,75,91,76,2195
773,744,29,624,120,1968,1078,168300,754,19,97.54,2.46,154,24,261,128,235,16,25,58,12,0,37,469,70,28,0,2196
1091,969,122,338,631,1943,987,198900,667,424,61.14,38.86,30,107,182,71,606,35,411,159,0,0,13,155,115,15,0,2197
258,258,0,242,16,1958,0,303900,258,0,100.00,0.00,0,0,9,108,170,0,0,0,17,0,13,0,126,45,37,2198
570,535,35,297,238,1939,1022,203000,453,117,79.47,20.53,0,44,0,30,508,105,173,44,20,0,12,106,79,0,8,2199
512,497,15,197,300,1949,781,154800,288,224,56.25,43.75,138,34,98,9,302,78,242,8,0,0,15,102,73,0,0,2200
219,215,4,22,193,1946,482,85000,59,160,26.94,73.06,0,0,6,5,261,106,44,59,0,0,9,16,0,0,0,2201
280,280,0,253,27,1939,1375,336800,272,8,97.14,2.86,14,0,84,0,309,0,78,33,46,0,0,18,102,28,63,2202
816,755,61,299,456,1988,1082,371800,400,416,49.02,50.98,387,53,179,74,65,13,323,42,0,0,0,0,78,45,176,2203
208,200,8,169,31,1983,917,281900,200,8,96.15,3.85,69,14,36,13,172,0,9,59,0,0,11,73,81,59,0,2204
264,264,0,234,30,1970,0,287600,234,30,88.64,11.36,43,20,120,25,15,0,0,0,15,0,0,0,78,41,28,2205
431,341,90,310,31,1939,1516,173800,431,0,100.00,0.00,0,0,13,0,366,0,15,29,0,0,0,233,79,0,23,2206
271,271,0,271,0,1966,0,425600,271,0,100.00,0.00,0,0,52,189,0,0,0,0,0,0,0,0,73,132,36,2207
537,537,0,254,283,1972,555,96900,281,256,52.33,47.67,58,32,134,37,170,27,117,0,0,0,104,156,0,0,0,2208
548,443,105,214,229,1973,860,137200,330,218,60.22,39.78,61,75,152,176,81,52,80,27,13,0,27,266,80,0,0,2209
875,875,0,289,586,1996,1182,211800,385,490,44.00,56.00,698,13,0,0,0,0,164,65,0,0,14,111,231,0,0,2210
1130,1041,89,54,987,1939,967,274000,0,1130,0.00,100.00,406,46,14,14,740,76,690,253,15,0,0,64,84,38,0,2211
603,581,22,356,225,1972,812,102400,511,92,84.74,15.26,150,99,48,6,232,64,59,0,0,0,261,86,0,0,15,2212
679,679,0,607,72,1982,1380,182200,450,229,66.27,33.73,135,390,54,27,0,0,7,32,6,0,151,148,158,17,0,2213
693,592,101,313,279,1967,950,159100,293,400,42.28,57.72,34,115,165,98,189,33,130,36,0,0,14,272,18,28,11,2214
606,533,73,213,320,1939,843,143600,442,164,72.94,27.06,159,148,50,51,164,128,297,23,0,0,0,84,0,0,0,2215
1211,1154,57,705,449,2001,1262,339800,783,428,64.66,35.34,733,30,30,91,105,0,154,75,78,0,29,131,124,79,182,2216
410,377,33,345,32,1985,1636,259800,410,0,100.00,0.00,247,92,8,41,11,0,0,31,29,0,14,27,247,14,0,2217
289,289,0,267,22,1974,0,208900,278,11,96.19,3.81,48,181,67,127,8,0,0,32,38,0,0,77,237,0,47,2218
512,512,0,221,291,1966,844,167300,320,192,62.50,37.50,0,46,142,55,131,14,138,26,0,0,0,122,41,0,0,2219
326,280,46,217,63,1944,1574,148900,326,0,100.00,0.00,0,41,166,85,182,0,58,14,64,0,12,240,0,0,0,2220
557,479,78,269,210,1953,709,147700,417,140,74.87,25.13,25,12,110,14,333,32,77,0,0,0,43,308,0,0,0,2221
471,432,39,370,62,1994,2186,388500,433,38,91.93,8.07,136,94,68,0,11,0,0,29,9,0,15,0,82,70,84,2222
1305,1263,42,634,629,1990,956,246500,522,783,40.00,60.00,456,173,248,68,129,0,379,136,81,0,119,30,224,19,13,2223
278,278,0,20,258,1961,613,0,99,179,35.61,64.39,11,31,20,33,81,17,100,12,21,0,0,18,0,0,0,2224
539,485,54,309,176,1947,1244,555300,380,159,70.50,29.50,56,14,37,16,250,23,36,13,10,0,0,20,45,34,183,2225
338,338,0,218,120,1939,1357,183700,324,14,95.86,4.14,30,0,0,0,262,0,22,77,0,0,14,113,36,0,30,2226
759,709,50,411,298,1970,684,0,291,468,38.34,61.66,82,92,98,60,317,29,182,12,0,0,190,200,36,0,0,2227
424,424,0,265,159,1984,354,204300,276,148,65.09,34.91,373,177,77,54,15,65,0,137,15,0,0,193,244,27,0,2228
864,864,0,133,731,1980,813,243000,208,656,24.07,75.93,535,283,257,40,104,51,979,24,0,27,0,91,0,0,0,2229
616,611,5,474,137,1968,798,260200,513,103,83.28,16.72,87,46,95,199,272,26,80,20,15,0,13,64,431,38,0,2230
719,708,11,631,77,1987,1178,167800,526,193,73.16,26.84,402,153,243,61,37,0,16,93,0,0,113,487,119,28,0,2231
830,745,85,269,476,1992,1140,204100,317,513,38.19,61.81,732,108,133,57,9,0,402,369,0,0,19,105,60,22,0,2232
436,408,28,185,223,1939,1014,188400,329,107,75.46,24.54,0,0,0,0,304,0,71,0,11,0,13,89,39,0,0,2233
344,344,0,152,192,1983,916,0,117,227,34.01,65.99,88,81,91,0,81,0,113,0,0,0,54,174,0,0,0,2234
576,503,73,199,304,1971,813,128400,305,271,52.95,47.05,67,34,174,79,76,0,91,34,0,0,90,142,11,0,0,2235
816,760,56,692,68,1947,0,143800,644,172,78.92,21.08,0,0,18,134,522,0,102,73,0,0,74,373,0,0,0,2236
613,613,0,198,415,1990,1568,262200,79,534,12.89,87.11,256,38,224,0,129,37,190,79,77,0,0,36,115,99,0,2237
485,449,36,326,123,1956,1168,205500,456,29,94.02,5.98,15,9,62,136,323,0,7,87,0,22,14,129,203,9,20,2238
398,346,52,182,164,1939,974,147600,284,114,71.36,28.64,41,0,0,0,322,12,69,21,44,0,0,104,79,0,22,2239
749,714,35,454,260,1969,1122,213500,163,586,21.76,78.24,12,66,296,411,0,0,69,46,0,0,57,404,104,0,38,2240
915,869,46,238,631,1995,1120,187800,599,316,65.46,34.54,463,85,81,12,105,0,128,86,0,38,0,224,43,62,12,2241
1259,1068,191,559,509,2003,1835,509300,33,1226,2.62,97.38,599,41,0,13,0,0,22,106,50,54,0,25,39,22,141,2242
580,548,32,540,8,1949,0,849700,555,25,95.69,4.31,45,13,51,45,452,0,10,0,26,13,0,0,65,80,412,2243
735,680,55,90,590,1965,611,112500,211,524,28.71,71.29,88,55,176,285,217,266,342,57,47,11,0,30,0,0,0,2244
610,610,0,574,36,1939,1075,743200,593,17,97.21,2.79,21,9,0,0,564,0,0,11,12,54,0,11,11,11,470,2245
485,421,64,366,55,1986,673,210600,362,123,74.64,25.36,93,56,24,41,227,38,50,36,0,0,3,111,12,0,27,2246
409,390,19,124,266,1956,904,91700,253,156,61.86,38.14,57,30,43,0,315,176,103,0,0,0,139,8,0,0,0,2247
446,389,57,200,189,1989,1553,337300,289,157,64.80,35.20,308,27,16,104,0,0,17,54,122,50,0,12,112,24,30,2248
404,361,43,250,111,1950,1341,245100,350,54,86.63,13.37,23,11,0,26,278,0,15,40,0,0,9,76,135,28,0,2249
928,753,175,438,315,1967,817,169400,731,197,78.77,21.23,169,98,96,79,303,14,107,0,11,0,81,375,67,4,0,2250
324,245,79,146,99,1957,958,128700,244,80,75.31,24.69,26,12,0,0,267,0,89,51,0,0,22,95,31,0,0,2251
439,398,41,373,25,1961,0,299500,439,0,100.00,0.00,24,60,45,97,295,0,0,20,76,21,0,24,149,231,0,2252
526,496,30,367,129,1947,1497,488800,526,0,100.00,0.00,33,17,0,33,378,0,0,24,55,9,0,0,52,150,171,2253
405,382,23,336,46,1956,0,470800,405,0,100.00,0.00,36,0,36,67,383,0,11,49,24,0,0,32,62,40,214,2254
438,438,0,43,395,1977,930,177500,90,348,20.55,79.45,62,170,350,68,39,50,554,28,0,0,0,17,0,0,19,2255
1841,1703,138,320,1383,1983,829,222700,459,1382,24.93,75.07,827,313,531,160,114,257,999,131,0,0,59,196,111,25,14,2256
625,598,27,487,111,1950,1315,594000,579,46,92.64,7.36,92,28,21,68,429,0,61,11,0,14,0,22,82,106,342,2257
584,546,38,515,31,1991,1438,294000,567,17,97.09,2.91,225,81,109,83,65,0,22,6,66,0,5,141,152,93,78,2258
708,700,8,612,88,1990,1474,237000,691,17,97.60,2.40,507,152,112,18,9,0,0,87,5,0,0,267,357,15,9,2259
468,415,53,329,86,1971,1067,317200,440,28,94.02,5.98,44,74,76,156,180,32,77,12,0,0,0,96,130,57,46,2260
637,627,10,281,346,1999,778,347600,424,213,66.56,33.44,419,94,26,28,81,30,149,140,12,0,0,29,208,32,14,2261
365,365,0,313,52,1974,0,223000,352,13,96.44,3.56,47,32,101,226,26,0,0,16,0,0,0,109,260,36,11,2262
935,891,44,147,744,1988,1194,465300,190,745,20.32,79.68,487,317,24,38,11,0,181,229,32,180,0,11,22,84,97,2263
317,284,33,239,45,1957,575,131800,258,59,81.39,18.61,7,21,30,48,260,25,46,0,0,0,75,171,21,0,0,2264
507,442,65,418,24,1983,0,404700,463,44,91.32,8.68,112,25,46,9,116,0,0,25,0,0,0,9,29,56,151,2265
425,380,45,314,66,1977,967,415800,367,58,86.35,13.65,84,20,122,56,71,0,49,15,11,0,0,14,133,82,49,2266
650,640,10,346,294,1981,946,380800,312,338,48.00,52.00,72,117,155,247,119,50,120,72,24,0,0,42,195,65,55,2267
507,483,24,309,174,1984,1728,334700,404,103,79.68,20.32,195,41,58,15,114,59,38,0,25,44,0,0,175,54,28,2268
585,585,0,523,62,1974,0,366800,515,70,88.03,11.97,96,74,118,119,147,0,0,0,8,6,0,17,215,176,101,2269
344,238,106,183,55,1982,1016,186800,294,50,85.47,14.53,44,261,39,0,0,0,0,54,28,0,23,194,45,0,0,2270
681,645,36,249,396,1959,1222,460200,366,315,53.74,46.26,28,18,105,51,429,42,95,84,9,20,0,26,57,109,110,2271
428,398,30,222,176,1968,947,218400,293,135,68.46,31.54,0,29,63,61,278,0,98,59,0,0,10,137,118,0,0,2272
700,618,82,439,179,1957,919,141000,646,54,92.29,7.71,63,39,124,57,383,0,50,18,0,0,32,522,21,0,0,2273
425,425,0,213,212,1979,826,212000,233,192,54.82,45.18,75,115,128,92,42,140,29,0,14,0,12,14,66,52,30,2274
404,385,19,333,52,1974,0,137000,404,0,100.00,0.00,122,62,73,0,60,0,46,56,11,0,12,134,44,0,14,2275
720,660,60,573,87,1991,836,204800,567,153,78.75,21.25,189,212,120,0,133,29,18,17,0,0,0,183,181,47,56,2276
426,404,22,310,94,1950,897,133100,418,8,98.12,1.88,23,0,10,0,524,24,8,18,18,0,22,308,68,12,10,2277
509,509,0,383,126,1952,1563,579700,459,50,90.18,9.82,20,49,30,82,335,0,48,0,34,0,0,11,54,110,245,2278
914,853,61,409,444,1996,1309,194200,653,261,71.44,28.56,706,73,57,10,65,0,70,285,42,0,17,177,89,20,57,2279
787,758,29,659,99,1987,1065,336800,654,133,83.10,16.90,278,82,220,47,155,0,173,0,25,0,40,50,162,59,183,2280
858,701,157,395,306,1959,468,104800,420,438,48.95,51.05,71,8,262,72,435,220,40,0,0,0,242,136,0,0,0,2281
328,299,29,179,120,1978,1231,155000,288,40,87.80,12.20,85,14,24,15,139,0,45,19,19,0,15,157,22,0,0,2282
450,450,0,197,253,1939,1363,540500,257,193,57.11,42.89,22,63,58,52,197,0,37,83,15,0,12,37,69,48,91,2283
316,316,0,283,33,1972,1875,380200,316,0,100.00,0.00,78,11,148,95,0,0,0,0,12,17,11,31,124,62,75,2284
869,826,43,527,299,1975,994,256800,619,250,71.23,28.77,194,374,119,93,129,11,192,190,45,0,19,101,219,28,68,2285
343,343,0,188,155,1985,997,169100,138,205,40.23,59.77,280,199,99,63,7,35,307,22,0,0,14,120,61,7,0,2286
569,557,12,364,193,1939,1490,598300,471,98,82.78,17.22,61,55,95,0,505,103,15,29,105,0,0,0,59,55,306,2287
655,624,31,369,255,1992,1468,613700,406,249,61.98,38.02,357,220,85,23,0,0,0,207,88,0,0,0,11,42,316,2288
531,494,37,284,210,1975,967,200000,301,230,56.69,43.31,46,26,122,160,52,0,125,33,37,0,0,37,77,0,0,2289
385,377,8,361,16,1944,0,880500,385,0,100.00,0.00,33,0,0,0,343,0,0,0,43,0,0,0,26,24,270,2290
366,366,0,288,78,1985,1732,287000,366,0,100.00,0.00,81,122,138,0,48,0,0,24,11,10,0,70,133,28,29,2291
214,214,0,77,137,2002,1299,228500,198,16,92.52,7.48,107,28,0,0,0,0,28,19,0,0,0,22,66,0,0,2292
445,445,0,337,108,1987,1471,224500,405,40,91.01,8.99,122,21,317,8,16,0,0,0,22,0,0,411,51,0,0,2293
505,465,40,275,190,1957,1341,220300,505,0,100.00,0.00,81,29,34,96,199,0,38,34,70,0,0,87,146,36,16,2294
566,566,0,221,345,1984,747,281200,231,335,40.81,59.19,207,21,128,77,91,12,222,0,0,0,0,97,143,20,9,2295
789,697,92,609,88,2000,1725,286700,764,25,96.83,3.17,624,49,0,0,0,0,0,8,33,0,36,17,475,64,40,2296
179,179,0,37,142,1966,532,111300,35,144,19.55,80.45,70,51,228,77,12,227,37,0,0,0,82,12,0,0,0,2297
644,644,0,549,95,1976,1425,267400,623,21,96.74,3.26,103,166,75,178,62,0,0,23,46,0,0,119,224,76,96,2298
515,515,0,479,36,1962,0,364300,500,15,97.09,2.91,47,25,28,101,232,0,0,16,0,0,0,24,110,122,161,2299
779,279,500,253,26,1994,341,322500,643,136,82.54,17.46,269,339,49,18,21,13,14,0,3,0,12,32,33,60,80,2300
466,435,31,114,321,1991,0,184100,66,400,14.16,85.84,320,46,80,0,84,18,39,0,79,162,14,110,10,0,0,2301
568,392,176,97,295,1939,663,142100,232,336,40.85,59.15,9,0,63,27,431,194,130,67,0,0,8,50,8,0,0,2302
1026,946,80,194,752,1996,978,64700,158,868,15.40,84.60,725,197,50,7,0,24,492,73,9,0,102,211,0,0,0,2303
665,665,0,330,335,1991,1477,540200,330,335,49.62,50.38,328,24,152,96,21,10,9,60,105,77,25,0,53,61,221,2304
577,552,25,204,348,1976,1072,158700,386,191,66.90,33.10,247,229,213,145,24,0,300,92,0,0,34,247,36,0,0,2305
267,212,55,129,83,1946,1104,146400,173,94,64.79,35.21,0,0,0,16,260,0,49,10,0,0,25,141,0,0,0,2306
335,335,0,85,250,1964,804,94200,195,140,58.21,41.79,21,17,15,285,83,126,106,21,0,0,47,25,0,0,0,2307
341,292,49,256,36,1958,711,112100,272,69,79.77,20.23,55,0,101,32,267,0,8,38,0,0,68,335,0,0,6,2308
511,472,39,273,199,2001,932,107900,387,124,75.73,24.27,69,56,98,70,219,115,102,10,0,0,117,67,13,0,0,2309
413,388,25,266,122,1952,873,86400,297,116,71.91,28.09,12,0,71,54,304,18,175,0,0,0,143,105,0,0,0,2310
524,468,56,407,61,1975,0,118100,396,128,75.57,24.43,55,82,252,56,46,69,39,22,0,0,61,288,0,0,12,2311
575,545,30,141,404,1978,897,179900,258,317,44.87,55.13,154,16,164,221,106,0,409,47,0,0,13,192,0,0,0,2312
658,604,54,380,224,1955,883,125700,468,190,71.12,28.88,58,20,167,56,333,0,83,84,0,0,69,258,51,0,0,2313
438,405,33,127,278,1945,568,193800,246,192,56.16,43.84,0,0,21,73,284,52,92,37,8,0,9,144,10,0,0,2314
359,277,82,222,55,1979,518,165900,226,133,62.95,37.05,234,52,48,5,54,15,38,0,0,0,72,68,52,0,30,2315
496,496,0,423,73,1983,1346,0,249,247,50.20,49.80,316,36,165,25,17,0,67,0,0,0,267,185,0,0,0,2316
226,199,27,123,76,1979,561,502500,170,56,75.22,24.78,6,0,34,13,165,6,18,10,0,0,14,61,20,25,13,2317
1008,913,95,530,383,1991,673,188300,481,527,47.72,52.28,430,243,65,142,92,79,347,77,24,8,156,97,137,0,0,2318
528,472,56,239,233,1939,885,219800,438,90,82.95,17.05,0,0,39,0,426,104,95,17,0,0,0,177,19,0,0,2319
644,543,101,356,187,1953,610,120500,488,156,75.78,24.22,101,9,69,72,421,46,21,0,0,31,244,166,23,0,7,2320
549,446,103,391,55,1990,0,267700,410,139,74.68,25.32,260,97,89,25,53,11,8,0,0,0,20,141,60,21,48,2321
765,686,79,225,461,1980,630,113900,284,481,37.12,62.88,52,73,50,99,155,95,64,60,0,0,106,104,0,0,0,2322
383,383,0,187,196,1986,664,245000,183,200,47.78,52.22,146,179,236,0,58,117,179,60,12,32,0,17,116,40,11,2323
540,540,0,482,58,1995,1618,355200,522,18,96.67,3.33,472,0,74,11,85,0,0,0,31,0,0,81,261,124,145,2324
823,777,46,525,252,1995,1306,181100,772,51,93.80,6.20,761,47,81,0,0,0,0,125,55,0,65,414,186,0,0,2325
521,496,25,194,302,1974,1048,268000,213,308,40.88,59.12,52,76,157,103,240,36,164,91,19,15,19,127,117,33,7,2326
559,408,151,226,182,1964,1043,245100,402,157,71.91,28.09,12,12,146,180,270,37,105,66,0,0,0,124,135,41,32,2327
1071,835,236,154,681,1993,1082,30000,76,995,7.10,92.90,402,275,137,5,57,134,347,80,20,0,200,0,9,0,0,2328
507,507,0,256,251,1967,1217,350900,281,226,55.42,44.58,188,0,27,135,156,0,77,86,83,0,0,43,108,39,29,2329
337,337,0,337,0,1996,0,710000,337,0,100.00,0.00,172,49,0,25,8,0,14,0,0,0,19,0,0,20,201,2330
275,275,0,275,0,1974,0,225700,275,0,100.00,0.00,60,75,97,182,0,0,0,0,0,0,0,167,213,0,0,2331
494,494,0,435,59,1986,2066,459200,484,10,97.98,2.02,20,469,0,0,0,0,0,0,20,24,0,7,74,139,225,2332
718,680,38,185,495,1983,825,0,107,611,14.90,85.10,52,95,173,160,170,28,424,94,0,0,27,12,38,0,14,2333
567,537,30,271,266,1982,969,247800,287,280,50.62,49.38,51,214,40,146,52,0,180,51,22,0,13,57,155,20,0,2334
880,793,87,404,389,1989,1312,0,183,697,20.80,79.20,426,336,37,0,0,25,204,206,0,0,0,219,0,18,95,2335
803,440,363,344,96,1978,0,483900,608,195,75.72,24.28,124,51,135,158,54,0,12,45,0,0,0,18,23,80,153,2336
423,309,114,211,98,1980,1399,637000,298,125,70.45,29.55,27,68,93,14,55,0,0,0,15,27,0,0,82,28,55,2337
493,493,0,423,70,1979,0,315400,431,62,87.42,12.58,107,99,157,80,49,11,0,0,0,0,54,73,164,83,96,2338
719,639,80,363,276,1979,1347,193800,206,513,28.65,71.35,13,266,482,36,0,0,160,54,15,0,25,347,63,75,9,2339
552,552,0,517,35,1982,2250,427200,478,74,86.59,13.41,41,179,172,101,33,11,36,8,6,0,0,29,228,86,112,2340
730,723,7,536,187,1991,1295,182200,711,19,97.40,2.60,367,174,183,20,5,0,0,124,0,0,5,373,247,0,0,2341
1004,976,28,389,587,1961,589,251700,447,557,44.52,55.48,132,21,231,80,426,252,299,19,0,0,10,122,148,33,7,2342
276,268,8,232,36,1976,650,197700,216,60,78.26,21.74,88,44,72,28,61,8,0,10,0,0,79,74,72,4,21,2343
588,588,0,369,219,1984,1523,374000,477,111,81.12,18.88,109,387,157,0,22,0,22,15,10,49,13,12,236,150,168,2344
621,576,45,461,115,1994,1809,285300,560,61,90.18,9.82,324,104,0,0,0,0,0,17,12,0,16,67,267,49,0,2345
364,364,0,276,88,1979,0,224300,346,18,95.05,4.95,105,91,191,49,0,0,32,96,44,0,0,145,103,0,0,2346
535,495,40,372,123,1981,1683,209400,535,0,100.00,0.00,85,52,199,41,34,0,20,34,18,0,0,184,139,16,0,2347
477,477,0,466,11,1944,0,949700,477,0,100.00,0.00,37,13,17,12,472,0,14,41,0,0,0,11,17,0,455,2348
474,443,31,369,74,1954,1373,349700,474,0,100.00,0.00,23,0,37,99,344,0,21,0,25,0,7,20,232,137,61,2349
718,674,44,562,112,1978,2033,501300,515,203,71.73,28.27,59,198,280,30,51,16,0,14,30,10,0,98,28,56,366,2350
699,657,42,120,537,1999,1627,426600,97,602,13.88,86.12,455,67,46,46,49,147,0,119,34,40,0,12,38,148,87,2351
1090,931,159,340,591,1972,1461,510000,319,771,29.27,70.73,191,173,297,317,0,49,156,327,80,12,0,11,68,100,103,2352
955,874,81,405,469,1991,1391,149700,327,628,34.24,65.76,582,111,49,13,143,0,150,364,47,0,0,193,131,0,13,2353
490,461,29,358,103,1970,0,252100,337,153,68.78,31.22,55,9,137,131,98,29,0,50,7,10,10,34,136,83,20,2354
779,715,64,225,490,1974,928,290100,295,484,37.87,62.13,101,225,59,207,185,34,276,77,0,0,0,126,90,0,35,2355
816,678,138,49,629,1984,1004,0,49,767,6.00,94.00,302,439,93,63,0,0,424,368,21,0,0,0,68,0,0,2356
855,758,97,737,21,1996,0,378500,792,63,92.63,7.37,389,196,164,0,45,0,0,0,26,0,0,232,300,89,147,2357
643,553,90,99,454,1991,1115,0,68,575,10.58,89.42,422,399,28,0,0,61,372,267,14,0,0,0,0,0,0,2358
604,604,0,585,19,1984,0,203300,505,99,83.61,16.39,168,25,203,122,203,0,69,0,0,0,0,491,50,50,26,2359
342,342,0,174,168,1983,963,190600,231,111,67.54,32.46,80,179,102,53,8,23,161,18,19,0,0,125,25,0,20,2360
788,774,14,566,208,1990,1242,263200,711,77,90.23,9.77,423,198,0,0,0,0,0,7,45,21,9,38,387,74,0,2361
702,667,35,577,90,1996,1897,201900,659,43,93.87,6.13,520,64,0,10,0,0,0,10,49,0,10,281,181,36,0,2362
53,20,33,0,20,1953,0,0,16,37,30.19,69.81,10,0,0,0,40,0,0,40,10,0,0,0,0,0,0,2363
706,667,39,388,279,2004,1709,268600,463,243,65.58,34.42,354,25,72,0,0,0,13,22,0,9,61,20,209,65,25,2364
122,122,0,122,0,1999,0,305300,122,0,100.00,0.00,85,0,0,19,22,0,32,0,0,0,0,22,48,24,0,2365
180,180,0,165,15,2003,1750,291700,164,16,91.11,8.89,164,0,0,24,0,0,0,0,9,0,0,0,147,32,0,2366
811,811,0,111,700,1996,1006,195800,284,527,35.02,64.98,684,28,197,0,11,52,454,69,142,0,0,52,57,0,13,2367
482,482,0,387,95,1996,1673,250600,482,0,100.00,0.00,349,105,0,0,15,0,0,0,0,0,0,277,157,17,18,2368
552,422,130,167,255,1978,1016,186300,336,216,60.87,39.13,92,153,171,123,86,8,128,131,0,0,60,137,48,0,10,2369
551,551,0,508,43,1983,0,241300,532,19,96.55,3.45,257,218,148,15,13,0,129,47,0,0,0,140,226,73,36,2370
410,319,91,100,219,1970,950,177500,172,238,41.95,58.05,89,45,44,96,111,42,147,32,0,0,0,43,64,0,0,2371
395,395,0,333,62,1958,0,377100,395,0,100.00,0.00,10,0,12,167,258,0,9,20,28,5,0,10,84,194,97,2372
556,470,86,250,220,1955,777,108900,528,28,94.96,5.04,9,26,144,51,323,0,25,25,0,0,42,401,0,0,0,2373
294,275,19,192,83,1941,1083,173900,281,13,95.58,4.42,17,0,102,46,339,0,185,28,0,0,13,265,13,0,0,2374
271,271,0,188,83,2002,603,137700,144,127,53.14,46.86,186,113,43,0,0,87,15,56,0,0,24,113,19,0,28,2375
615,615,0,139,476,1985,1137,418100,266,349,43.25,56.75,473,182,115,0,0,0,259,197,21,20,0,0,112,87,51,2376
540,496,44,279,217,1939,975,222900,438,102,81.11,18.89,0,0,14,8,454,7,120,8,0,0,0,178,137,26,0,2377
434,385,49,274,111,2001,1223,195400,374,60,86.18,13.82,191,0,137,41,13,0,110,15,0,0,0,232,25,0,0,2378
230,153,77,105,48,1965,692,215500,157,73,68.26,31.74,45,0,48,69,60,26,0,0,0,0,52,53,25,15,0,2379
672,610,62,493,117,1974,859,165900,541,131,80.51,19.49,212,106,308,50,13,0,72,17,0,0,70,352,162,12,0,2380
551,551,0,326,225,1974,808,137500,387,164,70.24,29.76,58,49,116,0,261,17,90,8,0,0,75,249,0,0,10,2381
545,513,32,395,118,1959,1204,174300,508,37,93.21,6.79,79,18,79,60,265,36,26,33,0,0,0,276,61,29,0,2382
501,443,58,303,140,1953,584,135400,501,0,100.00,0.00,0,0,14,56,436,16,15,25,0,0,13,405,0,0,0,2383
521,476,45,352,124,1992,1161,214500,462,59,88.68,11.32,230,120,81,17,0,0,0,72,0,0,14,161,154,7,0,2384
492,492,0,392,100,1973,1227,234300,435,57,88.41,11.59,81,65,136,103,60,0,15,34,0,0,11,130,230,4,0,2385
361,361,0,315,46,1986,0,471100,361,0,100.00,0.00,120,150,104,10,15,0,0,0,0,0,0,0,33,144,222,2386
447,439,8,414,25,1970,1519,185000,429,18,95.97,4.03,100,21,220,88,124,0,0,10,0,0,27,473,31,0,12,2387
782,741,41,162,579,1990,815,182100,201,581,25.70,74.30,450,229,229,135,35,77,683,86,0,0,0,99,10,0,0,2388
575,522,53,309,213,1985,1469,204300,480,95,83.48,16.52,174,243,111,0,35,0,0,12,36,0,94,173,204,2,0,2389
469,411,58,294,117,1977,1026,589300,416,53,88.70,11.30,114,85,46,0,154,0,27,42,12,12,12,37,66,29,154,2390
294,240,54,94,146,1939,740,327500,153,141,52.04,47.96,30,0,13,0,390,25,174,62,0,0,7,0,93,38,0,2391
377,377,0,325,52,1964,1581,150900,332,45,88.06,11.94,9,0,35,100,198,9,20,0,0,0,47,217,0,0,40,2392
692,602,90,399,203,1973,1241,249100,497,195,71.82,28.18,252,34,112,94,137,17,136,93,0,0,20,117,201,0,0,2393
578,549,29,426,123,1983,895,309100,380,198,65.74,34.26,175,151,110,105,65,0,23,72,0,0,67,59,191,58,136,2394
476,476,0,381,95,1988,870,47900,186,290,39.08,60.92,234,88,39,45,16,0,64,0,7,0,110,179,28,0,34,2395
489,489,0,431,58,1988,0,362800,429,60,87.73,12.27,157,99,65,65,80,0,25,0,0,0,0,78,125,62,130,2396
929,929,0,329,600,1963,1384,225700,22,907,2.37,97.63,223,0,40,147,417,0,223,107,117,0,0,71,118,78,0,2397
413,318,95,14,304,1939,634,0,14,399,3.39,96.61,9,10,33,29,261,89,148,0,0,9,0,9,0,0,0,2398
612,582,30,315,267,1972,1075,342800,327,285,53.43,46.57,115,81,130,118,178,0,209,159,0,0,0,31,89,77,10,2399
391,363,28,227,136,1958,1611,286700,373,18,95.40,4.60,78,0,97,27,236,0,89,31,31,33,0,65,157,32,0,2400
420,292,128,230,62,1950,815,107400,372,48,88.57,11.43,0,0,42,76,258,31,110,9,0,0,47,121,0,0,0,2401
367,367,0,367,0,1987,0,443700,367,0,100.00,0.00,125,256,46,0,0,0,0,0,7,0,0,22,167,118,113,2402
967,502,465,429,73,1994,664,204500,659,308,68.15,31.85,328,100,177,6,82,0,31,0,0,0,52,221,132,19,40,2403
297,293,4,183,110,1962,916,168500,267,30,89.90,10.10,55,28,50,79,111,0,66,12,0,0,40,125,26,13,0,2404
515,282,233,149,133,1976,583,233600,433,82,84.08,15.92,35,91,132,112,175,33,35,3,0,0,45,57,35,8,20,2405
559,498,61,137,361,1961,0,179800,330,229,59.03,40.97,123,16,33,0,273,33,123,0,0,0,87,58,0,0,0,2406
172,146,26,27,119,1964,0,0,19,153,11.05,88.95,23,0,11,10,59,22,32,23,0,0,0,0,0,0,0,2407
1063,915,148,201,714,1956,733,252100,123,940,11.57,88.43,184,46,202,96,572,179,475,155,46,11,0,118,0,0,0,2408
482,426,56,60,366,1968,607,241700,16,466,3.32,96.68,89,11,56,32,221,57,241,10,0,30,0,39,10,0,22,2409
253,253,0,217,36,1939,1609,240200,253,0,100.00,0.00,10,0,12,0,223,0,0,0,0,0,0,87,121,21,0,2410
389,343,46,278,65,1977,698,36300,96,293,24.68,75.32,136,35,157,9,98,13,26,23,0,0,284,89,0,0,0,2411
434,434,0,108,326,1975,792,183700,218,216,50.23,49.77,63,61,304,108,137,10,243,20,0,0,24,227,11,0,0,2412
418,373,45,143,230,1949,1003,223900,265,153,63.40,36.60,81,20,28,35,189,27,80,30,5,64,3,49,71,6,15,2413
217,217,0,203,14,1975,0,219900,217,0,100.00,0.00,0,68,57,19,54,0,39,24,0,0,0,25,101,9,0,2414
398,398,0,275,123,1954,1188,232500,356,42,89.45,10.55,31,8,34,70,249,0,39,58,0,0,11,136,118,8,22,2415
406,365,41,193,172,1939,906,340200,234,172,57.64,42.36,0,8,0,37,401,0,156,8,0,0,0,35,37,121,80,2416
800,746,54,467,279,1939,950,246800,733,67,91.63,8.38,47,13,0,14,516,15,111,46,24,0,0,188,167,27,0,2417
483,462,21,315,147,1939,1119,184600,468,15,96.89,3.11,0,3,0,0,414,32,12,35,0,0,0,226,5,12,0,2418
427,400,27,261,139,1939,963,148600,381,46,89.23,10.77,6,0,0,41,432,0,85,30,0,0,82,193,0,0,0,2419
1096,912,184,708,204,1992,865,197400,739,357,67.43,32.57,601,120,152,0,156,0,154,0,0,0,128,392,134,40,82,2420
672,630,42,471,159,1953,778,143000,655,17,97.47,2.53,27,12,48,22,510,12,30,36,0,0,12,474,0,0,11,2421
664,562,102,216,346,1974,434,105600,414,250,62.35,37.65,232,29,128,12,212,193,131,24,0,0,45,152,0,0,0,2422
524,524,0,443,81,1939,946,137500,490,34,93.51,6.49,17,13,0,0,498,88,25,74,0,0,35,209,11,35,0,2423
1644,1235,409,1025,210,1996,926,255900,1290,354,78.47,21.53,787,380,108,50,189,0,18,114,11,0,47,425,252,80,97,2424
708,617,91,536,81,1983,1574,243800,640,68,90.40,9.60,240,74,229,53,39,0,11,22,43,0,0,265,186,0,51,2425
375,375,0,281,94,1946,843,170700,326,49,86.93,13.07,23,0,10,27,379,37,46,19,0,0,7,273,45,0,0,2426
456,399,57,69,330,1946,564,107300,105,351,23.03,76.97,24,43,29,86,233,115,183,30,0,19,28,8,0,0,0,2427
940,859,81,385,474,1985,626,133100,378,562,40.21,59.79,388,238,179,45,114,264,222,88,29,74,92,96,27,0,0,2428
744,679,65,43,636,1976,842,0,43,701,5.78,94.22,0,114,428,78,0,23,456,0,0,0,0,38,0,0,0,2429
650,590,60,558,32,1987,0,254000,525,125,80.77,19.23,121,159,123,40,174,12,61,12,0,0,73,166,127,16,95,2430
758,540,218,430,110,1987,1147,390300,677,81,89.31,10.69,252,179,65,33,215,0,25,17,0,0,46,68,222,85,98,2431
847,802,45,24,778,1994,1155,0,472,375,55.73,44.27,350,149,66,12,92,50,248,240,0,14,8,0,0,0,12,2432
976,952,24,222,730,1991,790,43500,101,875,10.35,89.65,354,217,107,0,49,78,276,91,0,32,94,55,10,0,0,2433
768,690,78,478,212,1980,890,282400,516,252,67.19,32.81,52,79,145,223,63,0,61,10,0,0,10,33,320,45,34,2434
413,380,33,92,288,1971,843,190000,104,309,25.18,74.82,37,44,155,0,99,0,118,16,10,0,24,149,0,18,0,2435
1294,1275,19,507,768,1990,847,141400,502,792,38.79,61.21,469,246,231,89,128,50,494,77,2,0,171,146,68,0,14,2436
411,392,19,10,382,1986,859,0,60,351,14.60,85.40,208,56,72,57,77,44,243,50,32,0,0,0,45,0,0,2437
474,444,30,168,276,1955,1224,166300,467,7,98.52,1.48,0,21,17,18,283,14,13,53,0,0,26,204,7,0,0,2438
942,902,40,711,191,1985,721,160200,491,451,52.12,47.88,411,257,337,80,29,0,126,142,28,0,388,183,119,1,13,2439
434,417,17,261,156,1953,1237,193100,296,138,68.20,31.80,19,0,73,37,190,0,82,20,9,0,22,71,74,6,4,2440
727,607,120,55,552,1983,750,154800,79,648,10.87,89.13,181,184,99,57,23,43,334,32,0,0,0,44,53,0,0,2441
654,654,0,364,290,1956,1207,160700,575,79,87.92,12.08,111,33,49,80,386,0,75,27,18,6,36,327,117,0,0,2442
274,267,7,230,37,1970,2350,666700,274,0,100.00,0.00,41,35,187,85,11,0,0,9,43,0,7,19,10,8,253,2443
678,620,58,394,226,1972,1041,188700,366,312,53.98,46.02,66,177,183,99,97,0,39,199,11,0,6,197,133,0,0,2444
245,232,13,120,112,1969,856,165000,147,98,60.00,40.00,20,0,153,10,151,29,158,32,0,0,0,81,19,0,0,2445
373,303,70,188,115,1949,1279,180200,373,0,100.00,0.00,13,18,12,31,331,19,33,43,0,0,11,231,55,0,13,2446
443,404,39,305,99,1956,0,244400,381,62,86.00,14.00,26,90,10,119,222,0,0,0,0,0,0,133,309,6,7,2447
487,487,0,20,467,1972,789,0,53,434,10.88,89.12,14,103,361,0,43,0,340,0,14,81,0,0,0,0,0,2448
468,415,53,282,133,1982,848,180600,330,138,70.51,29.49,76,56,305,49,23,9,45,40,10,0,40,204,48,16,10,2449
962,786,176,126,660,2001,1194,171200,238,724,24.74,75.26,277,170,88,97,110,12,262,266,37,0,0,43,22,0,0,2450
311,295,16,225,70,1975,730,153200,217,94,69.77,30.23,30,17,61,81,44,0,0,0,0,0,15,148,45,0,0,2451
703,703,0,390,313,1979,678,145400,383,320,54.48,45.52,100,290,242,12,12,68,118,12,0,0,13,358,18,0,0,2452
944,666,278,475,191,1973,603,161000,739,205,78.28,21.72,170,190,150,67,408,119,35,0,0,0,109,257,30,21,45,2453
560,531,29,430,101,1963,895,191500,552,8,98.57,1.43,0,34,100,204,295,0,10,105,25,0,15,265,213,0,0,2454
535,475,60,288,187,1975,880,292700,415,120,77.57,22.43,114,43,124,99,13,0,48,21,0,0,0,120,140,35,29,2455
1067,1042,25,195,847,1940,1172,408800,88,979,8.25,91.75,110,99,103,179,661,71,541,308,54,28,0,0,46,15,59,2456
399,399,0,328,71,1974,2110,373600,399,0,100.00,0.00,30,134,68,91,25,0,0,0,14,0,0,21,107,170,25,2457
672,672,0,382,290,1995,1772,480900,538,134,80.06,19.94,387,152,0,37,70,0,0,48,120,52,0,36,67,118,173,2458
532,468,64,421,47,1966,0,971800,452,80,84.96,15.04,115,0,43,89,352,0,0,0,0,21,0,0,0,17,453,2459
648,538,110,242,296,1965,885,187500,398,250,61.42,38.58,33,67,36,15,428,0,196,10,0,0,29,234,100,0,10,2460
600,600,0,438,162,1990,1460,401800,583,17,97.17,2.83,203,42,132,89,49,0,14,16,0,0,0,72,149,73,102,2461
784,690,94,200,490,1976,871,177900,208,576,26.53,73.47,112,129,132,130,101,136,297,22,0,0,36,22,35,0,0,2462
542,542,0,63,479,1966,974,170500,151,391,27.86,72.14,33,56,53,139,285,46,147,42,44,28,0,93,90,0,0,2463
518,492,26,432,60,1977,0,398500,478,40,92.28,7.72,87,148,94,85,98,0,0,0,0,0,0,19,54,46,380,2464
753,736,17,375,361,1993,1222,213700,582,171,77.29,22.71,498,95,17,47,59,0,140,111,0,0,0,132,273,0,19,2465
336,336,0,309,27,1973,1625,457400,336,0,100.00,0.00,41,12,155,190,22,0,0,0,0,12,0,0,78,197,103,2466
507,507,0,292,215,1955,1378,286300,453,54,89.35,10.65,20,19,84,35,300,0,0,93,0,0,17,20,219,57,20,2467
527,527,0,294,233,1975,1253,300700,354,173,67.17,32.83,114,63,100,0,123,0,104,55,30,0,0,0,90,40,81,2468
355,355,0,238,117,1971,993,409600,264,91,74.37,25.63,54,24,39,299,75,0,73,51,0,0,0,0,57,139,93,2469
602,580,22,418,162,1953,1288,522100,505,97,83.89,16.11,49,16,103,98,278,0,0,74,59,0,0,28,66,137,137,2470
280,280,0,239,41,1959,879,193600,280,0,100.00,0.00,9,0,19,116,106,0,7,18,0,0,0,174,20,0,20,2471
359,359,0,240,119,1976,1198,253000,276,83,76.88,23.12,65,0,102,72,129,9,37,29,0,0,8,52,192,8,11,2472
1030,959,71,165,794,1983,832,214700,210,820,20.39,79.61,408,323,265,42,0,0,599,109,57,59,0,132,62,0,0,2473
411,375,36,43,332,1970,670,351900,52,359,12.65,87.35,45,0,98,42,227,70,310,0,0,0,0,0,0,0,0,2474
256,229,27,112,117,1957,784,91900,166,90,64.84,35.16,21,0,69,95,188,0,112,0,0,0,54,198,0,0,0,2475
366,366,0,254,112,1951,1143,135200,366,0,100.00,0.00,18,0,0,24,288,15,37,14,0,0,24,186,7,0,0,2476
386,386,0,253,133,1968,573,216800,260,126,67.36,32.64,14,98,123,36,64,14,14,19,0,0,14,128,131,15,0,2477
319,254,65,105,149,1986,1271,123100,60,259,18.81,81.19,16,245,118,0,66,12,67,233,0,0,0,110,0,0,0,2478
791,772,19,336,436,1982,915,225000,288,503,36.41,63.59,225,136,201,111,65,79,132,182,0,0,24,111,92,46,0,2479
707,586,121,120,466,1949,615,168200,67,640,9.48,90.52,68,78,88,60,544,167,334,11,0,0,0,57,19,0,12,2480
411,390,21,337,53,1947,1768,488600,411,0,100.00,0.00,52,3,0,15,323,0,0,12,51,11,0,0,41,92,154,2481
556,556,0,350,206,1981,945,298900,297,259,53.42,46.58,111,83,90,17,222,76,101,61,0,0,0,71,96,89,29,2482
510,434,76,313,121,1959,866,368900,336,174,65.88,34.12,77,25,12,91,239,0,30,63,70,50,0,46,69,60,29,2483
932,893,39,182,711,1975,1083,428400,193,739,20.71,79.29,85,97,368,90,114,13,397,116,0,0,0,67,108,13,25,2484
527,502,25,294,208,1967,1699,297200,527,0,100.00,0.00,186,13,115,14,258,0,6,86,57,0,0,74,224,119,10,2485
360,360,0,197,163,1953,1589,430200,336,24,93.33,6.67,97,0,0,0,227,15,23,17,19,0,0,0,157,65,28,2486
782,739,43,241,498,1976,1092,440900,228,554,29.16,70.84,261,72,40,81,306,0,410,105,15,42,0,29,53,20,86,2487
832,776,56,25,751,1939,783,541700,0,832,0.00,100.00,110,0,31,0,559,255,148,92,74,26,0,0,10,0,25,2488
701,654,47,106,548,1983,683,168900,243,458,34.66,65.34,80,143,161,85,305,138,204,60,0,0,21,186,70,15,0,2489
350,350,0,309,41,1985,0,293500,350,0,100.00,0.00,139,198,86,13,18,0,0,13,0,0,0,78,204,113,46,2490
307,284,23,240,44,1986,2125,366300,295,12,96.09,3.91,215,60,56,17,48,0,0,55,0,0,0,0,142,144,34,2491
516,452,64,248,204,1971,984,295500,320,196,62.02,37.98,41,113,89,158,82,0,147,85,0,0,0,60,156,35,0,2492
347,287,60,163,124,1950,680,120100,299,48,86.17,13.83,64,12,52,13,228,9,10,9,0,0,130,51,13,0,5,2493
603,578,25,298,280,1957,854,102900,476,127,78.94,21.06,61,107,158,118,178,98,155,0,0,0,86,186,77,0,0,2494
523,523,0,383,140,1959,1237,242400,523,0,100.00,0.00,106,33,64,149,203,0,78,132,33,0,0,48,212,52,0,2495
579,551,28,346,205,1967,1025,242300,427,152,73.75,26.25,119,8,66,83,238,8,91,7,35,4,0,115,166,44,10,2496
1268,1038,230,478,560,1983,1370,277500,321,947,25.32,74.68,414,337,321,122,101,14,162,421,67,16,42,256,184,68,17,2497
561,561,0,359,202,1939,1478,539600,433,128,77.18,22.82,20,0,29,18,545,0,50,117,0,0,0,64,119,87,127,2498
1082,977,105,171,806,1985,1290,355900,52,1030,4.81,95.19,600,169,125,20,372,251,210,279,181,0,19,0,81,14,85,2499
728,713,15,169,544,1950,1536,781300,139,589,19.09,80.91,0,65,54,138,266,0,352,96,17,0,0,0,17,17,0,2500
1264,1183,81,190,993,1951,1115,460000,56,1208,4.43,95.57,56,84,13,284,668,28,531,405,29,0,0,10,45,0,57,2501
647,597,50,367,230,1939,2381,670300,539,108,83.31,16.69,0,19,0,0,435,0,30,12,0,0,0,0,19,23,362,2502
519,519,0,254,265,1964,880,240600,275,244,52.99,47.01,102,23,68,140,409,49,271,46,14,0,0,65,224,12,14,2503
547,521,26,411,110,1984,1236,319800,401,146,73.31,26.69,157,108,101,78,25,0,0,46,0,0,41,45,127,128,57,2504
316,316,0,316,0,1993,0,410700,316,0,100.00,0.00,221,148,0,0,0,0,0,0,0,72,0,0,163,134,0,2505
280,255,25,215,40,1968,0,258700,274,6,97.86,2.14,10,41,110,115,41,0,26,58,0,0,0,83,123,0,12,2506
473,460,13,202,258,1941,697,148400,295,178,62.37,37.63,50,0,45,0,450,69,149,30,0,0,41,165,5,0,0,2507
543,358,185,279,79,1973,745,137500,321,222,59.12,40.88,149,146,71,65,144,0,33,9,0,0,30,161,0,0,0,2508
1123,303,820,262,41,1978,538,160000,834,289,74.27,25.73,224,134,457,177,147,29,45,0,0,0,67,184,51,8,31,2509
524,524,0,208,316,1977,924,638500,257,267,49.05,50.95,11,76,141,141,26,0,164,29,0,0,10,11,13,36,132,2510
1054,918,136,402,516,1985,1889,506500,345,709,32.73,67.27,242,560,194,0,203,0,67,217,381,79,32,0,122,18,209,2511
671,613,58,308,305,1979,1122,209000,324,347,48.29,51.71,30,42,169,268,74,21,60,28,75,0,19,130,211,8,0,2512
462,415,47,234,181,1967,822,182700,251,211,54.33,45.67,60,12,11,79,285,22,63,16,7,0,0,206,120,0,0,2513
571,571,0,135,436,1997,1053,318800,186,385,32.57,67.43,397,320,41,45,18,34,268,223,42,42,0,23,89,10,16,2514
459,433,26,283,150,1980,943,351400,451,8,98.26,1.74,90,92,96,30,77,44,33,0,9,0,14,56,101,32,59,2515
703,703,0,321,382,1967,941,173800,400,303,56.90,43.10,120,180,116,38,285,0,275,99,0,0,27,226,60,12,0,2516
364,304,60,242,62,1952,855,212100,364,0,100.00,0.00,47,25,17,7,258,9,38,25,0,0,8,219,39,8,0,2517
677,569,108,257,312,1972,1214,550500,405,272,59.82,40.18,140,13,69,34,210,0,123,114,35,0,0,56,31,46,61,2518
539,539,0,171,368,1939,860,597100,172,367,31.91,68.09,15,73,96,29,325,39,172,121,44,0,0,16,16,25,105,2519
550,426,124,153,273,1939,1643,782700,302,248,54.91,45.09,28,14,0,13,475,0,153,13,0,14,0,0,46,31,273,2520
602,573,29,447,126,1939,1310,501900,494,108,82.06,17.94,10,0,25,33,433,0,37,44,45,0,0,0,61,102,161,2521
614,558,56,396,162,1939,1028,494000,413,201,67.26,32.74,0,14,26,45,380,82,62,14,11,10,0,0,36,50,200,2522
517,388,129,285,103,1964,1578,542000,371,146,71.76,28.24,95,148,51,160,150,0,86,162,41,49,14,0,59,88,105,2523
947,412,535,312,100,1974,941,170200,783,164,82.68,17.32,284,113,109,205,178,17,31,2,0,0,56,215,44,4,23,2524
813,759,54,319,440,1984,1122,329900,411,402,50.55,49.45,98,231,28,144,280,0,240,82,14,63,0,12,237,42,41,2525
416,416,0,317,99,1966,1750,299300,402,14,96.63,3.37,0,18,134,157,94,0,0,30,60,0,0,31,222,60,0,2526
480,480,0,373,107,1961,1639,311900,480,0,100.00,0.00,9,21,22,206,219,0,44,59,14,0,0,22,200,115,23,2527
809,789,20,469,320,1968,1145,275200,543,266,67.12,32.88,97,66,87,139,174,0,77,42,15,0,0,122,218,17,72,2528
530,530,0,482,48,1993,1636,308200,412,118,77.74,22.26,404,39,79,13,0,0,13,0,0,0,23,141,188,170,0,2529
731,666,65,482,184,1987,1165,273400,654,77,89.47,10.53,341,126,61,64,62,0,0,31,0,0,16,140,306,129,32,2530
769,728,41,213,515,1989,1041,223300,380,389,49.41,50.59,370,310,170,39,0,9,389,218,0,0,0,99,128,0,10,2531
317,271,46,158,113,1939,1220,202900,211,106,66.56,33.44,0,23,32,53,175,0,46,27,32,4,13,139,22,0,0,2532
1230,1192,38,196,996,1975,790,118600,241,989,19.59,80.41,294,80,259,15,187,162,521,0,0,0,65,43,0,0,0,2533
542,542,0,297,245,1993,1154,209500,416,126,76.75,23.25,522,93,75,0,18,0,108,116,10,0,16,262,179,0,17,2534
713,688,25,188,500,2001,1193,304200,227,486,31.84,68.16,627,0,28,0,0,0,246,177,11,0,0,43,79,39,16,2535
577,577,0,492,85,1994,1574,196500,577,0,100.00,0.00,574,47,13,0,0,0,0,45,0,0,5,444,140,0,0,2536
352,341,11,269,72,1962,1146,231200,348,4,98.86,1.14,12,34,77,55,74,0,14,21,10,0,0,88,107,0,12,2537
317,295,22,177,118,1958,973,175300,285,32,89.91,10.09,11,10,30,119,220,0,73,20,0,0,0,253,36,8,0,2538
1100,1021,79,695,326,2000,1027,286900,762,338,69.27,30.73,351,92,93,31,61,0,43,39,6,0,0,171,223,55,91,2539
401,358,43,239,119,1939,883,115400,325,76,81.05,18.95,32,3,69,4,179,7,22,6,0,0,89,85,14,0,4,2540
647,647,0,473,174,1997,1170,200200,592,55,91.50,8.50,332,33,30,19,10,0,15,59,87,0,0,64,158,23,9,2541
1264,1163,101,368,795,2002,831,188800,335,929,26.50,73.50,1190,45,0,0,0,0,820,122,0,0,32,69,36,0,0,2542
556,556,0,293,263,2005,866,186400,353,203,63.49,36.51,612,0,23,0,27,0,155,226,0,0,0,242,39,0,0,2543
633,633,0,521,112,2005,1744,380300,598,35,94.47,5.53,501,0,8,12,10,0,0,24,11,0,0,0,161,177,158,2544
699,625,74,55,570,2003,1798,0,102,597,14.59,85.41,642,46,0,0,0,0,15,168,178,102,0,0,104,8,22,2545
1678,1427,251,81,1346,1999,1853,418300,15,1663,0.89,99.11,1094,100,35,22,33,38,56,211,246,271,0,0,26,81,49,2546
757,733,24,352,381,1978,1047,168800,306,451,40.42,59.58,139,201,124,104,99,142,203,13,0,21,67,54,139,13,0,2547
326,326,0,282,44,1993,2577,259800,326,0,100.00,0.00,282,80,0,22,13,0,0,27,19,0,9,59,228,45,10,2548
709,668,41,277,391,1961,994,427200,413,296,58.25,41.75,110,33,12,45,292,0,159,68,12,0,0,19,71,49,114,2549
438,367,71,227,140,1955,975,307800,382,56,87.21,12.79,0,87,35,0,271,0,35,69,45,0,0,12,162,18,52,2550
597,578,19,520,58,1966,3100,863500,590,7,98.83,1.17,46,0,162,405,35,0,0,0,0,49,11,13,0,35,509,2551
684,609,75,353,256,1984,1224,168000,590,94,86.26,13.74,253,182,106,133,57,39,101,40,11,10,15,387,56,0,0,2552
807,756,51,171,585,1968,1186,522500,340,467,42.13,57.87,68,44,74,166,334,42,245,123,44,39,0,0,61,58,28,2553
518,518,0,201,317,1980,1002,150800,329,189,63.51,36.49,131,112,82,111,93,13,191,28,17,0,35,152,60,0,0,2554
267,267,0,224,43,1968,1701,222800,267,0,100.00,0.00,68,0,87,47,64,0,0,0,0,0,26,217,23,0,0,2555
434,381,53,172,209,1995,1308,283200,250,184,57.60,42.40,399,212,0,11,0,0,285,134,0,0,32,22,149,0,0,2556
578,541,37,276,265,1956,706,128200,418,160,72.32,27.68,45,119,103,25,254,49,81,62,0,0,57,210,7,0,6,2557
830,783,47,569,214,1988,1284,261400,562,268,67.71,32.29,575,98,180,19,9,30,62,75,0,66,37,206,181,107,88,2558
271,250,21,199,51,1991,1480,135100,110,161,40.59,59.41,78,40,106,0,0,0,0,35,0,0,42,147,0,0,0,2559
316,316,0,265,51,1974,0,243700,264,52,83.54,16.46,14,95,91,138,28,0,0,0,0,0,0,66,204,51,45,2560
771,643,128,185,458,1988,800,174600,72,699,9.34,90.66,411,277,8,18,0,0,239,0,34,52,0,129,93,0,0,2561
1095,1058,37,206,852,1971,758,241100,236,859,21.55,78.45,65,161,217,691,56,35,681,80,0,0,11,67,172,0,16,2562
1179,1092,87,834,258,2004,1239,207300,966,213,81.93,18.07,1147,0,0,0,13,0,0,34,125,59,8,386,354,23,53,2563
617,581,36,215,366,1972,720,195300,307,310,49.76,50.24,179,64,113,28,146,44,128,69,0,37,0,41,127,13,10,2564
612,555,57,336,219,1974,1065,142700,447,165,73.04,26.96,57,0,111,72,191,0,56,86,0,0,29,196,40,9,0,2565
478,461,17,100,361,1975,579,210500,107,371,22.38,77.62,34,17,183,120,44,60,172,49,0,0,0,69,0,0,0,2566
411,411,0,140,271,1963,785,145000,220,191,53.53,46.47,12,12,164,220,47,0,295,56,0,0,14,46,9,0,0,2567
659,644,15,272,372,1963,1098,438200,274,385,41.58,58.42,0,277,85,86,233,0,333,121,19,0,14,0,0,63,55,2568
760,694,66,604,90,1979,1420,236100,390,370,51.32,48.68,129,124,269,59,118,0,65,35,0,0,64,237,235,17,0,2569
392,354,38,222,132,1950,1029,165200,377,15,96.17,3.83,40,9,0,21,360,0,79,47,0,0,43,188,36,0,18,2570
351,331,20,33,298,1939,762,0,114,237,32.48,67.52,0,19,32,19,420,33,230,62,19,0,0,22,90,5,0,2571
747,695,52,579,116,2000,1125,277100,564,183,75.50,24.50,170,102,63,146,91,0,78,68,24,0,19,164,125,0,12,2572
402,402,0,357,45,1992,1225,336400,322,80,80.10,19.90,138,86,90,48,97,31,0,31,16,10,11,24,136,116,29,2573
633,527,106,225,302,1990,1355,200400,257,376,40.60,59.40,254,151,182,10,0,0,156,131,19,0,27,150,57,10,0,2574
719,719,0,325,394,1978,1143,348700,314,405,43.67,56.33,86,167,300,60,39,42,126,105,35,0,10,86,91,87,8,2575
594,588,6,331,257,1982,1326,203600,257,337,43.27,56.73,184,180,32,77,50,24,101,44,0,8,0,155,122,21,18,2576
714,609,105,261,348,1993,972,172200,339,375,47.48,52.52,534,40,157,25,22,107,22,25,50,0,0,294,120,0,23,2577
738,706,32,398,308,1970,1216,711000,448,290,60.70,39.30,126,40,114,159,231,11,101,92,12,34,0,32,52,0,258,2578
698,652,46,101,551,1987,1332,332700,163,535,23.35,76.65,114,275,31,61,121,0,165,286,42,0,0,0,96,13,0,2579
731,663,68,394,269,1955,1436,461300,465,266,63.61,36.39,229,66,30,74,357,35,139,17,11,9,37,50,101,90,144,2580
1030,1030,0,0,1030,1992,1408,0,40,990,3.88,96.12,511,26,21,90,326,0,222,630,88,0,0,0,0,0,0,2581
1288,1167,121,773,394,2001,977,165900,561,727,43.56,56.44,822,89,117,0,82,5,0,102,22,0,258,669,39,0,0,2582
697,623,74,284,339,1976,1101,196500,374,323,53.66,46.34,290,0,64,173,109,10,130,77,0,10,0,299,80,14,0,2583
583,583,0,138,445,1979,1177,200000,46,537,7.89,92.11,69,177,213,64,8,20,133,144,38,0,0,51,86,0,0,2584
558,453,105,130,323,1939,532,199400,212,346,37.99,62.01,84,15,29,137,266,162,148,2,0,0,29,93,11,28,0,2585
590,556,34,149,407,1975,898,195200,364,226,61.69,38.31,0,35,383,0,30,62,73,20,0,0,0,262,22,9,0,2586
948,891,57,474,417,1976,864,173500,633,315,66.77,33.23,182,142,304,183,155,0,311,56,36,0,28,452,54,0,0,2587
516,516,0,370,146,1968,1450,345700,506,10,98.06,1.94,54,26,0,77,243,15,20,16,59,0,0,45,93,56,59,2588
653,591,62,503,88,1950,1979,428900,561,92,85.91,14.09,13,12,0,0,396,0,0,19,0,0,0,0,109,209,84,2589
637,582,55,381,201,1980,788,119300,353,284,55.42,44.58,174,92,305,0,188,30,221,58,0,0,88,180,41,13,57,2590
663,526,137,45,481,1939,452,202300,221,442,33.33,66.67,0,63,73,122,449,292,212,45,0,21,0,60,0,0,10,2591
487,487,0,477,10,1981,0,453000,487,0,100.00,0.00,87,139,325,23,0,0,0,0,34,27,0,35,104,202,172,2592
443,360,83,131,229,1945,813,97200,305,138,68.85,31.15,35,65,174,63,249,45,92,0,0,0,217,139,79,0,0,2593
343,248,95,216,32,1997,0,236000,233,110,67.93,32.07,149,113,145,16,14,0,18,10,0,0,26,87,96,14,0,2594
903,833,70,373,460,1981,992,195900,586,317,64.89,35.11,334,296,331,244,4,13,430,170,18,0,20,310,165,0,13,2595
380,353,27,278,75,1968,1182,206700,345,35,90.79,9.21,10,13,132,234,11,0,19,87,10,0,0,160,124,0,0,2596
263,255,8,178,77,1950,790,223000,243,20,92.40,7.60,15,0,19,12,304,0,76,0,0,0,17,116,75,29,0,2597
553,553,0,466,87,1966,1690,236400,547,6,98.92,1.08,64,40,38,308,75,0,26,0,0,24,0,102,350,9,14,2598
812,812,0,96,716,1980,1032,183800,113,699,13.92,86.08,112,201,519,68,0,28,373,274,0,0,13,101,63,0,5,2599
383,310,73,168,142,1975,623,95700,157,226,40.99,59.01,58,62,183,76,90,161,12,16,0,0,157,63,4,0,0,2600
679,655,24,321,334,1981,755,200200,286,393,42.12,57.88,58,135,271,59,182,15,239,8,0,0,100,237,51,13,0,2601
503,503,0,382,121,1979,1583,344400,464,39,92.25,7.75,114,49,145,74,79,18,42,15,13,36,0,12,138,150,37,2602
467,435,32,227,208,1973,830,206100,277,190,59.31,40.69,59,68,222,92,135,0,245,39,0,0,6,214,30,0,15,2603
391,258,133,96,162,1970,486,0,135,256,34.53,65.47,89,68,133,5,83,34,150,0,0,0,0,143,15,0,0,2604
400,364,36,17,347,1942,516,0,65,335,16.25,83.75,7,153,9,0,297,212,176,0,12,0,17,13,9,0,0,2605
464,464,0,407,57,1960,1875,239400,452,12,97.41,2.59,62,27,20,228,378,0,67,53,43,0,0,129,289,0,24,2606
480,480,0,76,404,1971,1017,153100,184,296,38.33,61.67,100,51,100,72,213,0,229,149,0,0,0,85,36,0,7,2607
478,456,22,176,280,1955,868,173700,414,64,86.61,13.39,71,53,48,88,279,0,142,38,0,0,24,243,33,15,0,2608
364,364,0,344,20,1974,0,410200,364,0,100.00,0.00,77,77,108,81,93,0,27,0,35,0,0,100,79,93,102,2609
369,369,0,337,32,1965,0,547600,362,7,98.10,1.90,0,0,0,314,42,0,0,32,10,29,0,11,38,96,140,2610
507,376,131,50,326,1939,848,0,253,254,49.90,50.10,41,10,0,0,160,113,37,10,0,0,0,12,0,0,0,2611
619,439,180,182,257,1966,776,169800,325,294,52.50,47.50,73,0,11,111,234,30,47,95,0,0,33,118,56,8,0,2612
599,558,41,404,154,1991,945,157000,290,309,48.41,51.59,249,154,225,0,22,0,182,18,0,0,223,150,29,0,0,2613
795,741,54,118,623,1991,616,231700,25,770,3.14,96.86,479,59,87,0,342,129,350,99,16,0,0,41,70,60,34,2614
608,573,35,536,37,2003,0,350600,608,0,100.00,0.00,467,0,7,11,46,0,16,10,41,0,0,7,220,165,50,2615
286,286,0,157,129,1985,888,0,99,187,34.62,65.38,175,30,64,106,76,100,64,64,9,0,110,42,30,0,0,2616
725,708,17,217,491,1956,848,188400,361,364,49.79,50.21,55,9,160,92,389,32,288,8,9,0,22,147,102,0,0,2617
538,440,98,177,263,1976,602,113200,306,232,56.88,43.12,146,69,99,72,234,109,255,0,0,0,59,84,11,9,7,2618
904,836,68,667,169,1980,1120,478000,833,71,92.15,7.85,204,340,100,79,104,0,76,0,27,11,10,61,233,71,278,2619
575,544,31,150,394,1970,979,186400,180,395,31.30,68.70,0,0,182,130,298,12,253,93,0,0,0,104,90,14,12,2620
794,711,83,150,561,1939,1441,390000,140,654,17.63,82.37,253,44,33,40,349,34,263,135,38,27,0,33,48,0,80,2621
458,458,0,100,358,1974,1351,460000,150,308,32.75,67.25,178,44,46,57,346,118,183,167,8,44,0,0,11,27,82,2622
1020,974,46,89,885,1966,1299,260300,111,909,10.88,89.12,41,64,114,234,335,27,339,179,0,13,0,36,0,0,0,2623
488,430,58,331,99,1949,1482,555600,436,52,89.34,10.66,15,0,74,28,320,0,15,38,0,59,0,14,34,119,158,2624
698,675,23,248,427,1981,1429,462500,226,472,32.38,67.62,186,151,248,146,92,16,272,124,46,17,0,55,95,75,86,2625
840,840,0,193,647,1973,1127,454600,226,614,26.90,73.10,186,75,133,53,280,0,321,146,0,0,0,15,76,75,83,2626
314,293,21,232,61,1946,1031,243200,270,44,85.99,14.01,41,0,12,67,299,0,64,54,0,0,28,64,144,16,0,2627
574,574,0,471,103,1985,1642,364600,574,0,100.00,0.00,108,298,113,43,0,0,0,32,0,0,11,35,138,140,206,2628
410,401,9,253,148,1967,1245,354400,229,181,55.85,44.15,17,16,143,0,209,0,96,19,0,0,0,61,59,69,81,2629
547,536,11,359,177,1952,1309,378100,424,123,77.51,22.49,3,151,14,0,323,0,70,25,13,0,25,18,216,77,47,2630
635,568,67,417,151,1958,1000,432200,571,64,89.92,10.08,113,6,44,84,324,0,13,27,17,4,0,11,208,136,140,2631
391,380,11,373,7,1953,0,536300,391,0,100.00,0.00,12,12,15,39,283,0,0,11,0,0,0,0,52,87,199,2632
752,707,45,620,87,1975,1302,204000,742,10,98.67,1.33,74,29,437,169,0,0,43,46,0,0,0,442,147,31,0,2633
1126,1046,80,356,690,1986,1157,168600,555,571,49.29,50.71,676,194,213,139,0,0,331,503,0,0,58,261,9,0,12,2634
724,649,75,344,305,1976,730,171800,474,250,65.47,34.53,38,9,461,76,0,24,148,0,0,0,0,311,49,0,0,2635
36,24,12,0,24,1992,0,0,11,25,30.56,69.44,5,8,9,0,0,9,5,0,0,0,8,0,0,0,0,2636
1470,1099,371,824,275,1992,1145,276300,1227,243,83.47,16.53,609,100,220,59,130,0,26,11,0,0,0,406,278,0,187,2637
365,339,26,191,148,1958,797,153400,284,81,77.81,22.19,46,44,41,28,351,104,145,0,0,0,52,77,35,8,8,2638
409,374,35,361,13,1994,0,469500,409,0,100.00,0.00,185,107,3,0,93,0,17,0,0,51,17,10,32,22,239,2639
903,878,25,357,521,1959,747,231000,517,386,57.25,42.75,115,8,124,153,428,87,157,31,16,0,0,258,114,0,15,2640
630,263,367,214,49,1981,655,208300,506,124,80.32,19.68,109,120,68,82,49,14,0,0,0,0,30,87,18,25,16,2641
701,603,98,400,203,1979,1146,227400,539,162,76.89,23.11,288,162,146,82,63,79,71,88,67,0,34,170,188,0,0,2642
338,322,16,274,48,1976,0,178100,259,79,76.63,23.37,58,85,119,94,37,7,10,18,0,0,117,99,110,12,13,2643
565,477,88,302,175,1964,645,101800,440,125,77.88,22.12,42,33,113,86,363,24,175,0,0,0,135,215,15,0,0,2644
679,615,64,153,462,1958,624,91500,385,294,56.70,43.30,119,67,48,116,333,106,118,0,0,0,184,102,46,0,0,2645
1520,1135,385,875,260,1991,991,335400,1251,269,82.30,17.70,650,252,309,47,92,0,131,106,0,0,7,111,346,95,236,2646
734,633,101,569,64,1986,0,380600,709,25,96.59,3.41,147,213,155,139,103,0,11,0,0,16,15,33,92,67,266,2647
447,447,0,285,162,1961,1217,596200,285,162,63.76,36.24,100,68,34,46,272,25,87,118,0,0,0,0,42,63,122,2648
316,295,21,68,227,1968,879,166200,127,189,40.19,59.81,5,46,33,0,149,0,58,53,7,0,0,34,31,16,0,2649
440,430,10,393,37,1981,0,125700,310,130,70.45,29.55,270,66,50,42,194,0,87,66,0,0,26,262,137,0,0,2650
732,732,0,350,382,1979,791,206200,474,258,64.75,35.25,213,141,132,25,177,32,159,64,0,0,17,119,183,37,17,2651
1015,987,28,482,505,1968,1217,1070100,575,440,56.65,43.35,195,123,174,160,315,0,90,66,43,28,0,13,44,80,364,2652
775,775,0,720,55,2004,0,354300,720,55,92.90,7.10,329,96,20,7,0,0,0,0,10,0,0,80,242,79,41,2653
509,409,100,324,85,1955,1316,167300,509,0,100.00,0.00,21,0,31,57,301,0,0,60,0,0,7,285,21,0,12,2654
483,413,70,165,248,1939,275,141200,265,218,54.87,45.13,8,14,57,39,300,150,40,9,0,0,43,146,8,0,0,2655
704,704,0,344,360,1995,763,292200,464,240,65.91,34.09,382,119,100,0,36,0,159,9,42,12,0,41,303,29,9,2656
328,320,8,278,42,1994,0,332600,315,13,96.04,3.96,132,108,77,0,96,0,19,15,0,0,0,116,136,46,66,2657
504,504,0,477,27,1989,0,473800,487,17,96.63,3.37,275,126,131,12,12,0,30,0,9,0,9,52,65,146,205,2658
818,768,50,499,269,1990,1215,208800,546,272,66.75,33.25,430,125,228,11,10,0,62,127,43,0,21,154,260,23,0,2659
730,641,89,279,362,1986,1047,120700,256,474,35.07,64.93,203,147,41,13,113,8,65,79,0,0,24,253,24,0,0,2660
969,886,83,666,220,1983,1192,215300,777,192,80.19,19.81,458,217,102,17,28,0,67,87,0,47,42,154,233,88,63,2661
360,360,0,346,14,1959,0,450400,353,7,98.06,1.94,93,56,24,33,269,0,35,14,0,0,12,0,88,44,250,2662
449,404,45,381,23,2000,0,272300,388,61,86.41,13.59,139,41,43,14,32,0,0,15,0,0,10,108,34,37,10,2663
957,913,44,470,443,1991,1713,570700,295,662,30.83,69.17,451,104,54,44,147,0,80,99,92,0,0,11,49,74,286,2664
391,372,19,265,107,1939,1175,504900,383,8,97.95,2.05,13,0,27,49,267,14,43,12,0,0,0,7,100,20,123,2665
761,666,95,361,305,1957,1148,255600,547,214,71.88,28.12,152,32,102,46,372,66,88,44,53,35,0,138,188,22,13,2666
441,429,12,383,46,1993,867,237000,318,123,72.11,27.89,77,34,109,70,61,0,10,0,0,0,32,61,76,55,81,2667
277,277,0,270,7,2005,0,182100,277,0,100.00,0.00,259,0,0,0,6,0,0,18,0,0,9,217,6,0,15,2668
773,755,18,655,100,2001,2104,394700,773,0,100.00,0.00,695,0,24,0,0,0,0,49,0,0,26,114,253,89,139,2669
370,355,15,269,86,1974,585,143800,259,111,70.00,30.00,60,74,140,56,102,12,60,15,0,0,63,107,77,0,56,2670
848,774,74,639,135,1992,996,178500,599,249,70.64,29.36,264,162,186,11,23,0,44,49,0,0,119,282,98,22,32,2671
697,697,0,598,99,1988,2395,510100,697,0,100.00,0.00,307,325,61,22,27,0,0,0,20,0,9,20,144,106,416,2672
1464,1402,62,1060,342,1993,949,237900,1179,285,80.53,19.47,782,99,188,0,0,0,141,103,17,0,0,292,378,76,25,2673
852,758,94,196,562,1977,1088,322600,164,688,19.25,80.75,103,291,311,229,61,75,345,157,91,0,0,35,107,47,33,2674
652,595,57,578,17,1988,0,249200,523,129,80.21,19.79,317,164,87,37,0,0,7,0,34,0,54,173,233,53,8,2675
862,606,256,536,70,1995,0,147500,553,309,64.15,35.85,401,141,102,32,10,13,75,12,11,0,53,288,93,0,23,2676
456,390,66,345,45,1979,0,328900,399,57,87.50,12.50,232,9,140,28,119,0,12,17,0,43,19,86,123,57,135,2677
321,304,17,202,102,1954,860,118200,321,0,100.00,0.00,0,42,43,36,279,19,128,19,0,0,29,189,16,0,0,2678
276,276,0,276,0,1991,0,423100,220,56,79.71,20.29,115,56,63,0,78,0,22,0,0,0,8,49,98,69,43,2679
617,617,0,395,222,1979,1314,217300,498,119,80.71,19.29,41,91,334,85,11,35,88,44,0,0,14,179,202,0,0,2680
756,711,45,224,487,1994,1200,256800,194,562,25.66,74.34,395,227,87,42,12,10,91,364,26,0,0,61,83,8,23,2681
749,662,87,584,78,1988,848,268100,486,263,64.89,35.11,326,130,134,18,77,13,8,12,9,0,36,134,234,39,133,2682
576,498,78,434,64,1989,0,320500,447,129,77.60,22.40,158,141,124,9,37,0,47,0,0,0,71,43,142,34,116,2683
803,785,18,392,393,1985,1343,284200,425,378,52.93,47.07,274,31,102,121,70,7,82,172,34,0,10,32,145,39,0,2684
1434,1389,45,941,448,1978,764,186200,1064,370,74.20,25.80,530,256,337,123,295,114,316,81,0,0,139,462,196,49,8,2685
1190,672,518,553,119,1987,840,266600,838,352,70.42,29.58,396,181,257,58,44,0,45,18,0,0,43,194,201,71,18,2686
420,265,155,129,136,1941,1140,138800,357,63,85.00,15.00,57,0,36,32,294,0,53,55,18,0,4,186,32,0,0,2687
307,307,0,220,87,1988,1133,92900,162,145,52.77,47.23,115,133,28,47,64,17,49,47,0,0,111,57,0,0,0,2688
561,521,40,324,197,1975,907,339200,414,147,73.80,26.20,73,147,294,46,53,0,193,72,0,0,22,61,144,9,87,2689
209,119,90,119,0,1991,0,612300,169,40,80.86,19.14,74,90,16,0,7,0,0,0,0,12,8,0,16,21,97,2690
606,568,38,511,57,1978,1322,182600,393,213,64.85,35.15,184,154,192,10,21,0,25,72,33,0,142,178,88,9,14,2691
419,348,71,199,149,1977,1417,178600,237,182,56.56,43.44,223,162,180,55,18,0,42,129,64,0,58,74,182,0,0,2692
402,262,140,118,144,1971,912,9999,62,340,15.42,84.58,16,25,0,107,44,53,19,24,0,0,36,11,10,0,0,2693
314,280,34,246,34,1957,0,779900,314,0,100.00,0.00,58,0,83,66,239,0,28,16,0,0,0,12,12,101,239,2694
490,490,0,345,145,1995,1416,416400,358,132,73.06,26.94,323,110,49,0,0,0,0,145,9,0,0,0,81,86,142,2695
861,732,129,543,189,1983,950,383300,799,62,92.80,7.20,270,177,44,70,211,41,21,12,0,0,0,110,157,76,186,2696
495,475,20,266,209,1975,649,90800,321,174,64.85,35.15,73,28,338,23,53,43,95,0,0,0,124,177,32,0,0,2697
397,383,14,126,257,1939,647,223300,224,173,56.42,43.58,39,0,18,39,335,46,129,32,35,0,0,69,14,15,21,2698
1098,983,115,823,160,1992,1240,262700,877,221,79.87,20.13,572,146,210,33,44,0,46,27,0,31,0,179,201,111,229,2699
928,798,130,345,453,1994,1626,442500,191,737,20.58,79.42,385,220,34,42,30,0,94,167,0,101,0,12,92,43,149,2700
743,663,80,589,74,1986,975,549400,711,32,95.69,4.31,270,153,138,30,198,10,42,0,9,0,19,29,89,57,428,2701
547,547,0,496,51,1958,2125,263200,513,34,93.78,6.22,68,39,19,169,437,0,37,45,0,0,28,177,311,56,53,2702
613,520,93,304,216,1973,999,348200,285,328,46.49,53.51,81,121,128,129,45,0,87,247,0,0,14,74,49,20,0,2703
216,216,0,171,45,1993,1317,275000,216,0,100.00,0.00,111,190,0,0,0,0,0,18,14,0,0,53,216,0,0,2704
1083,1043,40,302,741,1982,954,283300,333,750,30.75,69.25,187,146,258,132,119,0,464,195,0,0,7,75,30,18,39,2705
286,286,0,205,81,1991,1246,321800,208,78,72.73,27.27,191,130,19,5,65,0,0,38,0,0,12,99,38,29,154,2706
209,178,31,152,26,1982,0,219200,191,18,91.39,8.61,98,38,51,20,8,0,10,0,0,0,0,128,57,12,8,2707
363,363,0,363,0,1972,0,263100,274,89,75.48,24.52,11,89,121,40,120,0,0,11,28,0,62,121,67,39,53,2708
934,875,59,577,298,1988,1415,323100,582,352,62.31,37.69,414,286,143,0,0,0,93,87,65,34,0,33,174,88,131,2709
474,344,130,266,78,1972,1398,466100,459,15,96.84,3.16,79,39,128,68,174,0,34,0,29,10,0,0,54,101,141,2710
693,693,0,375,318,1967,1059,377500,444,249,64.07,35.93,18,60,107,249,237,171,0,13,65,30,0,0,162,140,47,2711
1044,1044,0,309,735,1989,948,0,175,869,16.76,83.24,388,461,195,46,0,89,567,136,0,0,150,42,53,0,0,2712
775,688,87,327,361,1952,862,181300,511,264,65.94,34.06,106,42,125,68,397,51,202,156,0,0,9,166,0,33,0,2713
402,356,46,315,41,1964,1156,432300,374,28,93.03,6.97,26,0,59,82,217,0,17,0,0,0,3,76,14,77,143,2714
598,531,67,208,323,1956,827,199000,319,279,53.34,46.66,21,138,54,30,413,74,164,146,0,0,0,133,46,0,7,2715
268,241,27,181,60,1973,881,153500,245,23,91.42,8.58,110,16,138,84,38,0,0,15,0,0,0,331,0,40,0,2716
338,298,40,209,89,1992,820,286800,212,126,62.72,37.28,377,0,151,46,30,0,156,51,0,0,31,127,43,0,119,2717
605,540,65,472,68,1993,0,329600,448,157,74.05,25.95,383,65,45,23,9,0,19,9,0,0,29,32,187,48,201,2718
594,559,35,256,303,1969,1079,242400,295,299,49.66,50.34,147,10,66,58,332,23,104,33,50,0,0,118,178,57,19,2719
612,569,43,275,294,1973,1279,346100,327,285,53.43,46.57,47,225,16,43,297,0,80,40,12,58,13,60,111,79,90,2720
465,410,55,298,112,1978,1370,287900,424,41,91.18,8.82,190,45,44,78,119,0,0,16,27,0,0,116,154,61,71,2721
533,499,34,406,93,1996,711,291300,387,146,72.61,27.39,277,85,27,21,49,14,0,0,15,0,123,30,220,16,41,2722
410,368,42,261,107,1986,934,0,167,243,40.73,59.27,120,119,100,78,25,0,66,39,0,29,125,73,26,0,9,2723
430,430,0,353,77,1978,1134,207600,269,161,62.56,37.44,134,45,212,14,10,0,0,0,0,0,15,159,202,11,5,2724
1000,950,50,933,17,2002,0,763700,986,14,98.60,1.40,765,204,0,0,9,0,0,0,0,13,0,14,19,11,893,2725
875,756,119,402,354,1969,1892,703100,570,305,65.14,34.86,115,227,106,41,196,0,9,114,55,29,0,32,81,22,329,2726
1210,1171,39,279,892,1995,1405,256000,134,1076,11.07,88.93,567,310,267,132,26,44,80,385,199,0,50,168,189,70,26,2727
269,225,44,164,61,1982,650,90900,197,72,73.23,26.77,123,73,74,3,39,22,30,15,6,0,95,58,0,0,14,2728
826,694,132,264,430,1984,1017,223200,344,482,41.65,58.35,234,137,188,67,157,0,267,121,0,0,0,136,105,15,22,2729
498,449,49,416,33,1977,0,278300,469,29,94.18,5.82,189,89,256,27,0,0,13,62,0,0,0,69,172,89,156,2730
361,339,22,237,102,1973,1027,269800,262,99,72.58,27.42,80,53,59,42,125,0,29,37,4,0,61,64,92,11,42,2731
367,274,93,231,43,1986,592,195800,308,59,83.92,16.08,131,97,74,28,87,3,19,0,0,0,28,120,27,7,21,2732
1378,1378,0,818,560,1997,1003,206700,895,483,64.95,35.05,771,307,228,11,88,11,214,98,32,27,103,337,367,46,46,2733
412,389,23,188,201,1948,528,118400,307,105,74.51,25.49,33,13,20,17,374,101,119,0,0,0,90,98,0,0,0,2734
998,875,123,124,751,1979,896,325500,97,901,9.72,90.28,182,49,177,12,418,15,548,67,31,13,0,7,11,16,10,2735
335,292,43,186,106,1959,1320,273900,314,21,93.73,6.27,8,50,37,25,184,0,12,13,58,10,0,15,126,23,10,2736
652,652,0,249,403,1972,629,102200,199,453,30.52,69.48,153,117,97,22,220,52,120,0,78,53,91,127,0,0,0,2737
727,663,64,489,174,1976,725,173700,547,180,75.24,24.76,113,59,160,99,174,46,59,0,0,0,155,210,10,19,39,2738
665,600,65,471,129,1994,1220,241300,571,94,85.86,14.14,282,200,41,0,39,0,11,28,0,0,21,203,208,30,35,2739
715,666,49,402,264,2002,1263,209600,681,34,95.24,4.76,561,8,36,0,35,8,21,132,0,0,0,332,110,9,0,2740
676,632,44,172,460,1986,1186,321900,244,432,36.09,63.91,321,110,47,192,19,8,224,120,29,0,0,8,140,47,103,2741
1017,901,116,500,401,1979,1112,472400,674,343,66.27,33.73,257,273,491,60,139,120,203,65,47,14,0,24,84,108,311,2742
659,598,61,446,152,1975,687,173500,505,154,76.63,23.37,160,53,142,83,290,0,110,71,0,0,112,189,190,21,31,2743
553,495,58,457,38,1983,0,401000,494,59,89.33,10.67,168,60,40,32,116,0,0,0,0,12,28,57,123,57,120,2744
981,950,31,855,95,1983,1326,262000,903,78,92.05,7.95,375,249,181,73,74,0,21,0,0,0,13,276,191,81,191,2745
746,617,129,384,233,1973,875,213400,559,187,74.93,25.07,82,57,95,50,380,44,121,40,0,0,18,227,40,13,34,2746
649,571,78,420,151,1979,834,240300,559,90,86.13,13.87,166,39,97,52,119,6,54,13,0,0,43,122,111,13,20,2747
423,401,22,383,18,1984,0,271000,376,47,88.89,11.11,209,48,11,9,73,0,11,32,0,0,0,107,74,26,55,2748
1250,363,887,333,30,1984,0,597900,1000,250,80.00,20.00,275,254,489,60,163,0,19,19,0,0,44,0,32,38,88,2749
895,41,854,28,13,1980,0,0,656,239,73.30,26.70,156,183,245,19,34,0,55,0,0,0,0,0,27,0,0,2750
1206,1193,13,997,196,2004,2162,569100,1189,17,98.59,1.41,1005,0,0,0,10,0,0,0,0,68,22,0,72,146,563,2751
518,360,158,314,46,1978,0,196300,476,42,91.89,8.11,147,42,122,19,213,0,26,13,0,0,29,97,60,0,54,2752
518,518,0,438,80,1994,2092,399100,499,19,96.33,3.67,206,90,170,67,0,0,0,13,0,24,0,16,149,210,121,2753
647,582,65,426,156,1939,1524,497300,556,91,85.94,14.06,30,0,38,0,550,0,67,90,0,15,0,0,73,98,259,2754
489,435,54,228,207,1964,413,175000,234,255,47.85,52.15,177,76,25,72,166,254,32,34,47,0,0,93,31,0,14,2755
483,450,33,341,109,1939,1140,231400,483,0,100.00,0.00,0,0,31,12,474,0,91,86,0,0,23,186,71,0,0,2756
580,580,0,556,24,1990,0,308600,575,5,99.14,0.86,226,106,83,10,0,10,10,0,0,0,0,26,252,98,29,2757
411,401,10,326,75,1956,1646,246300,400,11,97.32,2.68,29,0,10,59,357,0,0,17,19,6,9,77,307,0,0,2758
344,318,26,299,19,1984,0,362100,318,26,92.44,7.56,191,59,82,3,0,31,0,0,0,0,31,42,67,43,121,2759
1261,1037,224,826,211,1997,1666,217300,1135,126,90.01,9.99,630,239,208,73,0,0,28,64,60,26,40,451,385,10,86,2760
563,563,0,455,108,1991,1645,309400,479,84,85.08,14.92,249,126,31,14,47,0,0,0,21,0,0,33,230,83,56,2761
772,731,41,537,194,1957,946,230300,622,150,80.57,19.43,68,22,25,80,576,50,87,26,12,0,60,316,189,0,0,2762
804,778,26,724,54,1992,732,320900,667,137,82.96,17.04,389,178,319,0,55,12,49,0,0,0,93,293,222,62,131,2763
475,450,25,260,190,1955,918,202000,381,94,80.21,19.79,103,19,19,6,312,16,60,10,0,0,33,106,101,6,20,2764
624,588,36,169,419,1968,1073,273900,233,391,37.34,62.66,158,128,65,56,245,0,169,110,0,0,19,67,130,48,103,2765
2182,1046,1136,827,219,1991,792,152500,1540,642,70.58,29.42,936,209,331,161,0,15,150,15,0,0,247,494,226,19,0,2766
340,209,131,174,35,1981,0,0,242,98,71.18,28.82,186,134,70,46,23,0,0,0,0,0,9,17,106,0,58,2767
452,420,32,331,89,1986,1304,311300,432,20,95.58,4.42,163,194,69,10,54,0,0,47,9,0,0,22,224,37,124,2768
1084,851,233,642,209,1984,689,241900,786,298,72.51,27.49,450,144,121,40,156,14,51,83,0,0,49,155,253,29,92,2769
1044,968,76,858,110,1993,830,403100,906,138,86.78,13.22,567,70,69,140,174,12,85,16,0,0,9,108,303,95,320,2770
609,425,184,169,256,1959,632,113800,324,285,53.20,46.80,60,63,123,58,352,124,119,4,0,0,137,139,28,3,0,2771
435,435,0,371,64,1977,1709,237300,428,7,98.39,1.61,52,57,268,124,8,0,0,0,59,0,10,213,121,18,0,2772
279,270,9,230,40,1967,783,0,106,173,37.99,62.01,60,34,95,132,97,7,9,13,6,0,223,23,46,11,9,2773
1176,1138,38,844,294,1987,1411,430500,724,452,61.56,38.44,250,432,80,65,51,17,11,215,24,13,14,81,147,129,227,2774
693,650,43,20,630,1999,747,0,20,673,2.89,97.11,489,0,11,0,0,49,362,9,0,0,0,0,0,0,0,2775
637,554,83,448,106,1990,929,278000,444,193,69.70,30.30,215,160,159,40,20,21,0,12,12,0,118,166,61,27,68,2776
935,882,53,607,275,1995,1257,246000,878,57,93.90,6.10,595,41,51,11,204,20,35,30,0,25,0,255,397,34,64,2777
233,233,0,194,39,1983,872,170800,136,97,58.37,41.63,95,71,46,21,40,0,49,9,0,0,64,43,66,14,28,2778
447,370,77,180,190,1943,545,113400,312,135,69.80,30.20,26,11,0,43,365,59,153,0,0,0,82,72,10,0,0,2779
1073,1073,0,917,156,1989,1479,354400,984,89,91.71,8.29,422,307,108,147,34,0,19,27,32,0,0,19,648,107,119,2780
400,400,0,318,82,1980,1366,285400,325,75,81.25,18.75,268,46,106,0,49,0,0,0,0,0,0,53,210,78,98,2781
529,513,16,484,29,1986,0,685000,529,0,100.00,0.00,116,382,68,0,0,0,0,0,0,33,16,0,0,0,480,2782
645,632,13,585,47,1978,2173,451500,645,0,100.00,0.00,212,124,408,0,0,0,0,0,17,47,11,0,136,297,200,2783
695,665,30,372,293,1939,1173,565800,432,263,62.16,37.84,38,8,21,39,563,0,187,41,56,12,13,12,17,76,203,2784
683,646,37,531,115,1991,835,168800,369,314,54.03,45.97,304,128,139,87,105,0,0,41,0,0,117,444,107,0,0,2785
366,287,79,74,213,1975,816,0,113,253,30.87,69.13,154,61,224,15,78,175,209,4,0,0,0,64,0,18,0,2786
1286,1211,75,620,591,1996,1113,263700,740,546,57.54,42.46,553,200,414,102,0,0,262,80,32,0,0,132,563,98,59,2787
785,735,50,329,406,1963,1109,326300,303,482,38.60,61.40,46,79,102,47,338,0,114,276,10,0,0,17,52,49,13,2788
700,677,23,470,207,1977,562,280600,521,179,74.43,25.57,158,121,129,24,121,87,37,17,0,0,7,109,75,62,83,2789
531,531,0,425,106,1983,822,107000,232,299,43.69,56.31,278,57,125,39,116,35,57,0,0,0,270,126,0,13,0,2790
608,572,36,258,314,1977,949,207500,346,262,56.91,43.09,307,59,123,72,141,13,277,38,25,0,0,174,115,5,0,2791
486,449,37,125,324,1975,858,450000,148,338,30.45,69.55,83,55,51,53,145,44,244,0,0,0,0,6,32,17,31,2792
8,8,0,0,8,0,0,0,8,0,100.00,0.00,0,0,0,0,22,0,0,0,0,0,22,0,0,0,0,2793
474,458,16,215,243,1986,938,339200,420,54,88.61,11.39,175,78,264,21,76,27,32,10,0,0,18,59,84,90,199,2794
459,424,35,350,74,1968,893,218500,407,52,88.67,11.33,64,21,85,173,68,0,0,44,6,23,0,93,152,36,34,2795
623,594,29,527,67,1992,1510,278400,556,67,89.25,10.75,278,43,95,88,100,0,3,14,0,0,18,157,250,76,75,2796
576,548,28,323,225,1977,878,260800,416,160,72.22,27.78,82,115,154,49,161,18,14,101,0,0,0,182,145,31,63,2797
606,579,27,496,83,2004,2344,668200,606,0,100.00,0.00,331,0,45,0,0,0,0,0,0,0,0,0,11,55,310,2798
766,733,33,428,305,1985,1177,276500,468,298,61.10,38.90,265,55,217,128,111,11,100,70,0,10,107,107,132,113,61,2799
542,467,75,175,292,1971,1129,166300,358,184,66.05,33.95,392,0,18,76,128,0,114,84,34,0,0,173,87,0,0,2800
843,719,124,461,258,1976,643,130600,627,216,74.38,25.62,131,132,220,39,237,92,105,0,3,0,108,353,37,0,0,2801
447,447,0,351,96,1970,1083,246800,407,40,91.05,8.95,105,39,14,67,157,0,84,0,0,0,17,16,238,20,0,2802
709,709,0,656,53,1979,0,160700,622,87,87.73,12.27,133,114,247,17,91,13,15,50,0,0,90,371,48,0,0,2803
441,412,29,228,184,1973,1049,251800,245,196,55.56,44.44,89,145,30,59,69,10,26,0,0,0,11,23,235,8,37,2804
590,590,0,390,200,1956,784,142700,386,204,65.42,34.58,147,35,63,56,465,66,263,0,0,0,62,321,16,0,0,2805
537,515,22,428,87,1991,1679,246200,465,72,86.59,13.41,235,103,24,59,35,31,41,10,21,0,65,80,123,26,24,2806
279,279,0,71,208,1988,596,267200,149,130,53.41,46.59,12,13,4,0,167,0,87,0,0,0,0,33,37,13,0,2807
1109,1032,77,487,545,1990,1190,299000,562,547,50.68,49.32,772,318,139,25,97,0,282,371,12,3,6,79,263,125,74,2808
1863,1688,175,1637,51,0,2594,578400,1842,21,98.87,1.13,1369,41,0,30,13,0,0,22,0,30,0,0,122,253,970,2809
756,649,107,529,120,1985,906,211900,552,204,73.02,26.98,228,78,88,50,175,17,11,34,28,0,43,256,48,52,8,2810
439,419,20,385,34,1971,0,449300,333,106,75.85,24.15,103,125,33,13,190,0,29,43,11,81,0,21,86,33,160,2811
543,543,0,436,107,1991,1109,186200,286,257,52.67,47.33,361,240,88,19,33,0,130,10,11,0,122,221,118,16,94,2812
577,550,27,459,91,1981,1835,319900,567,10,98.27,1.73,201,180,170,27,63,0,0,0,13,0,16,41,310,198,26,2813
263,221,42,180,41,1992,0,760600,263,0,100.00,0.00,136,45,11,2,22,0,0,0,0,0,0,0,25,23,168,2814
337,337,0,231,106,1947,948,96600,337,0,100.00,0.00,0,19,0,0,313,0,44,17,0,0,112,76,0,0,9,2815
933,807,126,435,372,1988,863,135100,316,617,33.87,66.13,476,177,211,0,11,0,296,69,0,0,159,277,42,0,0,2816
330,288,42,277,11,1946,0,427600,330,0,100.00,0.00,83,56,15,29,258,16,50,37,20,0,0,0,44,135,139,2817
506,506,0,287,219,1967,958,184900,466,40,92.09,7.91,24,17,147,75,219,0,96,101,0,0,0,151,85,12,0,2818
481,437,44,351,86,1962,1724,495500,412,69,85.65,14.35,25,66,81,137,230,0,0,65,15,37,0,33,97,24,210,2819
443,408,35,295,113,1970,818,124000,253,190,57.11,42.89,56,36,123,45,175,3,47,37,0,3,156,24,80,23,23,2820
549,549,0,378,171,1993,1389,277900,401,148,73.04,26.96,498,137,13,0,14,0,111,10,0,0,11,87,191,105,47,2821
326,188,138,135,53,1977,811,0,194,132,59.51,40.49,74,90,85,12,44,0,0,0,0,0,69,93,121,13,9,2822
1177,1064,113,776,288,1979,932,270800,748,429,63.55,36.45,218,132,354,37,222,45,194,58,0,0,55,108,278,167,46,2823
1910,774,1136,651,123,1991,1080,170700,1286,624,67.33,32.67,507,597,378,226,158,26,54,22,11,0,46,534,107,57,35,2824
996,996,0,677,319,2000,1759,297600,932,64,93.57,6.43,594,250,131,13,52,0,72,47,10,14,15,57,501,121,100,2825
1026,582,444,463,119,1982,0,136800,814,212,79.34,20.66,246,327,134,24,100,10,36,0,0,0,90,290,66,0,61,2826
319,319,0,307,12,1983,0,358300,308,11,96.55,3.45,170,40,99,87,37,0,0,0,0,48,0,56,47,81,152,2827
508,449,59,403,46,1982,1435,280400,508,0,100.00,0.00,28,0,67,113,104,0,0,16,14,0,0,101,87,27,46,2828
812,812,0,414,398,1972,855,185000,304,508,37.44,62.56,88,92,288,121,84,12,253,61,0,0,0,241,35,25,0,2829
1250,1185,65,698,487,0,1762,580200,665,585,53.20,46.80,967,0,0,0,0,34,50,119,133,99,0,4,27,54,370,2830
393,356,37,291,65,1939,1168,279600,385,8,97.96,2.04,12,0,22,51,297,0,12,36,0,0,11,75,168,37,43,2831
944,908,36,546,362,1985,881,201400,462,482,48.94,51.06,543,103,313,0,61,0,146,67,0,0,175,154,266,7,29,2832
381,381,0,357,24,1989,1139,654500,373,8,97.90,2.10,144,102,64,39,19,0,0,21,12,0,12,28,21,46,228,2833
445,445,0,293,152,1977,825,234600,286,159,64.27,35.73,120,75,178,9,78,35,43,0,0,0,0,146,106,6,0,2834
588,569,19,152,417,1965,659,95200,351,237,59.69,40.31,112,33,63,111,245,114,232,26,0,0,33,51,9,0,0,2835
930,809,121,753,56,1993,808,258200,636,294,68.39,31.61,636,191,120,37,23,0,21,0,13,0,21,303,337,103,163,2836
498,498,0,478,20,1974,0,211800,498,0,100.00,0.00,134,54,250,128,0,0,0,34,55,0,0,332,103,17,0,2837
718,611,107,481,130,1969,1466,193300,650,68,90.53,9.47,13,38,206,228,132,0,73,48,38,0,12,154,233,25,24,2838
478,478,0,315,163,1969,1282,297800,324,154,67.78,32.22,64,57,0,201,203,15,28,0,0,0,0,36,316,102,0,2839
833,754,79,411,343,1979,1016,213300,469,364,56.30,43.70,96,337,171,113,23,61,68,128,0,0,129,268,43,0,28,2840
1189,1153,36,864,289,1990,740,162500,865,324,72.75,27.25,490,83,305,88,194,86,259,51,0,0,153,418,142,0,0,2841
492,463,29,240,223,1964,1864,223800,251,241,51.02,48.98,11,25,83,152,132,0,72,24,22,0,14,94,107,0,15,2842
516,516,0,173,343,1968,1064,336300,217,299,42.05,57.95,70,99,352,73,53,0,439,73,0,0,0,36,53,11,20,2843
541,433,108,272,161,1955,1019,183000,486,55,89.83,10.17,37,86,83,62,309,9,166,33,13,0,38,212,35,19,11,2844
677,638,39,532,106,1950,749,513900,566,111,83.60,16.40,53,44,16,32,540,16,31,16,13,31,0,0,178,136,236,2845
587,576,11,564,12,1978,0,518700,562,25,95.74,4.26,121,163,253,66,0,0,0,32,0,13,0,0,149,60,321,2846
376,362,14,275,87,1976,852,376900,308,68,81.91,18.09,60,12,39,42,208,0,0,50,8,0,14,91,44,67,44,2847
460,418,42,363,55,1955,1556,233500,441,19,95.87,4.13,72,42,81,87,339,0,48,84,0,42,0,164,220,38,25,2848
1042,971,71,457,514,1959,1120,611500,536,506,51.44,48.56,188,141,79,13,497,0,173,237,93,26,0,0,10,58,321,2849
577,515,62,422,93,1978,1658,329700,549,28,95.15,4.85,129,87,201,58,27,35,14,9,21,0,0,123,141,71,60,2850
517,435,82,401,34,1956,1813,613300,441,76,85.30,14.70,65,34,19,54,325,0,24,0,15,57,0,11,37,51,248,2851
913,858,55,394,464,1977,1051,416300,462,451,50.60,49.40,110,165,372,82,106,13,196,68,0,0,15,166,196,25,126,2852
375,312,63,211,101,1989,657,221300,209,166,55.73,44.27,74,48,133,9,100,0,23,41,0,0,47,65,42,13,72,2853
735,693,42,559,134,1992,834,313400,633,102,86.12,13.88,320,77,93,20,147,0,17,24,0,18,0,80,123,104,64,2854
566,515,51,446,69,1990,1608,479800,526,40,92.93,7.07,257,120,157,47,37,0,29,0,0,0,0,0,176,75,257,2855
858,748,110,636,112,1982,1036,415400,817,41,95.22,4.78,361,61,161,70,120,0,9,30,0,0,11,9,101,95,331,2856
913,806,107,32,774,1984,740,189600,13,900,1.42,98.58,313,0,39,16,408,220,278,73,25,0,0,41,8,0,0,2857
560,504,56,409,95,1981,1263,307100,541,19,96.61,3.39,42,11,145,168,102,0,13,0,26,0,0,91,196,90,52,2858
684,684,0,162,522,1970,722,165900,165,519,24.12,75.88,163,147,70,249,109,42,399,15,0,0,0,100,71,14,0,2859
540,540,0,329,211,1979,1163,332100,259,281,47.96,52.04,22,154,160,73,11,0,44,11,11,22,0,109,100,85,38,2860
445,445,0,278,167,1969,1155,336800,294,151,66.07,33.93,166,61,19,62,194,0,195,79,0,0,0,43,126,45,14,2861
1893,1772,121,1124,648,2005,1377,403000,1085,808,57.32,42.68,1279,0,12,0,0,0,80,189,133,36,24,62,228,142,268,2862
347,347,0,273,74,1949,913,179900,303,44,87.32,12.68,12,0,12,37,346,23,21,85,0,0,0,224,54,0,0,2863
751,722,29,558,164,1949,996,318300,634,117,84.42,15.58,113,41,115,112,288,0,66,65,0,0,11,85,233,83,108,2864
1109,924,185,782,142,2002,1106,202000,993,116,89.54,10.46,426,73,102,92,65,0,18,12,0,0,111,238,171,160,32,2865
952,903,49,597,306,1989,1247,305100,352,600,36.97,63.03,521,112,120,75,77,0,231,115,27,0,111,0,179,75,62,2866
576,548,28,76,472,1981,1098,245200,152,424,26.39,73.61,151,32,81,249,157,21,306,102,34,0,0,66,90,0,0,2867
785,762,23,137,625,1976,720,20300,73,712,9.30,90.70,69,113,368,117,88,109,468,9,0,0,69,64,0,0,9,2868
1186,723,463,642,81,1983,995,382000,1139,47,96.04,3.96,385,185,204,40,181,0,12,49,11,0,69,107,113,139,261,2869
1182,751,431,743,8,1992,0,346100,980,202,82.91,17.09,436,178,133,118,25,0,0,15,13,0,28,189,257,50,122,2870
640,544,96,279,265,1991,863,98300,159,481,24.84,75.16,455,169,107,12,0,0,167,23,0,0,190,267,27,0,13,2871
829,713,116,687,26,2003,0,257800,677,152,81.66,18.34,324,51,11,37,76,0,0,54,0,9,86,88,173,60,29,2872
484,475,9,352,123,1951,1042,146900,453,31,93.60,6.40,0,0,0,30,521,0,51,0,0,0,32,459,9,0,0,2873
628,628,0,479,149,1989,890,186400,340,288,54.14,45.86,140,153,200,10,61,0,0,9,0,0,49,227,238,11,11,2874
1167,1076,91,831,245,1987,549,171200,829,338,71.04,28.96,472,152,232,186,137,55,257,78,0,0,171,382,100,0,23,2875
320,279,41,279,0,1973,0,179400,207,113,64.69,35.31,96,84,71,37,27,0,16,0,0,0,86,129,39,0,23,2876
607,607,0,462,145,1973,779,191200,578,29,95.22,4.78,78,21,166,68,83,0,7,0,0,0,8,276,115,10,0,2877
596,596,0,340,256,1973,1000,255400,314,282,52.68,47.32,27,66,215,157,200,6,217,55,21,0,64,49,183,58,12,2878
639,380,259,250,130,1994,1032,321400,541,98,84.66,15.34,260,126,121,100,187,0,78,16,0,0,20,110,172,49,113,2879
615,523,92,23,500,1986,1003,0,69,546,11.22,88.78,145,111,117,41,51,0,235,131,0,0,0,10,50,0,18,2880
705,680,25,518,162,1990,877,253700,589,116,83.55,16.45,415,147,76,0,20,0,15,59,0,0,84,152,230,31,0,2881
1031,1031,0,716,315,2004,1396,250300,1031,0,100.00,0.00,635,41,95,14,61,0,11,76,72,9,0,183,356,46,56,2882
580,530,50,133,397,1965,921,350000,241,339,41.55,58.45,271,23,23,56,319,0,198,138,25,0,0,118,123,11,22,2883
476,439,37,213,226,1984,1165,146100,273,203,57.35,42.65,129,50,81,53,8,0,77,4,39,0,49,88,40,11,0,2884
630,522,108,404,118,1987,850,210600,485,145,76.98,23.02,223,84,113,26,157,67,76,13,0,0,29,254,26,4,7,2885
771,771,0,700,71,1996,1403,283900,771,0,100.00,0.00,531,94,105,16,23,0,0,0,0,0,18,73,393,155,89,2886
404,384,20,274,110,1979,1030,346400,310,94,76.73,23.27,160,29,36,131,55,9,73,16,25,0,0,9,159,70,50,2887
388,388,0,170,218,1977,1193,0,120,268,30.93,69.07,61,112,435,64,0,53,340,0,0,0,163,116,0,0,0,2888
858,858,0,488,370,1996,827,234200,580,278,67.60,32.40,454,23,128,20,165,33,249,35,0,0,54,204,138,0,24,2889
600,502,98,246,256,1967,1540,284700,433,167,72.17,27.83,209,115,34,58,161,0,11,157,45,0,0,99,126,114,25,2890
512,434,78,32,402,1954,708,0,165,347,32.23,67.77,81,38,116,41,263,233,140,11,12,0,0,10,9,0,10,2891
497,390,107,144,246,1976,848,201100,219,278,44.06,55.94,135,74,426,111,23,18,343,23,0,0,0,233,37,0,0,2892
208,165,43,97,68,1943,798,80400,208,0,100.00,0.00,0,0,10,0,215,0,24,42,0,0,80,65,14,0,0,2893
490,451,39,412,39,1986,0,299600,476,14,97.14,2.86,195,89,263,82,12,0,0,28,0,0,0,29,245,101,112,2894
394,355,39,158,197,1972,610,75000,199,195,50.51,49.49,45,23,87,52,242,144,61,0,0,0,53,106,0,0,0,2895
423,382,41,382,0,2001,0,249000,423,0,100.00,0.00,164,24,36,50,64,0,0,0,0,0,17,106,126,49,12,2896
338,338,0,251,87,1939,1227,258300,326,12,96.45,3.55,13,0,0,39,313,0,15,76,71,0,0,98,105,0,0,2897
585,585,0,535,50,1977,1931,291600,585,0,100.00,0.00,99,24,331,60,13,0,0,18,45,0,27,85,240,36,40,2898
868,813,55,242,571,1991,1134,182400,219,649,25.23,74.77,651,176,41,27,138,0,355,294,28,17,0,101,134,11,32,2899
442,404,38,307,97,1977,958,415600,279,163,63.12,36.88,86,0,172,154,54,0,57,21,40,13,10,0,11,92,222,2900
406,383,23,131,252,1975,550,181900,182,224,44.83,55.17,105,31,103,48,182,152,109,21,0,0,7,89,18,7,0,2901
1474,1394,80,343,1051,1999,1658,350500,30,1444,2.04,97.96,1018,160,143,137,101,0,173,505,219,53,0,29,227,48,13,2902
870,772,98,158,614,1982,1160,613900,255,615,29.31,70.69,406,14,142,175,132,97,179,172,71,0,0,14,127,85,75,2903
487,487,0,352,135,1969,795,334400,415,72,85.22,14.78,8,47,58,115,231,0,16,16,0,0,21,102,169,63,72,2904
347,316,31,281,35,1992,698,266200,227,120,65.42,34.58,129,52,21,22,93,0,6,0,0,8,54,49,152,0,29,2905
433,433,0,373,60,1975,1659,306800,405,28,93.53,6.47,35,9,226,40,40,0,0,23,50,0,0,31,217,22,0,2906
562,562,0,501,61,1979,1292,345700,488,74,86.83,13.17,179,85,153,32,33,0,6,10,0,0,22,103,91,81,169,2907
810,798,12,649,149,1980,671,207000,527,283,65.06,34.94,140,76,214,43,32,0,12,12,0,0,53,283,120,0,10,2908
884,869,15,730,139,1999,1470,320400,618,266,69.91,30.09,624,52,26,63,26,0,13,16,0,0,0,69,396,122,139,2909
706,706,0,616,90,1991,1591,272500,697,9,98.73,1.27,362,108,107,146,8,0,0,0,0,48,0,19,451,142,71,2910
834,773,61,653,120,1986,1655,357600,521,313,62.47,37.53,130,217,301,0,0,0,0,10,36,0,15,371,114,29,48,2911
362,337,25,256,81,1971,918,164600,300,62,82.87,17.13,87,0,125,71,33,0,8,11,0,0,65,214,18,0,0,2912
495,495,0,325,170,1977,1226,349700,341,154,68.89,31.11,20,98,64,138,0,0,71,26,0,11,0,9,153,50,0,2913
868,790,78,178,612,1990,1154,0,142,726,16.36,83.64,591,151,45,64,243,27,171,365,46,61,0,144,97,0,67,2914
995,913,82,154,759,1947,918,350500,11,984,1.11,98.89,148,53,109,59,458,11,408,164,50,0,0,0,88,32,11,2915
455,438,17,415,23,1982,842,120700,172,283,37.80,62.20,165,100,101,14,71,0,83,0,0,0,186,95,70,9,0,2916
346,313,33,167,146,1943,865,81300,305,41,88.15,11.85,0,11,12,70,203,31,28,3,0,0,124,87,0,0,0,2917
314,240,74,183,57,1957,888,182100,248,66,78.98,21.02,57,62,22,36,115,0,81,17,0,0,0,85,63,35,11,2918
220,220,0,184,36,1966,0,0,155,65,70.45,29.55,65,22,68,64,30,0,31,0,0,0,23,75,50,0,22,2919
351,332,19,243,89,1991,1392,157100,343,8,97.72,2.28,232,70,91,13,0,0,13,30,12,0,0,316,35,0,0,2920
654,607,47,322,285,1954,810,129600,424,230,64.83,35.17,175,0,9,41,467,88,187,115,33,0,53,205,11,0,0,2921
420,411,9,389,22,1977,0,638600,378,42,90.00,10.00,55,92,158,49,53,0,0,12,23,20,0,11,41,76,224,2922
332,332,0,209,123,1955,797,250900,263,69,79.22,20.78,66,11,11,43,200,0,68,11,0,0,0,58,94,0,58,2923
552,467,85,449,18,1967,2750,1535300,533,19,96.56,3.44,98,37,38,159,173,0,0,19,10,24,5,0,5,0,422,2924
387,387,0,332,55,1957,722,192900,367,20,94.83,5.17,0,11,12,33,342,37,19,47,0,0,23,199,63,0,10,2925
144,144,0,134,10,1974,0,203800,144,0,100.00,0.00,11,9,158,91,20,0,0,0,0,0,0,280,9,0,0,2926
698,659,39,545,114,1981,1064,165500,632,66,90.54,9.46,152,63,217,110,121,0,60,50,0,0,84,384,72,0,13,2927
668,606,62,490,116,1957,958,542500,632,36,94.61,5.39,52,65,15,70,391,0,15,14,14,0,0,15,103,120,270,2928
717,697,20,654,43,2002,2413,405700,711,6,99.16,0.84,578,30,41,10,16,0,0,0,15,15,0,60,211,103,235,2929
1010,394,616,394,0,1985,0,244900,969,41,95.94,4.06,179,143,195,211,147,0,48,0,0,0,32,206,149,10,85,2930
610,577,33,486,91,1988,813,341300,556,54,91.15,8.85,288,99,124,0,27,17,33,0,0,0,23,59,123,176,73,2931
1616,1530,86,0,1530,2003,1533,0,0,1616,0.00,100.00,745,71,40,0,358,218,355,253,187,26,0,0,10,0,0,2932
447,410,37,287,123,1939,1871,621700,333,114,74.50,25.50,157,0,0,24,379,0,62,30,21,0,0,0,22,59,188,2933
248,237,11,150,87,1977,645,141100,107,141,43.15,56.85,92,45,24,14,95,15,37,29,0,0,61,77,11,0,29,2934
525,456,69,338,118,1985,1143,382600,512,13,97.52,2.48,184,112,82,55,29,0,12,48,0,0,11,33,109,86,87,2935
576,522,54,164,358,1992,817,191900,234,342,40.63,59.38,227,52,98,93,100,150,94,23,37,0,9,24,65,0,0,2936
614,329,285,131,198,1983,810,0,453,161,73.78,26.22,146,162,73,92,100,11,0,0,0,0,29,147,63,43,14,2937
1291,574,717,513,61,1985,1011,244000,1196,95,92.64,7.36,445,50,202,56,107,0,8,56,0,0,12,91,129,57,116,2938
321,302,19,279,23,1973,1339,260500,292,29,90.97,9.03,60,72,145,105,8,16,77,44,0,0,8,95,123,27,0,2939
202,202,0,174,28,1984,0,168400,174,28,86.14,13.86,0,189,57,32,14,0,0,51,0,0,64,131,0,0,0,2940
408,351,57,199,152,1967,722,140100,257,151,62.99,37.01,14,31,57,16,363,63,84,35,0,0,104,107,0,0,14,2941
442,416,26,376,40,1990,0,248400,350,92,79.19,20.81,150,50,78,30,23,0,0,0,0,0,14,126,113,14,20,2942
541,460,81,339,121,1962,1356,256300,425,116,78.56,21.44,97,46,71,126,168,0,46,37,0,26,31,144,164,19,19,2943
698,654,44,342,312,1960,893,150500,468,230,67.05,32.95,66,99,256,195,225,0,312,66,0,0,49,209,13,12,13,2944
927,898,29,138,760,1978,873,251700,198,729,21.36,78.64,133,119,264,186,37,26,445,126,10,0,0,56,50,0,0,2945
1174,1114,60,1035,79,1986,832,212400,792,382,67.46,32.54,433,216,95,75,180,12,41,68,0,0,64,434,186,40,88,2946
870,771,99,112,659,1988,1261,405600,88,782,10.11,89.89,256,59,84,119,220,0,293,110,78,140,0,8,11,23,21,2947
424,424,0,344,80,1975,2408,709800,424,0,100.00,0.00,79,48,180,48,69,0,0,0,0,6,0,0,14,21,373,2948
502,502,0,448,54,1975,1075,231100,426,76,84.86,15.14,165,129,69,93,181,19,61,94,14,0,0,107,224,17,92,2949
571,549,22,447,102,1986,1246,252900,539,32,94.40,5.60,279,23,134,51,96,0,7,14,0,0,14,169,251,5,0,2950
741,651,90,562,89,1987,1477,243200,648,93,87.45,12.55,422,51,74,44,75,0,78,0,0,0,35,143,240,122,37,2951
578,539,39,309,230,1994,853,229800,382,196,66.09,33.91,194,85,34,86,221,0,40,68,18,66,23,35,262,16,14,2952
461,461,0,399,62,1977,683,125500,103,358,22.34,77.66,146,103,48,0,74,0,8,0,40,0,66,226,31,0,0,2953
423,423,0,414,9,1970,0,282000,416,7,98.35,1.65,168,38,90,80,109,0,0,45,0,0,10,120,125,110,53,2954
372,364,8,229,135,1980,882,33700,52,320,13.98,86.02,189,100,191,49,14,0,134,82,0,0,189,99,3,0,0,2955
633,565,68,0,565,1939,770,0,0,633,0.00,100.00,52,42,58,47,700,292,454,74,0,0,0,0,0,10,9,2956
944,944,0,671,273,1999,1713,270800,510,434,54.03,45.97,864,25,43,48,10,0,0,94,0,8,111,340,213,103,73,2957
1501,1308,193,85,1223,1944,654,318800,51,1450,3.40,96.60,266,0,239,94,703,492,486,75,0,0,0,47,54,0,15,2958
483,404,79,232,172,1976,879,187700,312,171,64.60,35.40,116,92,190,0,0,0,23,50,21,0,21,133,113,12,11,2959
489,489,0,489,0,1953,0,337600,458,31,93.66,6.34,33,10,75,0,451,19,17,15,17,10,15,16,305,123,17,2960
856,729,127,621,108,1991,1750,296100,552,304,64.49,35.51,507,60,86,52,13,0,0,22,0,60,13,158,235,167,52,2961
520,520,0,477,43,1980,0,353500,405,115,77.88,22.12,70,89,132,67,96,0,0,39,0,0,88,9,96,61,56,2962
693,667,26,467,200,1963,1089,186900,581,112,83.84,16.16,165,12,156,289,239,0,81,40,49,0,55,488,90,0,16,2963
616,544,72,454,90,1992,0,528100,569,47,92.37,7.63,267,90,119,110,76,0,0,18,46,0,0,48,99,120,285,2964
575,506,69,434,72,1950,2292,989900,538,37,93.57,6.43,69,109,60,37,391,0,0,12,0,0,23,0,37,19,524,2965
381,353,28,304,49,1986,2140,592300,381,0,100.00,0.00,68,266,0,0,0,0,0,0,0,21,14,11,0,13,275,2966
514,427,87,131,296,1979,1088,116300,145,369,28.21,71.79,47,270,321,21,45,10,253,138,0,0,16,151,9,0,11,2967
1278,1067,211,330,737,1983,721,156400,380,898,29.73,70.27,611,134,90,72,181,0,549,63,49,73,23,164,52,0,33,2968
683,637,46,173,464,1952,978,619100,254,429,37.19,62.81,0,66,38,83,564,104,376,114,16,0,0,31,11,0,99,2969
323,249,74,153,96,1961,709,98700,201,122,62.23,37.77,15,15,59,28,223,29,36,0,0,0,135,66,6,0,0,2970
508,472,36,337,135,1983,1177,142700,237,271,46.65,53.35,156,217,178,143,35,0,0,84,22,0,77,370,101,0,0,2971
845,770,75,271,499,1996,1053,178800,382,463,45.21,54.79,389,236,16,47,16,0,296,114,0,0,13,166,9,0,0,2972
772,680,92,525,155,1990,1125,458900,565,207,73.19,26.81,292,68,0,130,143,0,63,0,25,0,0,41,65,127,200,2973
867,867,0,829,38,1995,1703,414300,859,8,99.08,0.92,613,195,65,0,59,0,0,0,0,0,0,112,276,175,300,2974
567,476,91,308,168,1983,911,192900,394,173,69.49,30.51,234,53,150,42,117,0,103,34,3,0,29,199,94,53,0,2975
489,489,0,244,245,1965,659,102000,352,137,71.98,28.02,197,0,102,16,85,65,122,0,0,0,90,123,0,0,0,2976
389,357,32,350,7,1995,0,420000,389,0,100.00,0.00,238,26,0,38,0,0,0,0,0,0,0,0,97,82,119,2977
906,812,94,408,404,1982,790,204000,516,390,56.95,43.05,227,153,325,53,99,75,319,55,0,0,0,178,103,0,23,2978
739,739,0,449,290,1974,669,137900,499,240,67.52,32.48,191,28,207,236,123,118,83,0,15,0,127,333,9,0,0,2979
1170,628,542,570,58,1993,0,134800,844,326,72.14,27.86,441,61,145,99,67,65,0,0,0,0,210,199,73,0,18,2980
545,445,100,384,61,1992,921,283600,465,80,85.32,14.68,239,17,124,71,0,0,0,13,0,0,0,29,301,58,50,2981
507,507,0,294,213,1954,967,334400,294,213,57.99,42.01,45,17,43,81,323,0,123,127,10,0,0,101,110,23,6,2982
529,461,68,375,86,1984,1150,230400,470,59,88.85,11.15,133,145,75,37,39,0,10,19,20,0,0,62,104,17,179,2983
1966,1874,92,1182,692,0,1325,246100,1145,821,58.24,41.76,1174,12,25,0,0,26,0,91,21,0,10,370,414,161,83,2984
785,725,60,377,348,1987,993,272100,403,382,51.34,48.66,182,29,79,21,255,21,288,76,10,5,0,29,81,39,0,2985
224,166,58,108,58,1949,623,133300,184,40,82.14,17.86,45,0,0,35,204,62,0,0,0,0,45,142,0,0,0,2986
343,292,51,237,55,1986,1094,244100,259,84,75.51,24.49,98,37,93,10,61,0,10,32,0,0,13,72,108,28,9,2987
236,226,10,198,28,1991,0,168800,162,74,68.64,31.36,156,27,9,61,0,0,9,30,41,0,10,102,61,0,0,2988
702,652,50,513,139,1977,1016,215200,587,115,83.62,16.38,225,152,241,80,95,48,88,33,0,0,31,181,207,67,80,2989
1044,976,68,780,196,1993,1271,251300,727,317,69.64,30.36,448,182,118,57,71,0,31,11,4,0,34,329,172,39,102,2990
429,404,25,151,253,1960,946,254200,237,192,55.24,44.76,0,46,22,93,205,11,102,8,0,0,0,116,92,9,0,2991
417,406,11,139,267,1973,697,146400,148,269,35.49,64.51,33,125,231,72,113,81,172,0,9,25,97,104,0,11,0,2992
1011,1011,0,673,338,1984,1610,243500,618,393,61.13,38.87,131,435,183,79,105,86,0,124,68,16,0,140,327,65,27,2993
967,967,0,902,65,1999,1345,303300,886,81,91.62,8.38,514,47,119,40,28,0,47,27,51,30,21,51,317,160,30,2994
697,697,0,564,133,1968,1106,278500,684,13,98.13,1.87,113,26,202,167,142,0,43,53,30,0,15,133,307,34,8,2995
468,455,13,323,132,1956,1296,116800,468,0,100.00,0.00,16,28,36,41,295,0,58,28,0,0,132,149,22,0,11,2996
302,302,0,256,46,1986,0,348200,269,33,89.07,10.93,77,164,48,41,27,0,0,11,0,0,48,10,97,36,103,2997
609,609,0,555,54,1996,1639,199000,349,260,57.31,42.69,399,81,66,0,0,0,43,0,0,0,64,356,41,23,0,2998
593,593,0,338,255,1974,859,268600,302,291,50.93,49.07,40,194,71,230,108,16,29,55,27,0,15,199,220,58,24,2999
753,733,20,625,108,1982,1183,229800,568,185,75.43,24.57,217,125,362,14,10,0,60,0,17,6,41,173,288,16,30,3000
355,355,0,190,165,1962,516,171200,229,126,64.51,35.49,39,8,58,71,149,13,103,0,0,0,71,104,18,9,7,3001
505,455,50,285,170,1968,1350,217500,440,65,87.13,12.87,17,22,206,272,49,15,109,35,22,0,16,231,78,0,6,3002
458,458,0,224,234,1988,1398,292900,308,150,67.25,32.75,218,261,134,0,12,0,103,43,68,0,41,111,180,67,12,3003
461,376,85,298,78,1984,625,209400,415,46,90.02,9.98,170,78,41,0,93,0,17,0,0,0,0,146,83,55,67,3004
676,651,25,583,68,1991,0,410100,620,56,91.72,8.28,195,186,48,0,32,0,49,0,32,0,18,0,123,14,207,3005
993,949,44,514,435,1992,1069,168500,435,558,43.81,56.19,461,186,150,20,50,18,190,35,17,9,224,153,164,29,0,3006
1290,1094,196,310,784,2005,2113,444800,28,1262,2.17,97.83,750,0,0,0,78,36,113,108,62,202,0,0,12,16,11,3007
986,838,148,264,574,1988,1294,194400,492,494,49.90,50.10,579,119,79,183,13,11,150,338,107,41,0,184,142,0,0,3008
700,700,0,526,174,1965,1130,347700,601,99,85.86,14.14,79,37,162,254,126,0,65,68,0,0,0,95,186,94,117,3009
674,630,44,189,441,1975,802,217900,220,454,32.64,67.36,191,132,132,34,96,52,150,36,0,0,0,149,29,0,0,3010
557,557,0,510,47,1980,0,185500,388,169,69.66,30.34,184,99,175,48,59,0,31,0,0,0,23,283,171,5,33,3011
520,503,17,33,470,1942,800,0,69,451,13.27,86.73,198,75,10,9,298,114,214,140,14,0,0,0,0,0,19,3012
262,262,0,164,98,1949,1046,152300,262,0,100.00,0.00,14,0,14,82,157,0,67,0,0,0,54,108,0,14,0,3013
773,685,88,236,449,1962,589,113900,315,458,40.75,59.25,0,41,164,92,218,200,182,10,0,0,52,71,0,0,0,3014
668,658,10,467,191,2003,1464,360800,606,62,90.72,9.28,415,33,15,0,95,0,0,46,30,37,44,22,210,91,78,3015
671,671,0,649,22,1964,0,488900,671,0,100.00,0.00,28,8,163,186,306,0,0,0,29,24,12,0,138,367,121,3016
639,484,155,322,162,1959,1272,260800,582,57,91.08,8.92,79,64,21,35,230,0,21,23,0,24,0,183,83,0,64,3017
577,523,54,186,337,1991,1278,318200,120,457,20.80,79.20,199,140,55,42,27,0,22,199,7,16,0,64,77,5,73,3018
782,658,124,536,122,1989,1310,272200,616,166,78.77,21.23,267,112,148,98,77,0,70,28,0,0,53,179,153,21,55,3019
399,373,26,281,92,1981,1875,692200,249,150,62.41,37.59,105,91,70,40,78,0,73,17,40,33,10,0,0,0,211,3020
808,736,72,28,708,1973,705,0,85,723,10.52,89.48,184,233,445,58,111,47,840,0,0,0,80,0,13,0,0,3021
319,186,133,85,101,1943,581,132800,181,138,56.74,43.26,18,2,58,13,309,36,63,0,0,0,30,115,30,0,7,3022
761,761,0,731,30,1997,0,304000,731,30,96.06,3.94,349,130,0,24,0,0,0,14,0,0,0,45,183,108,153,3023
563,505,58,312,193,1950,1078,143600,521,42,92.54,7.46,59,0,68,56,212,0,28,14,0,0,25,228,54,0,0,3024
755,695,60,120,575,1978,788,318900,164,591,21.72,78.28,151,171,286,201,0,144,380,12,28,0,0,40,82,16,28,3025
807,437,370,314,123,1980,883,351500,658,149,81.54,18.46,269,132,176,22,155,0,29,7,8,0,11,214,143,21,137,3026
463,345,118,316,29,1981,0,204900,259,204,55.94,44.06,244,92,66,0,21,0,0,0,0,0,10,253,98,39,12,3027
806,690,116,498,192,1987,790,159300,477,329,59.18,40.82,193,53,191,47,219,12,120,14,0,0,72,209,75,0,88,3028
489,437,52,345,92,1979,780,245800,339,150,69.33,30.67,92,119,213,10,20,0,54,40,0,0,0,24,141,80,115,3029
858,684,174,210,474,1966,661,119300,266,592,31.00,69.00,437,46,66,42,455,238,420,42,0,20,88,107,19,6,0,3030
674,598,76,486,112,1986,1549,226700,646,28,95.85,4.15,131,218,112,19,31,0,0,11,0,0,0,57,368,0,49,3031
445,426,19,330,96,1958,1929,427300,445,0,100.00,0.00,4,0,0,203,244,0,9,14,0,6,20,10,225,96,59,3032
636,636,0,545,91,1987,1199,260400,555,81,87.26,12.74,185,170,187,21,29,11,67,31,32,0,0,134,219,54,28,3033
554,539,15,466,73,1977,1589,654300,481,73,86.82,13.18,180,121,34,62,310,38,60,37,39,0,0,0,54,124,339,3034
470,408,62,274,134,1943,738,136700,413,57,87.87,12.13,48,0,18,46,259,32,42,5,0,0,123,133,0,0,0,3035
498,481,17,380,101,1986,878,208500,474,24,95.18,4.82,300,23,44,52,130,0,64,26,10,0,4,208,153,13,23,3036
337,310,27,208,102,1997,670,163100,123,214,36.50,63.50,73,34,66,62,29,21,2,0,0,0,89,39,2,7,31,3037
292,292,0,227,65,2004,882,176200,269,23,92.12,7.88,348,0,0,0,0,0,0,28,0,0,0,320,0,0,0,3038
1421,1286,135,267,1019,1961,565,526800,19,1402,1.34,98.66,322,244,50,18,496,426,286,51,0,22,0,11,19,26,184,3039
473,473,0,343,130,1972,1650,404800,401,72,84.78,15.22,55,81,127,8,230,0,0,59,0,0,0,136,136,94,76,3040
444,396,48,0,396,1980,835,0,28,416,6.31,93.69,62,14,104,62,0,58,174,10,0,0,0,0,0,0,0,3041
629,588,41,485,103,1975,974,177200,462,167,73.45,26.55,174,39,97,25,224,0,59,57,0,0,38,143,124,40,23,3042
702,702,0,598,104,1992,1026,248700,547,155,77.92,22.08,275,121,67,25,71,0,28,0,0,14,19,122,231,44,66,3043
843,784,59,721,63,1996,1517,414100,762,81,90.39,9.61,666,135,72,35,51,0,0,38,0,0,54,150,201,168,293,3044
502,420,82,328,92,1991,1362,247000,397,105,79.08,20.92,239,38,39,54,39,0,0,0,0,0,0,165,103,38,89,3045
870,846,24,195,651,1959,1337,541700,154,716,17.70,82.30,156,45,90,80,477,0,356,188,62,0,0,36,100,15,0,3046
539,532,7,504,28,1986,2611,539100,531,8,98.52,1.48,98,359,10,8,27,0,0,0,0,23,0,0,25,83,371,3047
708,634,74,247,387,1983,679,207400,309,399,43.64,56.36,141,127,175,42,145,80,125,40,0,0,131,155,87,12,0,3048
455,416,39,362,54,1982,0,349200,375,80,82.42,17.58,362,28,5,55,57,0,47,13,0,11,0,101,130,32,100,3049
2053,1846,207,1327,519,2000,860,321500,1606,447,78.23,21.77,1302,51,107,14,68,0,105,13,0,0,57,350,371,185,293,3050
1353,761,592,649,112,1997,732,205500,1209,144,89.36,10.64,609,281,242,65,5,0,106,21,0,0,33,310,304,22,70,3051
1115,350,765,291,59,1978,0,153400,746,369,66.91,33.09,228,189,164,47,211,32,84,0,0,0,47,174,39,13,0,3052
560,480,80,423,57,1984,1034,300400,384,176,68.57,31.43,209,61,185,0,150,0,0,0,0,0,148,140,41,113,109,3053
326,326,0,317,9,1988,0,220600,228,98,69.94,30.06,276,20,74,13,39,0,14,9,0,0,60,147,65,39,75,3054
308,308,0,215,93,1959,1380,270300,300,8,97.40,2.60,13,8,6,54,147,0,0,0,11,20,0,43,130,24,0,3055
182,182,0,77,105,1939,1407,322500,119,63,65.38,34.62,9,0,29,0,168,0,75,9,0,45,0,15,33,0,29,3056
841,791,50,579,212,1975,1439,289400,772,69,91.80,8.20,270,25,116,92,205,0,24,0,85,0,34,96,263,25,93,3057
375,353,22,344,9,2001,0,384600,360,15,96.00,4.00,129,18,29,90,58,0,0,15,0,0,13,55,79,81,27,3058
831,790,41,592,198,1992,1373,169400,775,56,93.26,6.74,465,54,24,50,66,0,0,48,0,0,8,373,182,18,8,3059
478,465,13,288,177,1944,1063,382100,332,146,69.46,30.54,27,16,7,37,315,19,88,0,25,0,0,20,59,104,47,3060
774,664,110,596,68,1978,1553,561300,774,0,100.00,0.00,210,118,231,95,102,27,9,44,0,0,11,48,221,28,268,3061
408,370,38,370,0,1976,0,378300,307,101,75.25,24.75,101,34,196,51,25,0,10,72,16,0,0,35,41,31,155,3062
469,376,93,246,130,1997,792,43000,110,359,23.45,76.55,101,93,28,14,11,0,0,0,0,0,135,29,33,0,25,3063
939,848,91,399,449,1987,1020,239700,387,552,41.21,58.79,381,171,82,162,50,13,144,240,20,0,11,45,200,36,41,3064
506,506,0,370,136,1948,1370,282700,485,21,95.85,4.15,51,68,17,22,385,0,9,49,81,21,0,90,199,25,16,3065
292,292,0,233,59,1999,3101,744000,292,0,100.00,0.00,201,14,16,14,0,0,0,0,0,0,0,0,0,0,245,3066
688,573,115,223,350,1956,921,140500,387,301,56.25,43.75,7,69,131,152,358,18,292,98,6,0,0,118,38,0,0,3067
712,684,28,505,179,1989,1072,298100,495,217,69.52,30.48,339,82,94,38,115,0,32,6,31,0,2,164,219,67,60,3068
486,462,24,235,227,1985,954,186200,386,100,79.42,20.58,306,8,164,31,76,0,71,136,0,0,10,336,11,0,0,3069
425,425,0,380,45,1987,2050,436600,405,20,95.29,4.71,193,79,21,24,48,0,0,0,0,0,0,50,48,32,196,3070
1283,1071,212,743,328,1988,1331,227000,907,376,70.69,29.31,629,215,152,124,85,14,32,90,104,0,22,278,436,100,95,3071
431,431,0,423,8,1981,0,224700,431,0,100.00,0.00,67,150,156,25,0,0,10,81,0,0,0,140,147,0,20,3072
928,716,212,613,103,1986,806,266100,755,173,81.36,18.64,356,165,216,23,132,63,32,16,0,0,60,218,186,83,107,3073
669,419,250,237,182,1981,932,470400,431,238,64.42,35.58,207,117,148,66,84,37,56,72,12,0,17,12,27,53,191,3074
895,876,19,739,137,2002,1112,384200,746,149,83.35,16.65,554,29,87,0,18,0,0,0,0,14,0,182,303,70,119,3075
344,325,19,125,200,1942,672,137500,206,138,59.88,40.12,10,0,9,7,326,74,30,48,8,0,0,132,44,9,0,3076
894,756,138,57,699,1962,863,341700,192,702,21.48,78.52,112,11,58,110,590,22,513,101,0,0,11,41,92,37,10,3077
1245,1234,11,194,1040,1978,745,197100,250,995,20.08,79.92,120,436,321,285,0,174,619,30,0,27,0,85,46,0,0,3078
332,332,0,160,172,1973,881,187100,171,161,51.51,48.49,35,10,84,116,96,12,0,46,0,0,18,248,0,0,0,3079
382,382,0,304,78,1939,869,153400,366,16,95.81,4.19,0,16,8,0,455,0,106,80,0,0,24,269,0,0,0,3080
680,673,7,629,44,1986,0,239000,654,26,96.18,3.82,219,131,117,13,36,0,0,15,30,0,0,140,269,48,0,3081
331,299,32,224,75,2003,1957,295500,164,167,49.55,50.45,161,10,0,0,11,0,0,0,12,0,0,52,84,0,0,3082
569,535,34,468,67,1984,1368,395200,521,48,91.56,8.44,287,125,150,39,21,0,11,28,22,0,0,76,130,128,217,3083
371,251,120,202,49,1978,1015,218400,291,80,78.44,21.56,109,26,89,37,197,26,48,0,0,0,38,148,37,4,41,3084
500,466,34,350,116,1984,1301,235000,421,79,84.20,15.80,84,280,137,10,42,0,11,0,0,0,27,210,223,21,9,3085
315,315,0,259,56,1939,1226,252600,315,0,100.00,0.00,0,0,0,13,262,0,0,45,0,0,0,73,115,42,0,3086
566,566,0,520,46,1966,1611,975500,556,10,98.23,1.77,87,45,87,205,89,0,0,8,11,0,0,8,8,8,470,3087
1096,967,129,471,496,1991,1898,494100,156,940,14.23,85.77,517,50,154,107,133,0,107,121,62,43,0,13,72,67,412,3088
767,651,116,498,153,1980,1027,276900,567,200,73.92,26.08,188,106,210,52,75,0,18,30,0,0,99,86,146,59,133,3089
395,395,0,381,14,1994,0,261500,373,22,94.43,5.57,178,12,64,26,40,0,25,10,11,0,0,95,149,30,0,3090
472,456,16,399,57,1978,0,361000,442,30,93.64,6.36,32,64,177,28,207,0,6,0,0,32,0,25,143,119,183,3091
1903,955,948,719,236,1993,1150,164800,1677,226,88.12,11.88,708,497,234,55,24,0,151,33,0,0,0,348,61,37,12,3092
486,436,50,337,99,1972,1131,275200,469,17,96.50,3.50,57,42,88,88,262,0,29,35,23,0,0,89,181,85,57,3093
529,497,32,255,242,1984,649,155800,332,197,62.76,37.24,169,81,156,14,102,14,85,43,0,0,121,259,0,0,0,3094
358,358,0,305,53,1977,776,225700,285,73,79.61,20.39,59,25,135,0,82,20,38,11,0,0,109,95,13,15,0,3095
856,767,89,584,183,1986,831,269500,610,246,71.26,28.74,232,108,118,15,228,15,27,20,0,0,67,260,120,120,64,3096
465,439,26,366,73,1990,1182,190500,335,130,72.04,27.96,257,50,77,117,25,0,10,30,0,0,25,205,94,20,32,3097
447,447,0,331,116,1992,1369,244500,429,18,95.97,4.03,316,121,19,13,0,0,13,30,0,0,33,85,282,21,5,3098
126,74,52,71,3,1978,0,268300,126,0,100.00,0.00,65,0,9,22,14,0,18,9,7,0,0,0,8,54,6,3099
1492,1440,52,596,844,2001,1712,283200,1013,479,67.90,32.10,993,54,38,0,147,0,17,246,205,31,0,207,368,76,32,3100
438,392,46,367,25,1969,0,603500,395,43,90.18,9.82,108,151,22,73,310,0,74,0,63,0,0,78,16,21,412,3101
517,459,58,378,81,1991,0,261100,411,106,79.50,20.50,189,117,35,65,25,0,22,49,0,0,0,88,71,54,44,3102
746,681,65,532,149,2001,1567,243400,746,0,100.00,0.00,391,0,20,66,73,0,35,15,25,0,20,109,233,25,45,3103
405,405,0,405,0,1975,0,221000,405,0,100.00,0.00,33,68,197,62,0,0,0,0,24,0,0,104,184,0,0,3104
888,872,16,611,261,1973,913,172700,776,112,87.39,12.61,350,30,181,51,236,27,272,22,0,0,64,367,51,18,18,3105
409,387,22,349,38,1988,640,166500,305,104,74.57,25.43,88,100,103,56,20,37,20,0,0,0,133,89,36,14,9,3106
305,281,24,199,82,1942,1332,165200,305,0,100.00,0.00,28,0,0,0,151,0,0,63,0,0,0,82,16,0,11,3107
555,522,33,180,342,1952,906,275000,340,215,61.26,38.74,67,9,0,137,427,9,174,53,0,0,10,177,95,10,50,3108
551,496,55,449,47,1992,0,368100,399,152,72.41,27.59,134,141,132,40,71,0,3,0,31,51,53,65,58,58,110,3109
1453,893,560,728,165,1990,858,255600,989,464,68.07,31.93,569,160,296,76,109,10,31,13,0,0,16,99,145,118,79,3110
1063,955,108,798,157,1965,905,181600,846,217,79.59,20.41,77,69,223,402,388,0,15,158,17,0,36,734,145,8,16,3111
966,905,61,379,526,1983,831,115600,195,771,20.19,79.81,232,260,255,46,147,25,470,0,0,11,129,198,46,10,0,3112
1351,1268,83,1071,197,1995,1070,250500,1125,226,83.27,16.73,143,162,160,50,347,0,42,6,0,0,30,305,213,0,49,3113
416,416,0,310,106,1976,1230,259100,218,198,52.40,47.60,0,54,315,98,43,11,73,31,0,0,10,204,111,27,11,3114
501,443,58,337,106,1979,1071,156900,494,7,98.60,1.40,77,66,284,89,13,13,36,30,43,0,35,282,36,9,0,3115
381,269,112,269,0,1989,0,346700,296,85,77.69,22.31,118,81,54,42,90,0,6,0,0,0,45,78,84,15,9,3116
562,507,55,489,18,1994,1550,254400,449,113,79.89,20.11,280,29,30,10,75,8,0,0,0,0,65,192,129,30,0,3117
605,566,39,359,207,1975,891,256400,416,189,68.76,31.24,48,57,350,33,92,0,182,48,25,0,0,105,113,0,0,3118
449,405,44,405,0,1991,0,194300,439,10,97.77,2.23,487,89,107,0,13,0,0,6,0,0,0,642,48,0,0,3119
346,317,29,231,86,1993,0,194800,323,23,93.35,6.65,190,30,127,12,0,0,0,46,0,0,54,120,65,0,0,3120
522,410,112,186,224,1939,776,86000,460,62,88.12,11.88,0,0,13,39,547,44,191,0,0,0,38,214,0,0,0,3121
452,452,0,353,99,1988,1104,360900,299,153,66.15,33.85,156,32,56,78,20,0,11,0,0,0,23,39,145,39,53,3122
405,358,47,269,89,1974,883,178300,240,165,59.26,40.74,30,13,343,113,23,15,15,65,0,0,0,202,190,23,0,3123
798,708,90,259,449,1939,869,271600,438,360,54.89,45.11,95,16,135,36,547,55,201,16,0,0,11,186,145,11,0,3124
532,532,0,431,101,1958,882,420600,429,103,80.64,19.36,0,6,156,11,268,0,71,51,28,23,12,0,130,52,37,3125
259,221,38,47,174,1978,989,0,61,198,23.55,76.45,23,57,169,31,0,14,114,0,0,0,35,42,18,0,0,3126
629,580,49,471,109,1991,663,185400,378,251,60.10,39.90,310,19,165,5,127,0,57,0,9,0,99,226,145,12,13,3127
523,478,45,408,70,1981,874,239100,427,96,81.64,18.36,51,279,105,0,56,21,26,0,0,0,54,82,198,71,39,3128
375,350,25,0,350,1993,1327,0,278,97,74.13,25.87,192,53,44,0,47,0,55,230,17,0,0,0,0,0,0,3129
581,524,57,467,57,1947,0,1301500,560,21,96.39,3.61,124,31,54,40,349,0,0,14,0,0,0,0,14,0,530,3130
780,714,66,657,57,1999,0,620700,581,199,74.49,25.51,801,26,18,14,0,0,0,0,0,9,11,42,145,34,603,3131
847,814,33,615,199,1976,871,231900,776,71,91.62,8.38,246,72,89,24,470,0,12,136,33,0,48,378,245,37,12,3132
541,541,0,268,273,1939,1798,576800,378,163,69.87,30.13,20,18,35,66,479,0,45,111,79,63,0,20,30,0,227,3133
529,474,55,383,91,1981,681,162500,261,268,49.34,50.66,176,57,174,26,75,6,49,0,0,0,95,126,136,47,36,3134
801,769,32,674,95,1982,1220,193300,789,12,98.50,1.50,458,54,275,8,39,0,24,0,0,0,26,607,78,10,21,3135
764,496,268,392,104,1976,531,142600,678,86,88.74,11.26,138,120,179,57,193,16,76,0,0,0,125,189,73,14,18,3136
523,473,50,339,134,1977,946,427200,486,37,92.93,7.07,145,107,166,42,38,0,29,0,0,0,3,44,123,51,234,3137
622,571,51,190,381,1947,955,162100,300,322,48.23,51.77,0,17,27,52,456,44,187,71,0,16,16,129,9,0,0,3138
349,349,0,267,82,1975,872,153900,213,136,61.03,38.97,43,12,149,150,120,0,157,0,12,0,25,187,35,0,0,3139
621,598,23,591,7,1979,0,276600,621,0,100.00,0.00,123,18,408,56,0,0,0,19,0,0,0,184,290,75,10,3140
842,765,77,152,613,1989,1043,139900,130,712,15.44,84.56,358,189,178,221,0,0,524,176,15,0,12,124,0,0,0,3141
521,482,39,402,80,1981,911,145300,330,191,63.34,36.66,131,173,93,0,58,46,90,24,0,0,10,196,26,10,0,3142
424,410,14,318,92,1976,769,229200,271,153,63.92,36.08,110,108,163,47,134,0,100,0,0,0,122,190,40,29,67,3143
427,341,86,244,97,1993,0,370400,367,60,85.95,14.05,163,93,42,17,59,12,35,0,12,0,0,44,127,68,76,3144
785,746,39,710,36,2003,1690,291400,761,24,96.94,3.06,558,18,0,0,7,0,0,0,0,0,12,226,214,61,8,3145
350,350,0,263,87,1988,1590,257200,350,0,100.00,0.00,105,158,14,30,0,0,0,0,0,0,0,42,178,87,0,3146
858,833,25,734,99,1995,1594,330300,858,0,100.00,0.00,413,0,147,56,85,0,0,30,12,0,12,132,262,116,105,3147
647,647,0,396,251,1978,833,271500,489,158,75.58,24.42,195,182,341,55,79,52,361,88,44,0,9,79,146,9,8,3148
267,246,21,232,14,1980,0,233900,254,13,95.13,4.87,36,8,63,21,50,4,35,20,0,0,13,37,27,0,42,3149
799,799,0,739,60,1985,0,254800,788,11,98.62,1.38,440,191,218,16,9,0,0,13,39,0,30,239,480,46,27,3150
429,413,16,306,107,1978,827,245400,291,138,67.83,32.17,69,52,21,70,180,0,61,0,0,0,8,86,149,39,17,3151
894,770,124,629,141,1966,821,170300,709,185,79.31,20.69,197,0,42,172,295,28,94,66,0,0,71,279,54,0,12,3152
554,554,0,364,190,1963,907,115900,502,52,90.61,9.39,53,45,116,19,315,146,69,7,11,0,24,241,0,0,0,3153
433,399,34,388,11,1968,0,392400,433,0,100.00,0.00,17,0,74,218,85,0,0,0,46,0,0,0,84,168,96,3154
348,348,0,305,43,1991,0,348200,335,13,96.26,3.74,127,29,0,124,137,0,52,52,0,0,14,114,66,49,70,3155
515,515,0,439,76,1968,2250,998700,433,82,84.08,15.92,157,11,0,110,172,0,34,0,0,14,0,39,15,0,334,3156
443,388,55,373,15,1983,0,299000,428,15,96.61,3.39,134,21,65,101,0,0,0,0,0,0,9,38,111,75,88,3157
344,344,0,232,112,1977,434,30600,121,223,35.17,64.83,65,68,86,6,59,26,45,0,0,0,147,50,16,0,0,3158
839,839,0,321,518,1958,803,126500,616,223,73.42,26.58,131,163,52,56,642,36,338,31,16,15,52,439,18,0,0,3159
800,649,151,207,442,1975,938,0,182,618,22.75,77.25,153,236,188,101,147,105,238,152,13,0,56,88,44,22,0,3160
449,393,56,178,215,1939,643,319400,271,178,60.36,39.64,58,17,61,10,324,84,128,31,0,0,17,27,55,46,41,3161
287,287,0,205,82,1975,0,249500,248,39,86.41,13.59,148,12,65,18,19,0,0,0,0,0,13,79,49,9,25,3162
602,579,23,328,251,1971,758,127600,553,49,91.86,8.14,128,108,87,75,200,130,51,22,0,0,97,136,73,0,0,3163
429,429,0,422,7,2002,0,279100,429,0,100.00,0.00,378,73,31,0,14,0,12,0,0,0,0,153,309,10,0,3164
608,556,52,126,430,1985,869,0,132,476,21.71,78.29,236,121,156,42,102,38,310,55,0,0,36,88,25,0,0,3165
724,642,82,560,82,1988,1066,230400,627,97,86.60,13.40,235,189,218,120,111,61,31,67,0,0,38,216,295,52,57,3166
521,471,50,280,191,1939,1184,476800,429,92,82.34,17.66,15,7,10,28,437,0,11,0,28,0,18,25,75,46,136,3167
633,633,0,396,237,2002,987,277300,409,224,64.61,35.39,274,40,111,85,0,0,24,17,44,0,41,11,204,65,45,3168
322,322,0,268,54,1993,0,234700,277,45,86.02,13.98,102,45,55,31,11,0,11,0,39,0,0,60,98,12,24,3169
529,507,22,226,281,1974,800,162700,257,272,48.58,51.42,41,18,413,26,11,62,149,22,0,0,0,268,8,0,0,3170
281,276,5,276,0,1980,0,137500,155,126,55.16,44.84,128,63,85,0,75,0,0,0,0,0,117,116,105,0,13,3171
256,220,36,151,69,1939,1168,300700,241,15,94.14,5.86,0,0,10,0,262,10,11,28,0,0,0,35,116,52,8,3172
515,477,38,463,14,1973,0,855400,515,0,100.00,0.00,8,17,204,204,45,0,30,0,0,7,11,0,0,0,430,3173
582,564,18,471,93,1976,1009,166900,523,59,89.86,10.14,129,3,167,85,103,0,54,12,0,0,155,148,44,26,0,3174
635,590,45,572,18,2004,0,702000,594,41,93.54,6.46,428,51,16,0,15,0,0,34,0,11,0,0,0,0,436,3175
494,421,73,14,407,1974,649,0,64,430,12.96,87.04,99,41,224,61,293,218,243,102,29,23,0,12,11,0,0,3176
549,495,54,441,54,1959,1199,267700,515,34,93.81,6.19,109,18,32,46,354,14,29,0,0,73,10,153,122,67,72,3177
663,663,0,464,199,1979,691,167400,406,257,61.24,38.76,187,0,52,14,231,0,15,14,0,0,156,165,75,10,16,3178
262,262,0,129,133,1991,1284,207800,207,55,79.01,20.99,57,48,184,0,0,0,23,36,11,0,0,121,34,52,0,3179
629,566,63,110,456,1979,897,421700,102,527,16.22,83.78,298,0,85,34,167,0,275,153,41,14,0,0,0,0,0,3180
635,500,135,446,54,1978,1568,229100,564,71,88.82,11.18,213,150,122,102,204,10,11,28,8,0,38,187,227,67,21,3181
554,546,8,169,377,1980,544,110700,322,232,58.12,41.88,67,29,62,34,339,49,140,0,0,0,81,167,6,0,0,3182
532,450,82,362,88,1989,996,190300,442,90,83.08,16.92,192,52,51,49,84,20,35,0,0,0,61,132,123,8,0,3183
670,670,0,594,76,1976,889,256300,628,42,93.73,6.27,122,70,311,78,72,0,97,0,0,0,0,151,270,41,77,3184
265,221,44,107,114,1947,791,163400,191,74,72.08,27.92,9,83,64,0,109,0,156,0,0,0,0,59,9,0,41,3185
880,768,112,680,88,1995,784,386900,774,106,87.95,12.05,444,69,69,10,205,0,22,60,0,0,10,95,210,102,165,3186
336,303,33,259,44,1975,1319,249300,336,0,100.00,0.00,56,0,202,50,0,0,7,0,31,0,0,109,122,25,14,3187
279,279,0,218,61,1961,914,149100,233,46,83.51,16.49,68,19,78,51,216,73,57,54,0,0,29,194,0,25,0,3188
339,339,0,253,86,1967,1587,259300,258,81,76.11,23.89,177,64,11,42,74,0,49,68,0,0,10,32,151,9,0,3189
1764,1598,166,1005,593,2002,1089,184100,750,1014,42.52,57.48,1091,62,135,17,0,44,249,192,13,18,131,427,110,25,0,3190
524,496,28,261,235,1953,795,81800,382,142,72.90,27.10,49,74,66,45,334,127,227,0,0,0,174,17,0,0,0,3191
557,507,50,62,445,1987,904,0,162,395,29.08,70.92,10,9,210,54,150,72,135,19,11,0,23,20,0,0,0,3192
541,498,43,337,161,1960,974,217700,433,108,80.04,19.96,62,29,19,45,224,0,63,29,9,0,19,57,151,0,0,3193
744,600,144,210,390,1984,745,216900,292,452,39.25,60.75,29,307,204,34,0,46,143,46,0,0,22,137,82,0,0,3194
550,481,69,288,193,1984,1168,254900,289,261,52.55,47.45,189,121,99,76,192,169,118,42,0,0,0,121,131,96,0,3195
613,582,31,342,240,1978,1313,226700,444,169,72.43,27.57,233,94,252,42,30,0,111,64,0,0,0,144,145,56,49,3196
375,345,30,210,135,1969,797,249300,336,39,89.60,10.40,36,59,13,27,129,0,37,0,27,0,0,80,96,0,9,3197
330,298,32,181,117,1939,733,146300,241,89,73.03,26.97,18,9,0,15,244,30,68,15,0,0,18,133,0,0,0,3198
1145,1030,115,74,956,2002,1127,9999,53,1092,4.63,95.37,717,125,107,0,100,0,389,367,39,0,0,41,0,0,0,3199
804,776,28,684,92,2001,1005,293000,594,210,73.88,26.12,620,75,8,13,37,0,0,9,41,0,0,189,179,177,117,3200
869,844,25,728,116,1994,0,162900,530,339,60.99,39.01,519,233,106,0,10,0,32,32,0,0,348,236,135,32,0,3201
1076,1076,0,1033,43,1989,0,239000,1076,0,100.00,0.00,504,243,192,49,12,0,40,29,0,12,18,343,420,65,73,3202
625,537,88,444,93,1991,1295,314100,529,96,84.64,15.36,266,86,147,51,23,0,35,17,17,9,33,163,150,33,64,3203
226,200,26,156,44,1983,1257,131100,158,68,69.91,30.09,77,83,62,40,182,0,78,0,0,0,178,135,14,0,0,3204
513,459,54,376,83,1950,854,119200,435,78,84.80,15.20,12,13,95,16,416,0,121,0,0,0,87,228,13,0,10,3205
641,583,58,440,143,1980,953,166000,444,197,69.27,30.73,154,115,170,59,115,18,76,28,0,0,114,205,76,0,13,3206
338,338,0,321,17,1988,0,568800,332,6,98.22,1.78,132,104,19,28,0,0,0,0,0,12,15,0,38,66,152,3207
528,528,0,510,18,1982,0,536200,528,0,100.00,0.00,273,88,147,28,0,0,0,0,0,17,0,27,26,56,359,3208
559,534,25,451,83,1980,857,243500,446,113,79.79,20.21,225,26,116,129,88,0,76,59,0,0,12,158,107,46,126,3209
648,591,57,258,333,1983,784,264800,255,393,39.35,60.65,326,100,25,67,75,33,156,53,0,13,0,75,144,33,6,3210
973,884,89,771,113,1993,1021,379600,863,110,88.69,11.31,458,107,147,113,55,0,19,20,0,0,42,63,265,192,279,3211
673,635,38,446,189,2000,1304,258200,371,302,55.13,44.87,320,60,25,17,32,12,18,0,0,0,103,74,119,27,101,3212
1043,891,152,654,237,1987,1078,195700,765,278,73.35,26.65,365,290,275,7,79,17,160,70,0,0,63,425,171,12,11,3213
730,710,20,642,68,1990,856,275400,585,145,80.14,19.86,199,59,148,97,165,0,63,38,0,0,42,207,68,112,25,3214
666,611,55,192,419,1982,1438,408800,136,530,20.42,79.58,149,138,91,45,136,0,179,141,55,0,0,8,0,16,72,3215
701,632,69,99,533,1980,1013,247600,139,562,19.83,80.17,91,71,142,136,97,23,331,53,0,0,13,11,65,0,11,3216
644,579,65,208,371,1994,591,229300,481,163,74.69,25.31,253,0,88,11,113,83,48,10,0,0,11,173,129,11,0,3217
469,275,194,234,41,1991,775,172100,391,78,83.37,16.63,102,148,161,63,92,0,0,0,0,0,41,253,79,13,16,3218
487,459,28,293,166,1939,786,203100,368,119,75.56,24.44,24,0,24,15,293,15,44,0,0,0,0,156,51,40,13,3219
178,164,14,59,105,1960,0,155100,83,95,46.63,53.37,0,28,67,5,12,15,25,0,0,0,15,57,0,0,0,3220
514,367,147,274,93,1987,883,381400,449,65,87.35,12.65,132,112,104,29,194,13,42,13,0,0,13,84,108,60,58,3221
413,381,32,314,67,1977,788,218100,303,110,73.37,26.63,125,129,43,38,116,0,81,19,0,0,16,178,68,21,59,3222
510,510,0,487,23,1958,2281,345400,500,10,98.04,1.96,28,0,0,54,483,0,0,26,0,0,0,40,256,146,86,3223
516,516,0,322,194,1964,744,316500,399,117,77.33,22.67,54,75,40,27,192,3,21,24,14,9,0,102,124,81,10,3224
601,556,45,346,210,1958,871,146700,463,138,77.04,22.96,126,22,141,14,214,19,105,0,46,0,74,232,17,0,0,3225
591,556,35,497,59,1973,1268,418800,582,9,98.48,1.52,140,66,216,102,0,0,13,0,0,12,7,10,152,47,180,3226
991,900,91,538,362,1999,1104,329800,602,389,60.75,39.25,412,31,21,27,42,15,39,24,0,0,0,30,296,92,0,3227
647,619,28,559,60,1990,1306,282400,500,147,77.28,22.72,323,96,118,22,35,0,29,11,0,0,0,214,185,52,18,3228
470,419,51,382,37,1971,1139,473500,425,45,90.43,9.57,85,29,117,98,219,0,11,0,0,0,0,43,87,102,251,3229
705,657,48,614,43,1988,0,209400,662,43,93.90,6.10,231,157,364,15,0,0,0,26,0,0,71,429,105,30,45,3230
230,219,11,158,61,1978,992,141700,217,13,94.35,5.65,22,97,42,0,137,58,0,15,0,0,76,87,14,0,0,3231
615,528,87,340,188,1939,936,487900,380,235,61.79,38.21,14,12,86,110,464,0,118,18,57,17,0,74,90,73,140,3232
485,485,0,430,55,1971,0,296000,485,0,100.00,0.00,49,13,262,78,54,14,0,0,34,16,0,37,206,14,72,3233
294,294,0,194,100,1958,1105,346800,294,0,100.00,0.00,0,65,52,94,179,0,0,0,43,0,0,30,137,170,10,3234
486,486,0,396,90,1959,1260,249100,431,55,88.68,11.32,34,24,15,145,146,0,0,116,12,0,0,5,197,34,0,3235
381,283,98,138,145,2000,834,241200,156,225,40.94,59.06,83,55,113,10,0,0,120,64,0,0,13,40,0,0,24,3236
1280,1239,41,197,1042,1976,1439,278700,101,1179,7.89,92.11,171,295,387,309,63,0,85,564,144,0,32,45,94,46,23,3237
424,409,15,304,105,1975,1440,575700,325,99,76.65,23.35,16,84,145,153,10,0,0,91,0,13,22,7,17,30,160,3238
711,563,148,93,470,1976,763,0,116,595,16.32,83.68,124,112,192,179,77,23,388,44,22,0,11,0,0,3,36,3239
1750,755,995,664,91,1980,719,156300,1394,356,79.66,20.34,676,229,336,213,175,13,85,0,10,0,74,342,39,13,130,3240
558,553,5,339,214,1962,699,130900,393,165,70.43,29.57,96,32,36,144,203,16,120,0,0,0,138,175,10,7,12,3241
492,429,63,303,126,1970,753,104800,277,215,56.30,43.70,55,79,131,28,184,0,100,29,0,0,171,39,55,0,0,3242
658,501,157,452,49,1995,1029,469900,639,19,97.11,2.89,318,70,152,81,107,0,20,26,0,0,19,120,147,16,213,3243
462,462,0,408,54,1993,2466,531000,462,0,100.00,0.00,141,68,63,93,0,0,12,0,32,0,0,13,31,8,244,3244
437,400,37,300,100,1944,1395,475000,357,80,81.69,18.31,85,0,0,0,296,0,0,32,0,0,0,0,53,72,224,3245
529,451,78,323,128,1982,838,283500,300,229,56.71,43.29,158,120,87,48,153,0,52,10,9,0,13,87,182,24,29,3246
613,570,43,395,175,1983,1139,259400,400,213,65.25,34.75,263,112,177,0,130,0,37,17,0,0,24,181,177,167,41,3247
265,256,9,229,27,1962,1406,279900,259,6,97.74,2.26,0,11,148,74,78,0,0,6,12,0,0,82,121,18,25,3248
275,269,6,173,96,1979,1200,233700,173,102,62.91,37.09,78,109,86,11,9,0,66,0,0,0,19,42,75,56,0,3249
690,559,131,299,260,1955,938,183600,396,294,57.39,42.61,130,42,59,186,184,58,275,63,9,0,0,128,68,0,0,3250
276,254,22,231,23,2001,1375,185200,242,34,87.68,12.32,187,0,0,8,24,0,0,0,0,0,8,142,27,0,0,3251
493,361,132,38,323,1939,966,114600,367,126,74.44,25.56,55,0,48,31,328,199,52,32,0,0,18,131,30,0,0,3252
1122,1122,0,304,818,1980,1312,253900,389,733,34.67,65.33,302,188,339,165,271,38,382,273,42,0,0,204,135,14,14,3253
508,441,67,361,80,1973,1129,321200,491,17,96.65,3.35,233,45,79,75,117,8,57,32,0,0,0,36,132,36,196,3254
1034,974,60,607,367,1992,1331,331200,790,244,76.40,23.60,507,160,163,74,32,0,162,105,0,0,0,107,302,59,126,3255
862,862,0,266,596,1949,1069,348000,259,603,30.05,69.95,18,86,149,114,470,0,306,198,0,0,0,82,80,36,77,3256
1422,1217,205,992,225,1991,1282,346900,1097,325,77.14,22.86,711,183,214,0,12,0,52,84,0,0,41,63,313,120,319,3257
397,338,59,252,86,1964,741,132400,280,117,70.53,29.47,192,23,47,34,156,4,22,0,0,0,101,195,49,0,0,3258
386,386,0,285,101,1966,1186,240200,386,0,100.00,0.00,147,46,0,88,71,0,0,11,94,0,0,16,195,23,13,3259
814,814,0,693,121,1997,0,309100,708,106,86.98,13.02,523,49,68,16,133,0,23,16,15,0,41,51,347,64,165,3260
297,272,25,148,124,1943,548,68600,224,73,75.42,24.58,7,12,38,19,247,34,44,3,0,0,136,35,8,0,4,3261
757,724,33,505,219,1993,1084,258500,570,187,75.30,24.70,434,101,133,63,9,13,80,0,8,0,10,257,255,29,65,3262
968,968,0,651,317,1981,1410,271800,630,338,65.08,34.92,543,16,77,143,166,13,50,0,26,0,0,235,335,128,109,3263
564,516,48,425,91,1990,1273,302300,214,350,37.94,62.06,202,132,266,82,0,0,138,84,12,26,51,80,80,121,65,3264
746,666,80,548,118,1993,1434,268000,534,212,71.58,28.42,135,64,118,29,20,0,55,24,0,0,41,132,42,0,49,3265
659,628,31,464,164,1968,1066,263500,588,71,89.23,10.77,155,47,58,191,211,0,27,27,35,0,0,159,229,29,87,3266
561,448,113,241,207,1981,1588,532200,359,202,63.99,36.01,40,22,48,14,357,18,14,42,55,0,0,15,22,116,199,3267
1176,1133,43,368,765,1984,1329,407500,125,1051,10.63,89.37,153,203,276,148,356,10,258,215,107,21,32,52,72,72,141,3268
734,677,57,549,128,1985,950,257000,559,175,76.16,23.84,257,148,191,8,74,0,35,55,0,0,8,105,158,140,79,3269
359,303,56,219,84,1977,1185,230700,299,60,83.29,16.71,41,25,72,164,30,13,0,0,0,0,27,161,74,23,0,3270
514,514,0,0,514,1974,769,0,0,514,0.00,100.00,37,97,286,99,38,89,352,0,0,0,0,0,0,0,0,3271
483,468,15,428,40,1984,0,282900,483,0,100.00,0.00,34,443,157,15,0,0,128,44,0,0,0,126,248,56,47,3272
639,614,25,532,82,1988,2186,483000,606,33,94.84,5.16,160,379,0,0,0,0,0,25,20,45,0,0,95,80,240,3273
633,583,50,184,399,1988,1188,266100,245,388,38.70,61.30,197,151,118,76,27,11,177,129,10,0,0,41,107,9,17,3274
1422,1293,129,604,689,1986,818,76900,380,1042,26.72,73.28,472,322,209,137,270,172,399,52,0,0,381,199,14,0,0,3275
409,379,30,237,142,1949,1053,148600,365,44,89.24,10.76,51,7,39,58,294,3,59,84,27,0,19,144,41,0,0,3276
875,750,125,307,443,1977,1311,491500,175,700,20.00,80.00,218,348,393,144,0,13,124,334,141,43,0,67,51,41,115,3277
492,469,23,142,327,1976,783,302800,168,324,34.15,65.85,186,160,44,139,132,131,211,73,16,0,0,47,108,58,3,3278
354,327,27,80,247,1948,799,214300,152,202,42.94,57.06,40,7,0,0,280,0,89,38,37,0,0,44,70,7,0,3279
959,959,0,167,792,1974,639,135100,154,805,16.06,83.94,175,68,550,131,86,190,543,0,0,0,70,20,0,0,0,3280
437,421,16,139,282,1982,1173,159100,185,252,42.33,57.67,282,0,8,52,134,0,178,117,0,0,0,91,15,16,0,3281
815,671,144,569,102,1988,1369,318500,669,146,82.09,17.91,408,74,111,17,51,0,48,13,0,0,15,41,270,50,166,3282
429,404,25,320,84,1983,0,262300,322,107,75.06,24.94,188,55,95,89,63,7,4,71,12,0,21,49,258,12,53,3283
409,358,51,233,125,1976,723,124000,249,160,60.88,39.12,46,29,110,41,173,38,81,0,0,0,74,142,15,0,0,3284
590,590,0,522,68,1993,1348,254000,584,6,98.98,1.02,454,216,115,13,0,0,0,27,0,0,0,346,290,50,28,3285
271,249,22,169,80,1976,1311,0,182,89,67.16,32.84,35,56,152,44,18,0,10,10,0,0,66,76,82,9,8,3286
435,414,21,311,103,1950,888,161000,377,58,86.67,13.33,34,111,9,31,179,0,12,64,4,0,0,113,110,0,0,3287
922,833,89,463,370,1975,1064,238700,485,437,52.60,47.40,196,255,149,110,234,11,272,149,0,10,0,131,276,91,4,3288
732,705,27,462,243,1991,1273,275500,449,283,61.34,38.66,359,298,100,0,0,0,0,229,0,25,0,156,234,43,0,3289
727,687,40,548,139,1986,1221,340700,710,17,97.66,2.34,164,245,62,10,187,0,25,0,45,0,0,105,253,82,118,3290
407,351,56,209,142,1944,626,73900,266,141,65.36,34.64,43,10,180,78,252,68,158,39,0,22,123,80,9,0,0,3291
1158,1113,45,718,395,0,995,270300,892,266,77.03,22.97,960,16,12,9,0,0,54,33,53,44,15,212,227,139,68,3292
467,467,0,337,130,1970,1784,332800,437,30,93.58,6.42,80,62,27,68,47,0,7,12,0,0,24,16,142,67,16,3293
545,530,15,481,49,1967,3501,1239700,545,0,100.00,0.00,102,62,85,81,134,0,7,0,0,28,0,12,0,6,374,3294
774,774,0,608,166,1976,853,196300,512,262,66.15,33.85,296,104,185,90,48,42,100,14,0,0,88,243,165,13,33,3295
741,572,169,287,285,1943,1073,103600,623,118,84.08,15.92,0,0,50,26,675,0,165,6,0,0,172,328,0,0,0,3296
268,242,26,234,8,1965,0,281000,264,4,98.51,1.49,0,0,35,166,84,0,0,23,0,0,7,46,201,8,0,3297
457,435,22,352,83,1981,1066,276300,457,0,100.00,0.00,165,162,133,3,0,0,0,0,16,6,8,121,261,51,0,3298
970,913,57,399,514,1995,1232,251300,141,829,14.54,85.46,728,141,25,0,0,7,80,218,37,0,0,192,208,27,66,3299
592,545,47,406,139,1975,1170,191800,486,106,82.09,17.91,70,49,246,128,26,14,59,25,8,0,25,214,149,7,0,3300
1436,815,621,532,283,1974,957,175000,891,545,62.05,37.95,417,114,214,114,349,0,141,0,0,0,40,437,142,6,13,3301
621,574,47,535,39,1993,1330,283300,596,25,95.97,4.03,205,72,120,36,110,0,51,0,27,0,0,166,214,50,35,3302
297,289,8,189,100,1951,804,215700,247,50,83.16,16.84,27,0,16,0,238,24,77,0,0,0,0,39,100,10,31,3303
526,521,5,428,93,1992,931,227100,373,153,70.91,29.09,268,47,11,56,74,0,27,24,27,0,38,98,220,8,7,3304
257,257,0,145,112,1955,779,106000,205,52,79.77,20.23,31,20,17,64,192,43,59,13,0,0,33,125,17,0,0,3305
1987,1912,75,1495,417,2004,1644,266000,1949,38,98.09,1.91,1669,47,8,20,32,9,76,116,110,43,0,211,819,254,101,3306
471,471,0,438,33,1977,1313,310700,458,13,97.24,2.76,45,101,16,38,110,0,0,7,0,0,12,71,125,33,62,3307
506,360,146,226,134,1974,584,194000,321,185,63.44,36.56,107,23,171,72,122,61,33,0,0,0,132,53,41,0,0,3308
521,508,13,400,108,1974,1106,261100,463,58,88.87,11.13,111,82,114,39,145,0,18,13,8,17,12,107,169,82,54,3309
460,352,108,266,86,1980,0,124000,278,182,60.43,39.57,188,77,128,33,118,76,46,0,0,9,66,210,23,29,13,3310
480,480,0,418,62,1969,1120,218200,381,99,79.38,20.63,40,43,137,155,63,17,24,184,0,0,13,56,91,25,13,3311
594,573,21,567,6,1970,0,986900,594,0,100.00,0.00,49,78,187,201,147,0,0,0,0,9,0,8,0,0,645,3312
533,491,42,329,162,1973,1680,364500,445,88,83.49,16.51,56,95,153,175,0,0,0,59,65,0,0,75,114,137,0,3313
304,282,22,267,15,1982,0,192900,248,56,81.58,18.42,157,11,88,26,0,12,33,0,0,0,0,66,48,20,21,3314
354,333,21,197,136,1952,1286,162200,354,0,100.00,0.00,63,0,8,28,221,0,23,47,10,0,10,173,0,31,0,3315
862,846,16,538,308,1977,1649,153000,742,120,86.08,13.92,192,0,234,260,80,21,34,17,97,7,29,453,108,0,0,3316
630,608,22,530,78,1996,1357,230600,630,0,100.00,0.00,428,24,19,20,36,0,0,52,6,0,9,246,129,37,33,3317
584,453,131,394,59,1983,0,314600,458,126,78.42,21.58,171,59,56,40,50,16,11,17,0,0,0,101,67,43,110,3318
566,403,163,376,27,1983,720,175700,270,296,47.70,52.30,295,24,86,82,140,0,0,0,0,0,82,328,59,14,0,3319
777,746,31,268,478,1971,1304,274400,576,201,74.13,25.87,60,52,127,62,329,0,87,59,19,0,0,217,108,15,90,3320
420,374,46,335,39,1975,946,252000,346,74,82.38,17.62,81,79,68,78,78,0,33,50,0,0,31,34,121,84,31,3321
593,560,33,487,73,1992,1069,232000,528,65,89.04,10.96,322,154,18,23,101,0,7,23,0,0,117,235,139,51,39,3322
518,509,9,384,125,1961,1331,266000,496,22,95.75,4.25,70,42,17,106,328,0,37,68,13,0,0,29,176,162,34,3323
338,312,26,296,16,1987,0,302000,296,42,87.57,12.43,166,68,41,0,22,0,0,13,15,9,0,56,128,40,36,3324
880,783,97,509,274,1984,1029,226000,682,198,77.50,22.50,214,210,178,147,78,0,101,139,55,0,56,211,181,16,10,3325
457,443,14,187,256,1939,1614,464700,338,119,73.96,26.04,11,57,41,56,209,0,82,25,11,0,0,17,27,96,116,3326
441,441,0,276,165,1967,936,215900,311,130,70.52,29.48,92,26,49,178,116,49,24,27,0,0,0,79,244,23,15,3327
999,961,38,559,402,2002,1552,305100,646,353,64.66,35.34,415,25,110,85,73,0,0,133,93,0,28,40,267,85,37,3328
381,346,35,146,200,1987,708,235600,142,239,37.27,62.73,92,88,110,32,68,10,109,0,0,0,0,91,78,0,41,3329
319,319,0,291,28,1985,0,190300,274,45,85.89,14.11,142,42,75,24,16,19,0,14,0,0,12,166,61,8,19,3330
491,446,45,366,80,1973,1316,200600,355,136,72.30,27.70,23,260,199,48,96,45,85,23,0,0,68,186,56,0,13,3331
269,269,0,235,34,1980,0,181900,119,150,44.24,55.76,183,175,100,0,6,0,28,69,0,0,9,136,128,22,0,3332
707,707,0,608,99,1948,1243,584800,707,0,100.00,0.00,59,0,61,16,504,0,0,14,28,57,0,13,94,90,329,3333
59,53,6,21,32,1962,973,235000,46,13,77.97,22.03,22,0,15,2,62,13,27,9,0,0,0,10,11,0,6,3334
1016,874,142,74,800,1983,914,162500,44,972,4.33,95.67,230,341,313,110,45,16,671,166,11,14,0,54,44,0,0,3335
492,411,81,269,142,1990,0,203800,317,175,64.43,35.57,215,72,139,16,78,0,65,114,59,0,51,143,80,0,0,3336
387,359,28,299,60,1993,0,440100,270,117,69.77,30.23,190,57,58,7,51,0,0,10,0,0,0,19,87,48,130,3337
465,424,41,173,251,1967,339,265300,143,322,30.75,69.25,11,12,183,0,200,129,82,0,0,0,12,39,29,8,107,3338
440,440,0,323,117,1983,1086,275400,362,78,82.27,17.73,155,153,134,46,53,0,44,58,9,11,0,67,286,17,32,3339
613,584,29,370,214,1939,794,207300,520,93,84.83,15.17,34,34,53,16,504,21,82,57,31,0,0,252,147,31,0,3340
294,294,0,224,70,1949,896,257800,264,30,89.80,10.20,22,17,23,30,292,9,83,37,22,0,0,78,129,12,14,3341
506,413,93,287,126,1959,1290,196600,465,41,91.90,8.10,22,34,50,79,340,15,111,60,9,0,0,80,224,26,0,3342
327,293,34,205,88,1939,1053,138100,317,10,96.94,3.06,22,0,0,0,281,0,27,0,0,0,9,187,64,16,0,3343
639,541,98,298,243,1959,1299,567500,265,374,41.47,58.53,44,60,86,37,433,0,89,159,0,94,0,0,62,47,62,3344
617,584,33,444,140,1994,961,237500,505,112,81.85,18.15,211,30,56,23,146,9,43,37,0,0,9,204,97,25,33,3345
413,381,32,92,289,1993,1091,243200,182,231,44.07,55.93,213,45,44,33,118,0,124,155,6,2,4,38,54,3,13,3346
384,384,0,302,82,1973,1823,234800,384,0,100.00,0.00,0,40,245,46,0,0,0,37,14,0,0,55,215,0,0,3347
1313,1124,189,913,211,1974,1524,433600,1196,117,91.09,8.91,369,91,352,214,214,0,141,120,0,0,0,137,302,151,371,3348
1055,1025,30,904,121,2006,1506,210100,1025,30,97.16,2.84,419,13,0,43,0,0,0,9,0,0,13,255,144,8,13,3349
967,914,53,522,392,1984,944,349000,311,656,32.16,67.84,268,94,374,102,180,49,147,98,0,17,85,79,109,75,197,3350
798,717,81,637,80,1981,1789,470000,740,58,92.73,7.27,255,130,139,69,180,0,41,64,0,12,0,46,110,182,232,3351
340,295,45,255,40,1989,1643,1095600,340,0,100.00,0.00,151,116,18,43,31,0,14,42,0,0,0,0,29,41,233,3352
497,487,10,402,85,1969,935,430200,432,65,86.92,13.08,66,60,187,32,128,11,23,48,0,0,18,42,119,55,157,3353
562,547,15,510,37,1990,746,166200,439,123,78.11,21.89,332,163,88,46,110,0,101,0,0,0,46,316,109,43,52,3354
263,217,46,127,90,1950,575,91600,199,64,75.67,24.33,50,10,35,12,146,5,72,11,0,0,33,76,19,0,0,3355
578,490,88,343,147,1974,888,227700,464,114,80.28,19.72,170,58,249,80,58,0,59,66,0,0,0,205,204,22,38,3356
576,461,115,275,186,1985,593,318700,408,168,70.83,29.17,145,36,55,15,104,15,0,0,0,0,37,69,66,54,64,3357
625,586,39,143,443,1990,1017,61900,74,551,11.84,88.16,335,141,134,0,93,0,93,166,12,43,215,57,12,0,0,3358
1129,1056,73,954,102,1992,1395,257300,995,134,88.13,11.87,653,64,201,125,55,0,67,34,9,0,36,341,451,95,42,3359
967,828,139,507,321,1999,1122,275400,739,228,76.42,23.58,637,53,84,60,47,0,95,35,12,0,11,257,270,92,49,3360
1205,722,483,578,144,1989,890,204300,881,324,73.11,26.89,466,185,265,136,143,41,44,4,0,0,95,247,97,27,102,3361
526,477,49,330,147,1999,1350,259400,347,179,65.97,34.03,306,28,64,44,144,12,77,36,23,0,8,69,172,116,47,3362
770,620,150,216,404,1983,971,235700,267,503,34.68,65.32,71,351,158,62,91,48,127,36,12,70,32,152,133,0,30,3363
573,498,75,415,83,2001,1401,248000,573,0,100.00,0.00,377,17,126,16,0,0,0,0,11,0,0,181,231,113,0,3364
610,610,0,303,307,1977,876,527300,208,402,34.10,65.90,145,70,109,183,69,0,74,61,20,23,0,74,27,46,157,3365
504,504,0,374,130,1955,1097,199300,349,155,69.25,30.75,0,27,40,124,228,0,151,7,11,0,0,113,137,0,0,3366
423,401,22,235,166,1971,830,130300,334,89,78.96,21.04,42,94,67,68,225,129,111,0,0,0,71,136,0,0,0,3367
403,403,0,280,123,1956,798,173900,336,67,83.37,16.63,12,0,27,9,307,0,15,64,0,0,21,43,55,14,80,3368
474,441,33,381,60,1987,991,216300,456,18,96.20,3.80,187,71,115,0,0,0,0,17,11,0,9,195,113,18,10,3369
806,763,43,129,634,1981,860,287100,205,601,25.43,74.57,0,274,295,147,146,255,327,29,21,0,0,34,83,19,0,3370
844,844,0,621,223,1984,921,191500,658,186,77.96,22.04,263,63,231,18,107,0,93,29,0,0,42,207,216,23,18,3371
662,632,30,407,225,1975,1502,223000,594,68,89.73,10.27,113,15,114,119,43,0,25,0,36,0,11,132,184,0,16,3372
631,576,55,261,315,1975,792,191800,362,269,57.37,42.63,55,134,342,164,0,0,238,83,0,0,0,174,166,0,0,3373
599,554,45,385,169,1969,810,100500,513,86,85.64,14.36,98,31,96,54,292,82,106,10,0,0,155,150,4,0,5,3374
808,784,24,0,784,1977,1450,0,586,222,72.52,27.48,154,165,306,96,150,0,37,327,106,0,0,0,0,0,0,3375
336,327,9,257,70,1963,1179,234700,295,41,87.80,12.20,28,24,78,53,226,0,125,42,17,0,3,67,136,7,0,3376
698,675,23,630,45,1963,1014,185400,698,0,100.00,0.00,100,22,138,121,359,16,102,18,14,0,57,316,109,49,0,3377
673,652,21,413,239,1972,1129,255500,564,109,83.80,16.20,272,29,93,74,91,0,94,2,0,0,25,198,170,53,17,3378
851,851,0,809,42,2004,0,552000,842,9,98.94,1.06,393,67,23,22,0,0,10,0,0,0,13,29,10,92,281,3379
446,446,0,300,146,1984,0,561700,390,56,87.44,12.56,149,111,87,17,282,26,57,106,33,0,0,16,134,68,144,3380
539,492,47,106,386,1969,972,178600,131,408,24.30,75.70,244,0,55,143,194,45,149,64,0,0,11,142,25,0,0,3381
1121,1121,0,329,792,1992,1446,343900,312,809,27.83,72.17,502,264,191,108,64,0,143,387,109,0,0,58,90,43,175,3382
779,701,78,492,209,1981,912,205800,573,206,73.56,26.44,375,180,168,43,159,67,89,59,18,0,153,314,71,11,22,3383
351,324,27,195,129,1965,273,263200,231,120,65.81,34.19,23,0,54,231,49,93,0,13,38,0,0,66,80,27,10,3384
578,527,51,265,262,1990,1085,213400,297,281,51.38,48.62,216,48,74,38,9,0,74,70,27,0,0,78,136,0,0,3385
633,633,0,389,244,1968,0,429900,427,206,67.46,32.54,83,117,78,358,0,0,209,57,0,49,0,15,101,104,51,3386
801,754,47,307,447,1939,854,233100,474,327,59.18,40.82,166,22,30,88,548,58,370,76,58,0,0,120,55,17,17,3387
849,821,28,249,572,1982,608,89700,302,547,35.57,64.43,247,37,241,101,284,199,100,66,0,0,301,203,11,0,0,3388
967,883,84,695,188,1992,1274,209900,717,250,74.15,25.85,433,238,236,50,45,47,27,0,39,0,39,409,171,0,0,3389
13,0,13,0,0,0,0,0,13,0,100.00,0.00,0,36,0,32,0,0,32,36,0,0,0,0,0,0,0,3390
478,440,38,7,433,1983,1206,0,444,34,92.89,7.11,139,29,10,106,66,0,73,241,0,0,0,0,0,0,0,3391
545,464,81,314,150,1981,867,348600,380,165,69.72,30.28,106,57,72,17,228,0,0,28,0,0,11,22,193,53,102,3392
200,168,32,129,39,1947,1125,127500,192,8,96.00,4.00,0,0,64,0,270,0,92,22,0,0,49,100,0,0,0,3393
449,340,109,275,65,1985,736,240500,375,74,83.52,16.48,67,63,40,7,86,0,26,0,0,0,0,56,54,14,0,3394
590,562,28,249,313,1968,752,204100,352,238,59.66,40.34,60,30,172,105,126,15,182,0,0,0,34,156,72,7,0,3395
631,601,30,490,111,1986,807,222900,346,285,54.83,45.17,180,209,84,21,3,0,74,22,0,0,109,82,98,30,68,3396
543,493,50,354,139,1971,569,157600,397,146,73.11,26.89,83,19,200,29,143,59,126,0,0,0,54,185,8,25,0,3397
425,233,192,210,23,1971,0,235000,388,37,91.29,8.71,176,0,71,27,130,0,0,0,0,0,9,82,74,8,53,3398
544,504,40,64,440,1970,1005,118800,379,165,69.67,30.33,116,212,120,51,14,0,263,48,14,0,42,134,12,0,0,3399
300,276,24,228,48,0,1321,220700,276,24,92.00,8.00,198,34,29,0,0,0,0,0,0,0,0,203,35,11,12,3400
577,544,33,452,92,1967,1198,241800,542,35,93.93,6.07,57,32,145,99,287,0,0,13,0,0,31,372,154,27,10,3401
292,273,19,77,196,1989,987,260400,252,40,86.30,13.70,132,76,93,0,6,18,0,0,35,0,22,97,111,11,3,3402
528,500,28,279,221,1988,2083,769500,235,293,44.51,55.49,245,98,43,111,94,9,0,10,93,121,0,22,67,0,222,3403
355,244,111,82,162,1963,548,300000,192,163,54.08,45.92,34,29,58,69,216,18,216,7,10,0,45,39,9,0,34,3404
849,789,60,456,333,1997,1346,195800,658,191,77.50,22.50,371,53,250,52,37,8,13,57,33,0,95,287,211,0,21,3405
1410,1192,218,174,1018,1939,802,386700,89,1321,6.31,93.69,24,62,116,123,850,189,596,81,13,0,0,24,12,0,57,3406
870,848,22,678,170,1992,1162,219800,673,197,77.36,22.64,470,233,31,10,0,0,11,28,0,0,21,297,305,58,0,3407
838,838,0,316,522,1988,1115,261600,157,681,18.74,81.26,201,87,117,28,255,0,199,151,17,23,16,40,59,56,65,3408
439,421,18,387,34,1956,0,178000,439,0,100.00,0.00,0,0,0,26,319,0,13,17,0,0,36,209,27,0,0,3409
263,263,0,242,21,1976,0,186800,167,96,63.50,36.50,54,47,119,45,114,0,26,0,0,0,53,65,149,11,37,3410
352,307,45,120,187,1966,913,190900,192,160,54.55,45.45,19,86,94,111,123,12,254,32,33,0,0,102,0,0,0,3411
392,358,34,323,35,1976,2679,1531300,392,0,100.00,0.00,46,69,59,48,119,0,0,0,4,8,2,8,5,0,253,3412
685,618,67,397,221,1972,814,198400,403,282,58.83,41.17,293,116,104,45,239,0,130,57,0,0,156,348,76,0,14,3413
66,0,66,0,0,1939,0,0,21,45,31.82,68.18,0,0,0,0,77,0,0,0,0,0,0,0,0,0,0,3414
354,287,67,121,166,1965,488,117800,214,140,60.45,39.55,56,24,34,29,237,126,59,6,0,0,60,79,50,0,0,3415
430,362,68,313,49,1959,566,85900,352,78,81.86,18.14,131,13,159,121,137,40,90,0,0,0,133,162,49,0,0,3416
398,386,12,373,13,1985,0,361100,385,13,96.73,3.27,22,353,0,28,0,0,0,0,72,0,9,44,151,49,78,3417
679,633,46,379,254,1978,625,156000,342,337,50.37,49.63,170,129,120,134,204,83,115,8,7,0,151,207,9,0,15,3418
480,466,14,226,240,1972,672,157600,270,210,56.25,43.75,24,9,87,9,192,23,69,0,0,0,74,109,8,0,0,3419
655,602,53,336,266,1977,609,94500,305,350,46.56,53.44,62,28,251,111,67,25,97,0,0,0,174,135,0,0,0,3420
926,804,122,496,308,1980,921,272500,553,373,59.72,40.28,164,138,213,53,193,14,94,0,0,0,63,182,134,0,28,3421
1074,866,208,734,132,1991,2050,460500,994,80,92.55,7.45,427,145,192,61,134,0,44,26,28,10,0,110,159,134,367,3422
417,417,0,206,211,1939,1066,308300,357,60,85.61,14.39,0,0,0,0,364,0,70,53,0,29,0,78,76,16,24,3423
687,665,22,507,158,1974,1207,296500,615,72,89.52,10.48,186,137,74,36,263,0,76,16,0,16,0,65,178,90,187,3424
433,408,25,286,122,1958,1345,190700,433,0,100.00,0.00,53,33,78,54,176,0,37,0,0,0,28,169,88,0,0,3425
190,177,13,160,17,1995,0,0,87,103,45.79,54.21,93,9,67,0,0,46,0,0,0,0,39,32,11,21,0,3426
361,292,69,219,73,1961,1156,227900,311,50,86.15,13.85,44,23,41,118,93,0,0,12,0,0,8,157,86,33,14,3427
326,286,40,159,127,1959,1108,183800,271,55,83.13,16.87,25,0,10,46,305,15,58,24,0,0,0,131,120,38,0,3428
556,514,42,135,379,2004,446,179500,377,179,67.81,32.19,288,0,0,8,8,137,63,13,0,0,0,59,5,0,0,3429
557,527,30,218,309,1939,884,158200,359,198,64.45,35.55,57,45,49,27,418,11,178,82,0,0,11,261,13,7,0,3430
327,311,16,244,67,2000,1261,164900,171,156,52.29,47.71,82,107,57,49,0,0,16,15,0,0,33,231,0,0,0,3431
494,459,35,365,94,1993,1638,199200,480,14,97.17,2.83,404,8,114,8,0,0,0,33,8,0,0,291,202,0,0,3432
568,532,36,267,265,1952,589,115700,321,247,56.51,43.49,0,0,64,83,520,115,107,0,0,0,157,137,0,0,0,3433
598,598,0,412,186,1955,840,110800,483,115,80.77,19.23,6,44,47,55,327,0,106,0,0,0,165,174,23,0,0,3434
547,502,45,352,150,1974,925,0,92,455,16.82,83.18,72,11,172,152,166,31,112,33,0,0,198,45,0,75,0,3435
715,695,20,500,195,1995,976,251500,508,207,71.05,28.95,456,13,112,7,16,0,171,28,0,0,0,186,74,15,38,3436
787,737,50,530,207,2002,981,294100,436,351,55.40,44.60,338,185,103,38,30,11,51,33,0,7,175,237,68,0,102,3437
263,246,17,141,105,1968,792,211300,209,54,79.47,20.53,19,0,71,161,26,0,20,0,0,0,0,69,88,17,9,3438
299,282,17,185,97,1964,971,192600,281,18,93.98,6.02,31,0,19,193,46,0,47,26,0,7,18,80,92,0,19,3439
437,437,0,344,93,1984,1139,320000,372,65,85.13,14.87,189,0,146,16,76,0,0,0,0,0,0,47,194,103,41,3440
378,378,0,378,0,1996,0,309900,372,6,98.41,1.59,265,45,16,0,0,0,0,0,0,0,13,19,110,68,85,3441
266,266,0,194,72,1990,1125,394900,249,17,93.61,6.39,17,68,83,12,87,0,10,0,18,0,11,58,43,108,19,3442
790,732,58,610,122,1989,1000,247200,654,136,82.78,17.22,291,54,148,74,147,19,6,10,9,0,7,267,182,57,136,3443
633,582,51,461,121,1969,589,161400,415,218,65.56,34.44,225,81,349,7,112,0,74,0,0,0,200,363,75,0,0,3444
380,372,8,254,118,1974,771,130900,170,210,44.74,55.26,74,39,163,28,131,35,38,0,0,0,110,173,30,0,15,3445
878,840,38,608,232,1974,719,163900,593,285,67.54,32.46,251,41,67,36,249,0,79,63,11,0,164,220,16,16,25,3446
224,224,0,217,7,1996,0,252900,151,73,67.41,32.59,88,5,54,26,17,0,0,0,0,0,42,55,55,8,16,3447
624,568,56,139,429,1997,940,0,145,479,23.24,76.76,648,8,14,0,14,0,342,148,0,17,0,92,11,0,0,3448
585,514,71,194,320,1972,821,150000,258,327,44.10,55.90,109,63,188,61,65,22,174,11,0,0,51,136,4,0,0,3449
267,267,0,230,37,1964,0,163500,198,69,74.16,25.84,53,35,36,85,76,0,18,0,0,0,23,220,0,0,0,3450
313,313,0,249,64,1971,0,123000,251,62,80.19,19.81,0,0,84,47,321,0,91,65,0,0,90,160,17,0,0,3451
545,521,24,338,183,1945,906,150000,424,121,77.80,22.20,0,7,19,0,483,12,146,38,0,0,35,218,9,0,0,3452
306,279,27,244,35,1985,868,174500,251,55,82.03,17.97,131,82,18,31,19,0,10,9,0,0,22,110,73,0,18,3453
353,353,0,326,27,1977,0,250900,289,64,81.87,18.13,64,97,83,41,110,0,72,0,0,0,56,233,34,0,0,3454
1005,963,42,730,233,1954,792,215900,779,226,77.51,22.49,7,10,128,177,537,37,69,8,0,0,8,503,146,17,20,3455
428,428,0,277,151,1975,997,149900,228,200,53.27,46.73,155,42,109,95,12,0,131,18,0,0,12,252,0,0,0,3456
528,484,44,282,202,1959,669,135600,355,173,67.23,32.77,0,30,28,170,359,87,153,0,0,0,54,232,0,0,0,3457
473,473,0,271,202,1977,960,137400,348,125,73.57,26.43,166,31,112,59,136,64,151,7,0,2,20,214,0,0,0,3458
589,537,52,467,70,1978,0,124600,313,276,53.14,46.86,192,109,234,93,65,0,108,8,0,0,169,336,29,14,0,3459
406,406,0,331,75,1994,0,172500,288,118,70.94,29.06,74,35,134,21,50,0,28,0,0,0,34,181,71,0,0,3460
524,415,109,392,23,1971,800,241600,465,59,88.74,11.26,129,42,54,18,185,3,0,0,9,0,40,147,110,29,29,3461
563,504,59,369,135,1971,858,140200,400,163,71.05,28.95,82,44,66,48,292,45,63,14,0,0,83,205,66,8,3,3462
427,377,50,228,149,1942,740,97000,319,108,74.71,25.29,61,0,59,0,308,31,132,0,0,0,159,83,0,0,0,3463
469,426,43,213,213,1970,835,140200,288,181,61.41,38.59,126,71,88,40,175,31,156,68,0,0,52,144,0,0,0,3464
513,464,49,155,309,1946,632,100300,277,236,54.00,46.00,63,0,12,49,305,104,71,53,0,0,21,78,29,0,0,3465
270,270,0,139,131,1967,953,162900,196,74,72.59,27.41,12,0,54,140,193,12,156,64,0,0,0,167,0,0,0,3466
760,705,55,228,477,1976,969,154600,421,339,55.39,44.61,240,178,226,88,109,34,445,73,0,0,0,180,86,0,11,3467
587,587,0,391,196,1995,1287,199300,536,51,91.31,8.69,298,0,58,83,29,21,67,39,0,0,0,154,133,11,30,3468
700,700,0,149,551,1978,1084,186000,321,379,45.86,54.14,169,294,330,0,0,0,373,220,0,0,0,154,31,0,15,3469
785,767,18,604,163,1996,1188,204500,467,318,59.49,40.51,647,41,124,34,0,0,40,144,19,0,156,165,246,67,0,3470
506,506,0,406,100,1975,950,214000,467,39,92.29,7.71,52,56,69,139,200,40,50,24,0,0,22,169,165,25,0,3471
577,577,0,311,266,1978,1085,257200,389,188,67.42,32.58,37,150,389,11,43,0,167,101,0,10,0,101,177,19,13,3472
915,822,93,333,489,1959,856,152100,460,455,50.27,49.73,63,101,164,71,336,33,331,30,0,0,26,208,43,0,0,3473
431,431,0,209,222,1941,902,223400,321,110,74.48,25.52,0,14,58,25,306,0,147,34,0,0,0,88,69,0,7,3474
780,706,74,357,349,1964,801,211300,532,248,68.21,31.79,129,37,190,104,425,55,427,34,0,0,0,227,137,0,5,3475
503,442,61,380,62,1946,707,153800,503,0,100.00,0.00,70,28,53,49,365,18,131,42,0,9,55,208,28,0,40,3476
834,717,117,306,411,1971,878,111100,396,438,47.48,52.52,130,33,173,56,439,141,131,59,0,0,127,299,29,0,0,3477
410,321,89,236,85,1966,554,153400,280,130,68.29,31.71,83,33,78,16,225,28,3,0,0,0,101,114,33,14,0,3478
1269,1131,138,848,283,1982,786,140100,672,597,52.96,47.04,389,125,222,75,237,43,87,0,0,0,231,356,136,0,29,3479
629,629,0,230,399,1949,531,101900,421,208,66.93,33.07,36,15,83,0,379,96,66,36,0,0,55,169,55,0,0,3480
681,657,24,588,69,1994,0,277100,623,58,91.48,8.52,336,138,160,29,53,0,22,64,0,0,70,195,208,32,53,3481
933,892,41,653,239,1994,1138,207200,845,88,90.57,9.43,599,34,20,14,142,0,6,112,0,0,12,410,225,11,19,3482
1900,1661,239,1211,450,1990,825,185200,1579,321,83.11,16.89,523,148,279,226,255,88,331,67,47,46,64,682,25,0,34,3483
475,475,0,201,274,1960,840,96400,455,20,95.79,4.21,3,0,52,152,313,11,240,6,0,0,156,80,0,0,27,3484
462,457,5,172,285,1976,571,96400,168,294,36.36,63.64,105,136,75,100,35,133,107,28,0,0,86,57,6,0,0,3485
877,801,76,493,308,1974,624,89100,416,461,47.43,52.57,262,154,141,83,211,137,146,0,0,0,231,199,8,0,0,3486
572,572,0,440,132,1987,950,266400,365,207,63.81,36.19,262,66,91,23,107,8,83,0,0,8,104,95,91,17,21,3487
783,708,75,18,690,1971,740,267900,308,475,39.34,60.66,113,55,157,81,234,128,254,82,39,0,0,41,11,0,0,3488
635,635,0,73,562,1965,766,272600,112,523,17.64,82.36,207,0,143,136,68,89,109,73,11,16,13,0,39,0,0,3489
361,319,42,225,94,1973,763,246100,310,51,85.87,14.13,81,29,50,46,151,37,23,12,8,0,16,148,41,18,11,3490
753,699,54,532,167,1975,749,267600,609,144,80.88,19.12,296,30,212,21,302,60,16,56,0,0,88,262,151,80,59,3491
499,421,78,249,172,1939,620,134200,419,80,83.97,16.03,41,15,57,24,313,17,60,31,0,0,112,116,19,3,0,3492
280,225,55,180,45,1972,537,158800,194,86,69.29,30.71,53,0,40,0,122,66,25,0,0,0,13,51,17,0,11,3493
369,361,8,237,124,1988,750,208800,181,188,49.05,50.95,201,19,77,10,29,10,18,0,0,0,95,125,11,0,0,3494
386,384,2,262,122,1939,558,159600,328,58,84.97,15.03,21,21,71,21,288,15,91,0,0,0,90,130,63,0,23,3495
1354,592,762,351,241,1990,783,261900,546,808,40.32,59.68,338,427,308,11,149,0,104,0,0,0,71,179,83,49,9,3496
436,375,61,311,64,1984,750,166700,206,230,47.25,52.75,100,61,81,35,158,6,39,29,0,0,74,92,41,11,4,3497
383,375,8,224,151,1985,0,131600,120,263,31.33,68.67,89,110,85,11,16,44,0,0,0,0,139,81,0,0,0,3498
569,484,85,393,91,1939,567,107900,461,108,81.02,18.98,43,6,60,26,375,34,38,12,3,0,143,159,9,0,0,3499
258,221,37,170,51,1952,675,144600,205,53,79.46,20.54,34,23,27,4,179,13,12,0,0,0,63,104,15,0,17,3500
835,800,35,418,382,1983,902,42400,292,543,34.97,65.03,171,91,196,168,204,47,81,52,15,0,309,188,71,0,0,3501
455,400,55,329,71,1992,1484,229300,438,17,96.26,3.74,319,34,79,22,0,0,0,17,73,0,0,70,177,17,17,3502
475,421,54,421,0,1989,0,390400,448,27,94.32,5.68,199,92,133,0,0,0,0,0,0,0,23,18,117,115,139,3503
395,380,15,349,31,1976,0,226300,395,0,100.00,0.00,60,110,154,0,40,0,15,17,0,0,0,220,112,0,0,3504
582,549,33,479,70,1993,852,408100,570,12,97.94,2.06,226,61,19,94,162,0,0,0,0,0,6,120,73,107,164,3505
540,540,0,143,397,1992,731,72600,75,465,13.89,86.11,196,143,182,42,57,109,171,0,0,0,180,90,45,15,0,3506
686,686,0,624,62,1988,867,360500,610,76,88.92,11.08,268,150,130,33,27,0,0,21,0,0,13,56,296,123,90,3507
331,325,6,293,32,1992,0,396700,300,31,90.63,9.37,170,117,27,0,8,0,0,23,0,0,0,28,60,60,151,3508
937,876,61,820,56,2000,0,345700,824,113,87.94,12.06,745,25,105,33,51,0,18,37,0,12,39,128,175,104,364,3509
918,872,46,582,290,1988,1139,241100,735,183,80.07,19.93,414,45,63,51,188,0,75,96,33,32,0,185,188,68,8,3510
391,391,0,257,134,1980,0,152900,277,114,70.84,29.16,182,34,64,27,0,0,0,30,0,0,84,149,15,17,12,3511
736,697,39,663,34,1989,0,366000,670,66,91.03,8.97,308,117,158,45,28,13,33,0,0,5,18,23,217,100,199,3512
813,775,38,478,297,1974,890,231200,638,175,78.47,21.53,411,58,105,57,256,10,158,60,40,0,0,327,187,32,10,3513
516,433,83,148,285,1960,783,141500,309,207,59.88,40.12,50,97,50,27,309,0,200,0,16,0,0,210,21,0,0,3514
895,867,28,635,232,1997,1239,297200,778,117,86.93,13.07,787,0,29,0,0,0,0,77,53,0,0,162,321,152,22,3515
947,894,53,493,401,1999,1615,253100,736,211,77.72,22.28,689,0,68,0,0,0,14,59,41,0,7,122,405,64,16,3516
593,547,46,477,70,1982,959,313000,520,73,87.69,12.31,260,59,179,10,125,0,29,4,0,0,15,59,130,197,171,3517
989,965,24,791,174,1976,588,160200,729,260,73.71,26.29,263,127,83,66,239,5,84,11,0,0,113,409,20,20,25,3518
108,108,0,99,9,1985,0,0,100,8,92.59,7.41,112,10,23,10,107,14,27,10,0,0,0,41,0,0,24,3519
618,611,7,410,201,1978,748,136100,391,227,63.27,36.73,199,56,221,26,226,40,44,25,0,0,112,387,27,0,12,3520
729,707,22,488,219,1983,726,213900,468,261,64.20,35.80,131,95,132,42,338,36,45,0,0,0,56,270,134,41,28,3521
732,693,39,291,402,1984,915,181000,390,342,53.28,46.72,117,126,203,42,85,0,208,54,9,0,0,224,39,0,0,3522
467,467,0,346,121,1993,1412,191400,467,0,100.00,0.00,334,34,166,0,0,0,47,20,0,0,12,233,184,0,14,3523
372,372,0,343,29,1980,0,259400,372,0,100.00,0.00,148,63,77,24,149,0,23,19,0,0,11,183,144,24,11,3524
935,906,29,556,350,1972,876,201800,701,234,74.97,25.03,199,122,366,120,122,0,336,24,0,0,68,290,211,0,0,3525
1099,1024,75,545,479,1986,1018,216600,833,266,75.80,24.20,406,96,163,135,133,0,235,20,0,21,11,190,209,48,28,3526
499,394,105,302,92,1952,718,118300,408,91,81.76,18.24,65,10,43,19,212,47,27,22,0,0,108,145,0,0,0,3527
534,466,68,432,34,1990,1099,181700,408,126,76.40,23.60,151,90,178,61,50,0,51,4,0,0,34,237,90,31,36,3528
409,315,94,221,94,1976,715,129700,244,165,59.66,40.34,184,18,91,26,164,10,73,0,0,0,130,55,83,0,3,3529
452,429,23,409,20,1956,0,642700,452,0,100.00,0.00,47,28,76,66,368,0,0,0,0,0,16,0,52,56,404,3530
900,853,47,628,225,1991,1426,246900,697,203,77.44,22.56,367,146,171,69,146,0,93,31,0,0,25,145,103,228,137,3531
550,308,242,225,83,1982,944,196700,422,128,76.73,23.27,181,42,138,26,147,38,13,0,0,0,30,143,52,59,9,3532
1046,962,84,498,464,1989,1240,510200,520,526,49.71,50.29,358,529,238,0,0,0,357,146,25,0,0,32,93,48,297,3533
654,478,176,423,55,1988,1058,404600,561,93,85.78,14.22,160,64,105,69,55,16,40,0,0,0,29,57,50,47,109,3534
342,287,55,180,107,1969,1287,228400,321,21,93.86,6.14,71,27,203,93,100,0,110,81,0,0,0,117,31,43,87,3535
614,538,76,427,111,1979,653,114100,407,207,66.29,33.71,206,67,164,17,86,19,24,2,0,0,59,203,88,0,14,3536
806,806,0,740,66,1982,0,337600,765,41,94.91,5.09,212,109,88,84,175,0,0,0,31,29,63,29,244,127,145,3537
602,535,67,479,56,1990,1240,378300,591,11,98.17,1.83,331,59,43,22,163,5,11,36,3,16,3,22,140,158,200,3538
582,582,0,418,164,1983,1573,279000,448,134,76.98,23.02,0,89,93,196,95,0,50,33,0,0,0,73,205,85,15,3539
500,458,42,341,117,1977,759,209000,336,164,67.20,32.80,68,74,198,118,148,0,222,0,0,0,11,197,155,0,9,3540
381,381,0,372,9,1994,0,415000,381,0,100.00,0.00,228,71,30,10,40,0,18,0,0,0,0,81,30,122,128,3541
863,818,45,746,72,1978,864,209600,622,241,72.07,27.93,339,150,207,76,73,77,52,0,0,0,111,309,172,11,40,3542
704,655,49,535,120,1971,753,150300,588,116,83.52,16.48,183,6,142,222,158,103,112,0,24,0,65,353,24,10,0,3543
371,327,44,253,74,1990,1900,247000,371,0,100.00,0.00,146,76,21,159,25,0,0,26,92,17,0,25,98,33,104,3544
260,260,0,243,17,1942,0,181500,230,30,88.46,11.54,0,0,0,11,302,0,0,0,0,0,13,273,14,0,0,3545
618,568,50,368,200,1978,1919,342000,618,0,100.00,0.00,215,31,45,161,84,0,49,0,31,0,0,38,169,117,104,3546
683,629,54,492,137,1993,1186,258700,526,157,77.01,22.99,281,252,76,48,37,0,39,60,11,26,0,176,271,15,18,3547
1002,1002,0,670,332,1983,785,257600,770,232,76.85,23.15,444,153,259,38,117,6,188,41,16,0,0,240,327,159,8,3548
1274,1181,93,803,378,1989,999,185600,514,760,40.35,59.65,323,626,113,0,25,80,249,111,0,0,265,164,56,24,13,3549
490,490,0,412,78,1945,2085,506500,444,46,90.61,9.39,55,14,41,30,419,0,0,0,0,7,15,30,61,40,392,3550
611,578,33,414,164,1973,0,376500,531,80,86.91,13.09,133,36,32,26,212,0,18,0,0,0,0,12,112,41,172,3551
664,566,98,445,121,1992,1257,232700,414,250,62.35,37.65,214,94,119,142,74,0,56,0,0,0,90,306,110,13,49,3552
626,585,41,310,275,1939,907,531300,305,321,48.72,51.28,24,14,16,78,474,54,238,0,17,0,0,14,22,32,134,3553
824,743,81,560,183,1984,1373,347500,630,194,76.46,23.54,421,229,121,160,191,81,134,117,43,87,10,90,182,198,117,3554
1037,512,525,388,124,1983,1196,210400,340,697,32.79,67.21,699,408,399,66,97,13,66,65,0,0,72,173,100,12,14,3555
229,229,0,217,12,1961,0,185600,229,0,100.00,0.00,55,26,58,0,258,0,0,26,0,0,29,252,0,55,0,3556
699,592,107,428,164,1990,1120,695300,637,62,91.13,8.87,195,85,94,49,141,0,30,0,0,0,0,50,21,52,411,3557
418,418,0,130,288,1989,793,189000,261,157,62.44,37.56,256,43,39,37,34,21,121,62,0,0,0,113,66,0,0,3558
431,431,0,111,320,1972,642,118800,93,338,21.58,78.42,50,24,84,94,153,24,193,25,0,0,44,93,0,0,0,3559
784,747,37,603,144,1993,1423,237500,758,26,96.68,3.32,418,104,175,24,14,0,16,0,0,0,24,227,444,12,12,3560
942,877,65,272,605,1978,885,227700,351,591,37.26,62.74,206,237,288,50,140,0,457,150,0,0,21,113,124,0,0,3561
488,434,54,420,14,1986,0,425000,470,18,96.31,3.69,266,161,100,0,12,0,19,36,0,0,23,71,105,53,162,3562
773,724,49,163,561,1979,868,176300,192,581,24.84,75.16,283,210,134,63,45,119,455,17,0,0,0,57,87,0,0,3563
596,552,44,333,219,1941,713,100100,438,158,73.49,26.51,0,0,97,34,492,0,220,9,0,0,128,235,31,0,0,3564
739,686,53,277,409,2001,737,250400,260,479,35.18,64.82,320,91,36,0,254,61,403,0,14,0,30,67,79,0,47,3565
446,332,114,242,90,1979,1327,312500,380,66,85.20,14.80,132,76,61,8,156,0,16,5,12,0,17,46,50,46,53,3566
291,276,15,149,127,1951,970,206300,200,91,68.73,31.27,19,0,13,0,197,0,0,59,0,0,5,83,82,0,0,3567
667,449,218,346,103,1990,759,186900,479,188,71.81,28.19,209,134,90,6,251,0,32,0,0,0,17,276,36,29,57,3568
1131,1066,65,856,210,1993,734,196700,482,649,42.62,57.38,471,115,145,49,145,22,49,14,0,0,160,323,156,41,49,3569
1123,621,502,398,223,1987,640,150000,544,579,48.44,51.56,225,344,190,42,108,27,88,7,0,0,90,190,120,10,58,3570
724,535,189,384,151,1976,1026,264700,552,172,76.24,23.76,229,66,120,57,228,11,38,19,0,0,73,100,153,24,24,3571
504,391,113,351,40,1981,489,222900,316,188,62.70,37.30,171,138,106,86,58,26,15,12,0,0,84,228,75,0,45,3572
519,424,95,147,277,1974,681,108800,221,298,42.58,57.42,116,21,200,49,174,0,212,113,0,0,50,132,0,0,0,3573
995,924,71,902,22,1978,0,291800,897,98,90.15,9.85,252,97,409,68,114,0,21,42,26,0,46,272,300,63,134,3574
294,274,20,203,71,1963,533,209400,229,65,77.89,22.11,33,26,39,12,185,10,30,18,0,0,34,73,29,3,22,3575
900,852,48,793,59,1992,897,255000,841,59,93.44,6.56,514,128,229,22,51,0,16,0,0,0,44,402,318,40,48,3576
807,673,134,367,306,1976,2023,373100,583,224,72.24,27.76,297,97,71,6,218,0,20,23,10,176,10,94,136,42,145,3577
620,544,76,90,454,1974,852,214600,159,461,25.65,74.35,61,86,155,20,134,12,268,42,0,0,0,50,53,0,0,3578
342,294,48,118,176,1939,718,114600,167,175,48.83,51.17,0,0,22,31,320,73,114,17,0,10,58,101,0,0,0,3579
498,498,0,396,102,1979,2412,488800,480,18,96.39,3.61,130,103,181,15,0,0,0,0,0,0,0,14,112,79,195,3580
712,500,212,27,473,1939,621,163300,139,573,19.52,80.48,0,0,68,0,406,108,275,11,0,0,0,23,0,0,0,3581
556,503,53,445,58,1986,1550,244300,422,134,75.90,24.10,255,47,200,12,11,0,22,20,11,0,63,62,186,43,25,3582
529,529,0,235,294,1947,647,106900,272,257,51.42,48.58,55,17,90,46,312,0,228,17,12,0,82,126,11,0,0,3583
485,442,43,276,166,1949,2153,634800,356,129,73.40,26.60,73,12,9,0,265,0,12,0,13,0,0,10,31,54,224,3584
395,242,153,157,85,1939,823,189700,273,122,69.11,30.89,34,37,87,9,167,0,80,72,0,0,11,91,13,0,16,3585
510,429,81,228,201,1953,836,171800,402,108,78.82,21.18,96,0,9,8,260,0,54,0,0,0,0,241,32,0,0,3586
1053,909,144,713,196,1984,1140,273400,976,77,92.69,7.31,345,330,306,51,92,10,82,41,13,0,59,225,310,66,171,3587
419,281,138,248,33,1991,790,328100,351,68,83.77,16.23,278,184,89,60,75,4,4,10,0,0,170,24,48,71,67,3588
548,497,51,420,77,1956,1356,619000,429,119,78.28,21.72,42,13,70,75,356,0,13,9,0,14,0,8,67,39,332,3589
953,863,90,697,166,1988,1090,318500,806,147,84.58,15.42,264,165,300,51,110,0,39,82,0,0,10,171,203,92,178,3590
1033,931,102,640,291,1984,965,184900,824,209,79.77,20.23,327,105,311,52,165,20,99,96,11,0,25,343,167,12,52,3591
967,735,232,598,137,1987,904,165200,695,272,71.87,28.13,390,117,276,10,203,0,142,19,0,0,95,211,177,127,68,3592
761,622,139,397,225,1985,631,149400,254,507,33.38,66.62,238,200,220,89,63,57,68,10,0,0,181,249,34,0,21,3593
498,453,45,341,112,1997,707,193800,276,222,55.42,44.58,137,140,81,26,64,44,65,7,0,0,169,106,44,6,0,3594
466,424,42,213,211,1970,601,94000,186,280,39.91,60.09,289,48,95,6,108,82,89,0,0,0,204,115,0,0,0,3595
598,551,47,188,363,1956,717,173700,316,282,52.84,47.16,47,89,121,94,250,65,295,33,0,0,0,189,19,0,0,3596
522,433,89,299,134,1971,603,91700,318,204,60.92,39.08,83,33,146,67,185,8,61,0,0,0,35,112,73,28,0,3597
1046,968,78,495,473,1980,776,273900,598,448,57.17,42.83,463,197,227,165,104,76,238,31,0,47,131,180,216,70,23,3598
1698,1291,407,76,1215,1997,653,273800,48,1650,2.83,97.17,884,178,275,159,88,163,717,168,0,0,0,0,0,0,0,3599
392,392,0,341,51,1966,688,288600,331,61,84.44,15.56,82,24,181,17,36,24,20,0,0,0,55,192,49,0,0,3600
356,344,12,177,167,1963,540,150300,207,149,58.15,41.85,0,17,7,31,221,25,51,10,0,0,43,127,9,0,0,3601
311,311,0,163,148,1944,744,138300,251,60,80.71,19.29,0,25,14,20,167,55,14,9,0,0,51,97,0,0,0,3602
564,564,0,434,130,1972,688,216200,487,77,86.35,13.65,241,45,172,66,90,12,63,11,0,0,37,237,110,8,0,3603
332,282,50,172,110,1944,672,166800,271,61,81.63,18.37,10,45,33,6,209,7,35,0,0,0,59,102,22,10,7,3604
392,369,23,320,49,1975,1023,212600,339,53,86.48,13.52,97,44,246,47,37,14,23,11,0,0,0,297,109,0,17,3605
824,621,203,521,100,1993,793,264400,605,219,73.42,26.58,347,86,102,125,143,56,30,60,0,0,21,137,226,52,57,3606
699,673,26,634,39,2005,1418,197700,699,0,100.00,0.00,479,0,0,0,14,0,12,25,0,0,44,306,70,0,5,3607
838,798,40,68,730,1979,840,9999,37,801,4.42,95.58,174,562,276,85,62,35,761,13,0,0,0,0,0,0,0,3608
480,461,19,392,69,1993,1182,184200,269,211,56.04,43.96,147,125,55,41,23,0,10,11,0,0,1,146,92,21,7,3609
981,840,141,367,473,1998,948,163500,536,445,54.64,45.36,828,84,0,10,113,58,297,111,0,0,0,266,79,23,0,3610
911,885,26,769,116,2004,1807,305900,911,0,100.00,0.00,973,0,36,0,8,0,0,46,94,58,0,100,315,47,215,3611
595,584,11,524,60,1995,1222,253500,530,65,89.08,10.92,482,71,12,56,0,0,0,16,17,0,32,148,368,20,20,3612
732,697,35,490,207,2003,1692,196900,684,48,93.44,6.56,590,29,65,40,0,0,28,40,94,0,41,205,238,0,10,3613
467,438,29,313,125,2004,1723,172500,454,13,97.22,2.78,311,21,20,30,0,0,10,35,0,0,27,116,125,11,30,3614
1461,1268,193,789,479,2001,1597,186800,1135,326,77.69,22.31,780,99,167,47,69,60,21,92,188,0,94,294,292,9,10,3615
998,586,412,466,120,1981,1288,227900,844,154,84.57,15.43,234,163,145,88,248,0,11,47,11,0,53,62,75,42,90,3616
481,436,45,174,262,1982,985,322400,209,272,43.45,56.55,161,98,168,10,6,0,127,116,0,0,0,46,53,49,6,3617
579,569,10,412,157,1994,1538,275300,563,16,97.24,2.76,439,34,61,25,15,4,27,32,44,0,13,90,230,56,39,3618
475,440,35,153,287,1985,836,203100,171,304,36.00,64.00,124,94,60,14,136,18,193,44,0,4,12,50,75,14,3,3619
629,590,39,111,479,1984,1054,620800,179,450,28.46,71.54,473,83,107,10,72,0,374,177,0,0,0,0,0,0,83,3620
565,565,0,471,94,2002,1239,263000,520,45,92.04,7.96,493,25,8,14,0,0,8,7,35,8,14,58,276,122,12,3621
886,849,37,186,663,2006,1042,338200,248,638,27.99,72.01,367,0,0,0,33,0,49,189,45,0,0,0,97,13,7,3622
262,205,57,157,48,1976,2292,560200,254,8,96.95,3.05,66,58,55,44,15,0,0,0,0,0,0,14,66,0,114,3623
1023,968,55,920,48,2003,0,345200,965,58,94.33,5.67,969,6,36,0,0,0,0,0,15,11,34,81,296,282,212,3624
385,385,0,192,193,1992,1358,217000,259,126,67.27,32.73,203,48,193,0,0,0,33,182,40,0,0,117,72,0,0,3625
1267,1160,107,314,846,1984,1325,331600,59,1208,4.66,95.34,181,202,109,87,861,14,705,232,14,0,53,69,203,15,0,3626
547,504,43,386,118,1957,838,223200,441,106,80.62,19.38,77,60,78,48,222,25,84,0,0,9,39,0,169,26,99,3627
574,574,0,420,154,1950,931,198300,511,63,89.02,10.98,126,62,10,97,350,9,67,82,15,0,10,153,172,36,87,3628
564,246,318,0,246,1975,1296,0,281,283,49.82,50.18,117,58,239,54,70,0,24,153,0,0,0,0,0,0,0,3629
1079,897,182,280,617,1970,1070,136600,589,490,54.59,45.41,138,13,10,144,355,0,213,123,33,0,8,191,49,7,0,3630
546,546,0,459,87,1980,1492,356700,517,29,94.69,5.31,159,145,135,0,19,0,18,0,0,0,0,57,173,66,57,3631
815,815,0,764,51,1998,1273,407100,726,89,89.08,10.92,537,102,74,20,29,10,8,10,0,9,26,96,132,156,267,3632
904,826,78,480,346,1966,740,154900,406,498,44.91,55.09,70,192,144,134,142,144,47,20,0,0,147,166,117,0,0,3633
570,448,122,328,120,1950,733,131600,498,72,87.37,12.63,45,11,55,36,438,34,71,3,5,0,143,213,3,3,6,3634
510,502,8,394,108,1981,830,264300,273,237,53.53,46.47,55,68,62,17,93,0,9,0,0,0,0,183,51,0,0,3635
674,620,54,424,196,1987,850,236000,417,257,61.87,38.13,324,163,123,43,107,0,38,25,22,0,7,235,249,36,52,3636
750,670,80,559,111,1983,974,285100,517,233,68.93,31.07,81,202,173,156,112,0,124,134,18,0,50,118,146,23,88,3637
478,478,0,388,90,1978,1865,261500,474,4,99.16,0.84,58,209,295,0,22,12,0,0,11,16,14,80,389,39,23,3638
502,477,25,337,140,1968,1183,364300,430,72,85.66,14.34,52,91,73,112,224,0,39,47,0,0,21,0,194,116,69,3639
563,494,69,451,43,1974,1375,404100,548,15,97.34,2.66,155,109,140,43,96,0,11,10,9,10,0,44,117,71,200,3640
571,523,48,391,132,1987,1143,17600,8,563,1.40,98.60,191,211,221,30,123,69,125,87,2,0,421,33,39,0,0,3641
508,508,0,476,32,1980,0,366100,476,32,93.70,6.30,175,168,97,0,57,0,21,31,0,0,0,50,91,31,181,3642
565,565,0,465,100,1995,1583,266700,500,65,88.50,11.50,354,266,91,50,11,0,10,151,10,13,0,164,206,61,65,3643
778,745,33,189,556,1974,817,159700,218,560,28.02,71.98,93,30,363,51,120,7,366,36,0,0,43,121,0,7,0,3644
795,795,0,765,30,0,0,304100,795,0,100.00,0.00,821,15,35,0,0,0,0,0,0,0,21,7,447,348,48,3645
398,377,21,277,100,1996,0,205300,398,0,100.00,0.00,430,15,43,0,0,0,0,97,46,0,0,205,59,16,18,3646
397,397,0,244,153,1992,1299,207500,315,82,79.35,20.65,145,30,24,10,50,11,32,31,0,0,15,80,58,2,25,3647
893,521,372,495,26,1989,1268,262500,766,127,85.78,14.22,378,108,172,171,155,0,58,19,0,0,13,142,127,59,121,3648
734,474,260,417,57,1987,0,234200,572,162,77.93,22.07,109,94,74,35,67,13,32,11,0,0,34,118,95,14,27,3649
482,482,0,403,79,1972,0,395000,447,35,92.74,7.26,47,95,144,80,164,48,0,0,15,0,11,50,102,86,136,3650
661,631,30,471,160,1991,2267,651800,384,277,58.09,41.91,300,195,74,24,28,0,11,72,0,34,66,0,13,43,342,3651
732,693,39,490,203,1976,1153,293300,404,328,55.19,44.81,7,180,492,44,0,5,28,28,38,7,52,178,183,120,22,3652
930,930,0,574,356,1977,1339,393600,484,446,52.04,47.96,36,293,265,197,102,97,14,156,28,19,0,94,196,115,121,3653
560,508,52,475,33,1978,0,656000,560,0,100.00,0.00,73,153,350,0,0,0,0,0,0,78,15,0,0,65,363,3654
531,508,23,452,56,1989,0,268000,507,24,95.48,4.52,176,208,112,14,0,0,0,21,0,0,0,77,253,67,29,3655
400,361,39,327,34,2000,0,245000,213,187,53.25,46.75,298,31,10,0,0,0,0,41,0,0,13,100,106,38,33,3656
502,502,0,471,31,2004,0,274000,493,9,98.21,1.79,451,0,0,0,13,0,0,0,0,9,0,56,360,26,13,3657
311,311,0,301,10,1994,0,225400,254,57,81.67,18.33,121,60,142,8,12,0,0,15,0,0,0,164,155,0,0,3658
444,418,26,352,66,1997,833,201700,391,53,88.06,11.94,278,21,15,4,26,0,3,0,0,32,13,158,80,18,0,3659
626,582,44,17,565,1979,833,0,77,549,12.30,87.70,79,228,254,62,14,13,440,17,0,0,0,0,0,0,0,3660
707,682,25,72,610,1983,757,144400,76,631,10.75,89.25,232,87,185,95,75,26,425,37,0,0,0,82,33,0,0,3661
475,429,46,315,114,1981,1100,287100,414,61,87.16,12.84,145,53,46,32,173,0,21,27,0,0,0,161,211,29,0,3662
409,409,0,368,41,1942,1197,261700,409,0,100.00,0.00,49,0,25,26,323,0,23,38,41,0,0,61,144,72,44,3663
925,863,62,577,286,1976,632,198300,752,173,81.30,18.70,307,65,376,34,104,0,46,50,0,0,80,250,237,39,80,3664
1385,1338,47,1141,197,2003,1087,243200,1145,240,82.67,17.33,500,114,44,19,34,0,66,0,0,11,0,118,371,40,61,3665
698,629,69,463,166,1996,1216,241000,676,22,96.85,3.15,749,184,153,0,0,0,21,207,73,0,0,342,413,0,30,3666
821,739,82,667,72,1997,2077,276500,821,0,100.00,0.00,488,30,131,23,70,21,59,0,6,0,3,149,364,70,53,3667
715,715,0,674,41,1989,0,266100,674,41,94.27,5.73,249,152,264,0,37,0,0,0,8,0,14,389,167,0,30,3668
347,301,46,292,9,1985,0,362000,303,44,87.32,12.68,303,0,20,20,28,0,6,10,3,0,51,65,68,94,74,3669
622,622,0,532,90,1996,1104,359000,542,80,87.14,12.86,344,37,46,0,0,0,0,0,0,0,14,188,146,49,30,3670
310,279,31,279,0,1991,0,277800,236,74,76.13,23.87,34,32,33,0,128,0,18,0,0,0,14,19,97,16,21,3671
163,150,13,131,19,1998,0,501900,158,5,96.93,3.07,91,25,15,0,0,0,0,0,0,0,0,64,44,12,11,3672
694,678,16,527,151,1994,1423,221000,676,18,97.41,2.59,370,37,42,44,25,0,30,15,0,0,0,208,265,0,0,3673
584,559,25,559,0,1991,0,268500,559,25,95.72,4.28,351,107,151,0,0,0,0,0,0,0,24,252,239,61,33,3674
479,468,11,387,81,1994,1313,287500,394,85,82.25,17.75,276,38,63,0,46,0,19,0,0,0,0,19,167,71,110,3675
311,311,0,311,0,1977,0,223700,311,0,100.00,0.00,65,15,56,24,9,0,0,0,0,0,0,28,68,59,14,3676
448,448,0,397,51,1997,1456,312100,448,0,100.00,0.00,486,0,15,0,0,0,0,0,15,0,15,44,273,67,87,3677
881,850,31,696,154,1974,979,260100,766,115,86.95,13.05,97,135,562,202,0,8,82,0,12,0,0,482,306,71,24,3678
1131,1131,0,317,814,1980,878,180600,424,707,37.49,62.51,123,341,275,145,97,28,391,143,10,0,104,180,58,14,12,3679
704,616,88,515,101,1986,1173,255900,643,61,91.34,8.66,210,214,181,0,0,0,0,13,12,0,17,90,353,71,49,3680
591,591,0,410,181,1990,1486,214000,437,154,73.94,26.06,323,31,138,19,18,42,32,50,30,0,22,62,233,27,12,3681
536,449,87,382,67,1979,0,274200,399,137,74.44,25.56,194,52,132,12,115,0,0,42,0,0,14,216,151,29,37,3682
598,598,0,443,155,1993,691,283700,446,152,74.58,25.42,201,124,41,34,134,27,0,43,8,7,65,154,125,86,19,3683
214,214,0,163,51,2001,1210,385100,214,0,100.00,0.00,103,18,64,13,9,0,0,0,0,0,0,60,109,27,11,3684
1094,1064,30,981,83,1995,1268,359500,930,164,85.01,14.99,794,17,146,47,142,0,16,35,20,0,118,325,404,120,101,3685
674,584,90,483,101,1992,0,351000,527,147,78.19,21.81,261,118,102,9,57,17,0,0,15,0,16,141,90,85,111,3686
366,264,102,244,20,1979,0,265600,344,22,93.99,6.01,114,72,45,12,38,16,11,0,0,0,11,62,42,46,79,3687
330,309,21,170,139,1970,775,211300,285,45,86.36,13.64,102,6,25,21,66,0,53,0,0,0,31,98,23,4,11,3688
487,446,41,260,186,1972,1054,214500,443,44,90.97,9.03,183,10,170,47,213,39,55,10,0,0,178,250,0,0,27,3689
671,671,0,345,326,1984,763,199700,339,332,50.52,49.48,416,119,169,30,30,0,350,28,0,0,27,191,157,11,0,3690
733,688,45,358,330,2004,924,158500,480,253,65.48,34.52,483,28,67,0,55,41,124,78,8,0,22,277,15,0,0,3691
915,882,33,74,808,1974,710,167900,136,779,14.86,85.14,67,156,268,240,114,172,458,15,0,67,0,38,23,0,0,3692
803,735,68,358,377,1939,649,123800,510,293,63.51,36.49,0,0,56,28,547,78,118,52,0,0,66,287,0,0,0,3693
775,696,79,253,443,1939,832,145800,630,145,81.29,18.71,19,0,102,48,509,20,189,0,0,23,77,311,7,0,0,3694
575,563,12,452,111,1975,937,113000,323,252,56.17,43.83,92,101,180,52,55,9,0,0,0,0,186,271,14,0,0,3695
1011,933,78,604,329,1971,1098,193100,824,187,81.50,18.50,199,77,244,54,235,13,68,59,0,0,45,242,153,41,26,3696
497,468,29,426,42,1985,1338,205900,422,75,84.91,15.09,164,43,140,68,104,0,25,0,0,0,66,186,137,34,52,3697
635,346,289,226,120,1971,468,116300,458,177,72.13,27.87,104,79,325,60,305,45,75,0,0,0,85,121,1,0,0,3698
555,415,140,38,377,1950,566,86100,96,459,17.30,82.70,30,10,43,108,303,87,224,29,0,0,11,90,0,0,12,3699
591,565,26,424,141,1997,1066,234100,464,127,78.51,21.49,463,45,71,0,0,29,25,11,44,0,0,116,264,59,0,3700
558,492,66,401,91,1984,1106,189500,388,170,69.53,30.47,128,175,180,20,47,0,94,0,79,32,116,59,130,17,23,3701
846,803,43,667,136,1989,1388,211000,778,68,91.96,8.04,582,182,100,0,40,0,34,12,57,0,47,315,341,45,23,3702
558,529,29,391,138,1990,1178,173100,363,195,65.05,34.95,391,53,131,65,0,0,11,101,0,0,42,328,73,11,18,3703
1999,1850,149,1135,715,0,1760,298500,1743,256,87.19,12.81,1709,0,14,7,17,0,39,120,114,93,22,328,679,92,25,3704
8,8,0,8,0,0,0,0,4,4,50.00,50.00,26,0,13,0,0,0,13,0,0,0,0,0,0,0,0,3705
372,372,0,233,139,1991,1076,288400,289,83,77.69,22.31,110,10,26,0,119,0,27,19,0,0,52,98,21,34,0,3706
558,523,35,467,56,1991,1402,269500,429,129,76.88,23.12,162,59,219,59,0,8,65,0,9,0,19,106,167,20,86,3707
697,661,36,482,179,2003,1226,190900,639,58,91.68,8.32,575,28,0,0,5,0,32,26,61,33,25,308,51,6,10,3708
978,978,0,360,618,1988,948,159000,199,779,20.35,79.65,444,346,128,26,28,13,346,29,20,0,0,347,138,10,25,3709
924,876,48,393,483,1995,1357,411300,317,607,34.31,65.69,697,107,0,0,0,0,79,182,59,47,10,80,102,64,69,3710
538,529,9,454,75,1981,1725,373100,538,0,100.00,0.00,191,116,106,90,63,0,7,52,53,0,14,11,236,83,110,3711
553,507,46,335,172,1997,1500,262700,482,71,87.16,12.84,373,88,96,12,91,0,14,97,36,0,43,57,289,58,57,3712
1282,1265,17,1071,194,2004,1794,259600,1204,78,93.92,6.08,811,0,12,126,69,0,0,34,12,0,59,167,509,110,93,3713
782,757,25,605,152,1992,1497,294600,617,165,78.90,21.10,549,54,76,8,50,0,11,59,43,22,34,153,172,75,52,3714
520,520,0,488,32,1967,0,628300,505,15,97.12,2.88,77,43,163,114,103,0,0,0,0,37,15,0,21,0,353,3715
659,539,120,389,150,1968,1139,290700,565,94,85.74,14.26,162,82,147,114,220,5,69,11,3,0,61,85,104,33,205,3716
295,295,0,14,281,1983,1284,0,14,281,4.75,95.25,123,92,31,0,0,0,102,103,0,0,0,31,10,0,0,3717
1513,1150,363,312,838,1994,1208,128700,293,1220,19.37,80.63,1001,254,30,0,0,0,305,530,66,21,0,135,102,0,0,3718
829,262,567,252,10,1977,0,0,602,227,72.62,27.38,105,119,281,274,321,75,161,1,0,0,10,196,109,0,60,3719
1025,645,380,421,224,1979,401,91600,667,358,65.07,34.93,163,237,414,138,137,84,51,3,4,0,110,220,26,22,18,3720
780,745,35,518,227,2005,1459,161200,780,0,100.00,0.00,635,9,0,0,0,0,0,95,0,0,6,473,0,0,0,3721
930,930,0,626,304,2005,980,153900,728,202,78.28,21.72,623,0,7,14,20,0,104,48,31,0,0,306,14,0,0,3722
408,313,95,66,247,1971,818,137500,134,274,32.84,67.16,60,22,77,103,120,12,162,29,9,0,7,111,0,0,17,3723
422,372,50,287,85,2002,1190,203900,414,8,98.10,1.90,238,21,72,15,32,0,0,54,13,0,29,186,77,0,0,3724
308,308,0,205,103,1980,994,240400,186,122,60.39,39.61,81,142,12,14,23,0,24,0,0,0,11,33,61,26,12,3725
996,996,0,471,525,1994,954,167700,631,365,63.35,36.65,484,430,222,174,17,0,444,163,0,0,0,526,15,0,14,3726
1102,941,161,326,615,1991,935,153100,297,805,26.95,73.05,636,257,189,86,0,36,684,66,24,0,11,267,39,0,0,3727
660,566,94,356,210,1967,864,194500,479,181,72.58,27.42,22,155,79,173,343,85,265,56,0,0,12,252,76,12,0,3728
728,728,0,130,598,1963,732,179800,216,512,29.67,70.33,43,41,90,28,316,35,184,31,0,0,0,132,26,0,12,3729
280,280,0,197,83,1968,1176,172400,242,38,86.43,13.57,79,23,81,15,141,43,0,0,0,0,109,130,31,0,15,3730
584,584,0,550,34,1975,0,139200,363,221,62.16,37.84,250,62,150,35,37,0,0,0,0,0,212,211,55,42,14,3731
313,313,0,70,243,1996,964,155400,101,212,32.27,67.73,309,0,26,0,0,0,150,31,0,0,0,81,0,0,0,3732
879,842,37,548,294,1989,1334,281400,560,319,63.71,36.29,418,313,45,24,0,24,25,112,0,0,0,151,336,72,24,3733
914,914,0,381,533,1988,928,291700,717,197,78.45,21.55,490,57,195,0,46,16,161,26,0,0,17,140,142,72,142,3734
354,327,27,177,150,2003,878,163500,219,135,61.86,38.14,106,0,58,11,0,36,8,38,13,0,0,66,12,0,2,3735
901,871,30,716,155,2000,1313,262600,774,127,85.90,14.10,786,52,32,0,0,0,16,38,117,0,85,86,448,64,16,3736
415,361,54,294,67,1980,1581,278100,324,91,78.07,21.93,113,122,149,32,33,0,0,0,0,0,0,125,177,76,71,3737
788,788,0,617,171,2000,1550,456800,694,94,88.07,11.93,440,129,49,38,50,0,0,38,0,5,0,54,79,244,243,3738
527,468,59,430,38,1990,0,294400,395,132,74.95,25.05,141,159,136,27,9,0,10,40,0,12,7,86,206,52,34,3739
653,638,15,500,138,1992,1321,239700,534,119,81.78,18.22,343,83,100,0,70,0,32,84,27,0,0,115,232,39,36,3740
540,521,19,426,95,1979,1272,293700,446,94,82.59,17.41,168,73,166,10,26,0,0,45,62,0,5,102,125,49,55,3741
558,465,93,385,80,1979,0,276000,286,272,51.25,48.75,193,74,137,13,158,10,10,50,0,0,0,49,195,25,102,3742
609,541,68,470,71,1973,914,275800,541,68,88.83,11.17,23,82,203,87,213,0,0,34,40,11,0,78,259,65,58,3743
383,383,0,356,27,2004,0,341900,383,0,100.00,0.00,319,47,0,0,34,0,0,9,0,0,0,21,154,154,28,3744
541,404,137,236,168,1989,1366,234000,304,237,56.19,43.81,196,96,122,109,22,36,110,59,34,0,0,118,164,0,24,3745
939,859,80,819,40,1995,0,312900,910,29,96.91,3.09,510,174,12,11,7,0,0,0,10,0,0,17,410,152,95,3746
891,807,84,95,712,1990,1291,318800,169,722,18.97,81.03,345,342,112,0,0,0,201,291,53,0,0,16,102,65,0,3747
629,621,8,414,207,1981,2313,266200,486,143,77.27,22.73,156,73,204,76,0,0,9,12,29,40,0,116,289,14,0,3748
658,658,0,535,123,1998,1966,360100,642,16,97.57,2.43,412,0,53,40,0,0,0,0,14,9,0,75,204,99,104,3749
362,362,0,327,35,2005,0,297700,347,15,95.86,4.14,213,43,101,20,0,0,0,15,0,0,0,80,194,40,23,3750
615,554,61,260,294,1997,1220,226900,310,305,50.41,49.59,491,38,0,0,51,0,81,145,12,0,15,90,192,20,25,3751
436,436,0,368,68,2004,2217,297900,436,0,100.00,0.00,462,13,0,0,0,0,0,0,0,0,10,11,314,110,15,3752
1492,1410,82,1124,286,2004,1902,430700,1302,190,87.27,12.73,1263,16,38,11,17,0,0,32,92,46,11,13,276,347,518,3753
623,602,21,499,103,1949,1652,458500,603,20,96.79,3.21,61,43,10,19,508,0,11,18,43,0,30,8,83,161,240,3754
638,598,40,583,15,1970,0,658400,638,0,100.00,0.00,81,209,178,102,134,0,0,38,0,45,31,20,32,70,446,3755
709,615,94,547,68,1969,3501,1574400,709,0,100.00,0.00,117,35,71,112,278,0,0,0,0,68,0,4,4,0,475,3756
729,679,50,236,443,1941,1215,620200,318,411,43.62,56.38,179,0,21,59,481,0,284,110,14,13,0,0,24,107,120,3757
1025,986,39,539,447,1963,656,345900,767,258,74.83,25.17,188,70,62,121,287,109,147,45,14,0,34,32,94,81,83,3758
440,440,0,400,40,1955,1417,590900,426,14,96.82,3.18,33,4,2,85,288,0,0,9,0,0,0,13,71,69,241,3759
602,564,38,109,455,0,388,313800,305,297,50.66,49.34,250,0,0,0,0,102,72,23,0,0,0,0,0,53,0,3760
699,673,26,84,589,2004,519,268200,125,574,17.88,82.12,124,0,9,22,141,82,93,0,24,0,0,46,22,0,0,3761
1547,1294,253,296,998,2002,1324,226900,390,1157,25.21,74.79,364,0,45,62,425,121,301,78,0,11,0,31,198,12,0,3762
584,584,0,571,13,1981,0,659500,566,18,96.92,3.08,83,193,162,25,22,0,0,0,0,0,0,25,10,38,353,3763
442,442,0,368,74,1986,2803,668300,429,13,97.06,2.94,79,321,79,0,0,0,0,0,0,15,31,0,0,40,369,3764
1219,1219,0,1132,87,2001,2820,546400,1205,14,98.85,1.15,833,49,97,0,26,0,0,0,31,32,25,0,65,244,608,3765
879,879,0,859,20,2005,0,770300,879,0,100.00,0.00,739,82,42,0,0,0,0,0,0,0,21,0,6,34,725,3766
573,544,29,468,76,1999,2583,637400,544,29,94.94,5.06,287,96,14,76,0,0,0,0,0,11,0,16,10,38,352,3767
830,787,43,342,445,1990,1285,387100,286,544,34.46,65.54,686,548,172,0,13,13,340,441,42,0,12,32,216,113,76,3768
1403,1360,43,97,1263,1997,1497,533500,127,1276,9.05,90.95,1090,486,57,85,23,0,185,771,357,63,12,0,8,26,73,3769
608,564,44,309,255,1996,1230,322300,313,295,51.48,48.52,473,217,25,0,0,0,44,179,56,0,0,111,132,80,32,3770
661,584,77,269,315,1972,1123,250500,391,270,59.15,40.85,62,211,155,76,105,0,171,88,0,0,12,97,120,58,48,3771
465,443,22,435,8,2003,0,365100,465,0,100.00,0.00,215,34,9,120,59,0,0,0,0,0,11,0,163,108,143,3772
769,733,36,588,145,1978,1453,211200,571,198,74.25,25.75,153,92,240,167,100,0,80,59,0,0,10,307,203,24,13,3773
1020,954,66,683,271,2001,1045,311100,726,294,71.18,28.82,399,133,107,89,66,0,31,126,0,0,0,50,278,161,70,3774
381,356,25,319,37,1994,1653,246000,381,0,100.00,0.00,201,135,0,0,0,0,0,0,14,0,0,39,269,14,0,3775
358,358,0,310,48,1996,1647,260300,358,0,100.00,0.00,291,35,0,0,0,0,0,34,12,0,0,21,259,0,0,3776
657,526,131,476,50,1994,0,350800,571,86,86.91,13.09,368,86,93,0,36,0,42,10,0,0,7,97,115,103,158,3777
838,648,190,452,196,1983,1250,297500,637,201,76.01,23.99,334,139,121,58,149,0,67,67,18,27,36,119,171,89,56,3778
816,771,45,482,289,1997,1350,189700,728,88,89.22,10.78,421,56,4,27,42,0,13,45,0,0,46,191,226,0,0,3779
773,732,41,378,354,2003,1494,334400,538,235,69.60,30.40,365,86,0,0,30,24,30,13,0,0,24,66,147,167,10,3780
684,684,0,644,40,2005,0,383100,599,85,87.57,12.43,765,0,0,0,14,0,0,17,0,0,0,141,154,200,267,3781
507,507,0,453,54,1997,1909,337700,507,0,100.00,0.00,496,0,29,16,15,0,0,0,73,0,0,43,289,113,38,3782
524,492,32,438,54,2003,1500,281300,515,9,98.28,1.72,330,14,14,26,64,0,0,88,0,0,0,4,240,58,58,3783
547,443,104,244,199,1977,569,194400,402,145,73.49,26.51,92,65,71,63,185,21,62,31,25,0,88,116,34,9,15,3784
545,491,54,232,259,1975,1431,0,158,387,28.99,71.01,136,30,118,67,246,20,94,0,0,0,90,85,110,55,31,3785
548,506,42,317,189,1987,1426,343300,422,126,77.01,22.99,292,64,19,88,70,0,0,91,12,0,9,45,123,86,73,3786
518,512,6,319,193,1939,1422,601900,403,115,77.80,22.20,0,29,37,117,438,0,98,41,28,88,0,0,76,36,231,3787
445,445,0,397,48,1942,2719,875000,445,0,100.00,0.00,38,15,90,13,516,0,0,0,28,21,0,0,10,30,451,3788
194,194,0,132,62,1951,0,913500,150,44,77.32,22.68,40,11,13,46,231,0,46,40,15,0,0,0,0,0,240,3789
794,723,71,217,506,1958,1301,250600,0,794,0.00,100.00,91,0,87,242,504,0,454,181,47,0,0,55,55,0,19,3790
1919,1635,284,100,1535,2002,1610,198600,171,1748,8.91,91.09,941,118,10,45,40,68,50,600,198,13,0,16,11,0,0,3791
607,557,50,408,149,1959,1174,292100,574,33,94.56,5.44,98,107,53,44,287,0,61,92,0,0,11,51,236,54,58,3792
730,585,145,263,322,1968,0,438200,518,212,70.96,29.04,78,78,10,31,250,41,34,9,0,0,0,37,86,61,156,3793
592,592,0,483,109,1986,1842,413700,479,113,80.91,19.09,206,239,162,28,0,0,24,11,70,10,0,81,131,85,223,3794
819,819,0,358,461,1977,1037,217400,180,639,21.98,78.02,13,229,254,75,0,46,130,117,0,0,12,107,11,30,105,3795
640,640,0,381,259,1983,1673,568100,422,218,65.94,34.06,138,340,93,25,118,0,0,139,55,37,25,41,111,38,258,3796
426,426,0,341,85,2000,0,706800,400,26,93.90,6.10,455,14,0,12,9,0,0,14,33,11,0,36,77,65,219,3797
1164,1093,71,406,687,2003,1707,429300,367,797,31.53,68.47,941,62,0,43,0,0,0,292,107,110,0,46,148,69,120,3798
682,631,51,551,80,1949,2524,873900,682,0,100.00,0.00,32,0,34,28,436,0,15,0,0,44,18,0,0,14,405,3799
398,389,9,362,27,1993,0,458500,398,0,100.00,0.00,249,49,30,32,53,0,17,0,10,0,0,15,110,24,188,3800
537,537,0,473,64,1995,1288,266800,375,162,69.83,30.17,343,33,87,0,54,0,44,0,0,0,23,52,264,25,48,3801
467,345,122,308,37,1973,0,400000,467,0,100.00,0.00,77,99,55,96,142,0,0,17,15,0,0,12,90,74,212,3802
334,334,0,325,9,1957,0,703800,315,19,94.31,5.69,9,9,66,136,206,0,16,0,13,0,0,27,15,69,286,3803
724,707,17,422,285,1983,1439,743700,243,481,33.56,66.44,198,136,159,61,361,41,45,36,87,58,0,17,80,84,315,3804
1255,1209,46,792,417,1991,1318,238500,676,579,53.86,46.14,901,134,82,84,41,12,123,83,58,0,195,170,377,105,90,3805
542,488,54,396,92,1994,1102,277500,416,126,76.75,23.25,229,68,223,0,0,0,37,18,0,0,14,37,216,50,76,3806
476,449,27,191,258,1958,829,91800,321,155,67.44,32.56,52,17,0,57,246,12,92,52,0,0,61,65,0,17,13,3807
1019,893,126,759,134,1987,922,258700,848,171,83.22,16.78,428,73,218,91,122,0,87,0,12,0,0,317,263,67,118,3808
624,624,0,585,39,1997,2125,293200,569,55,91.19,8.81,137,70,239,72,0,0,0,0,0,41,0,92,203,31,125,3809
281,274,7,16,258,1976,1353,0,96,185,34.16,65.84,13,96,71,57,13,0,0,150,13,0,0,0,0,0,0,3810
703,648,55,0,648,1970,1404,0,202,501,28.73,71.27,76,38,65,65,159,0,35,274,0,0,0,0,0,0,0,3811
399,376,23,210,166,1978,798,68700,210,189,52.63,47.37,87,40,73,40,142,39,69,21,0,0,160,77,7,0,0,3812
438,382,56,0,382,1975,1373,0,242,196,55.25,44.75,236,65,47,134,222,0,0,577,33,0,0,14,0,0,0,3813
518,438,80,251,187,1982,1049,184200,240,278,46.33,53.67,218,135,87,115,106,0,154,125,0,0,91,48,99,13,33,3814
665,563,102,464,99,1985,1140,226400,595,70,89.47,10.53,321,31,165,13,97,0,26,44,34,0,23,81,259,48,99,3815
494,374,120,338,36,1987,0,276400,440,54,89.07,10.93,191,155,91,0,111,0,32,46,0,0,0,128,247,0,49,3816
865,701,164,611,90,1979,1151,238600,733,132,84.74,15.26,278,105,207,80,124,0,34,11,0,0,25,215,203,113,79,3817
557,529,28,396,133,1987,1091,353400,486,71,87.25,12.75,216,97,112,0,77,0,21,34,0,0,0,91,147,74,101,3818
587,483,104,406,77,1991,1439,300000,516,71,87.90,12.10,155,45,116,58,83,0,11,7,0,0,0,105,163,31,78,3819
287,287,0,242,45,1981,0,276000,264,23,91.99,8.01,59,74,101,0,111,0,0,0,0,0,20,113,100,0,42,3820
699,612,87,243,369,1948,960,163200,561,138,80.26,19.74,51,58,118,0,438,85,188,75,0,0,0,202,89,12,0,3821
1445,1160,285,1018,142,2000,1364,168800,1306,139,90.38,9.62,890,180,167,15,26,0,0,37,0,0,106,679,219,32,19,3822
828,704,124,583,121,1997,0,596300,731,97,88.29,11.71,295,180,32,46,129,0,0,0,7,15,0,34,97,75,394,3823
607,563,44,497,66,1994,1621,579300,589,18,97.03,2.97,208,188,91,50,72,0,16,62,26,0,0,9,80,62,230,3824
868,741,127,549,192,1990,0,660900,740,128,85.25,14.75,254,26,191,0,196,0,47,99,15,14,0,14,56,73,278,3825
908,825,83,674,151,1991,1375,248600,669,239,73.68,26.32,356,169,107,66,20,0,0,24,17,0,16,171,137,123,127,3826
966,773,193,634,139,1990,1556,272500,765,201,79.19,20.81,367,205,148,0,12,0,0,0,29,0,12,222,148,62,191,3827
921,848,73,191,657,1966,825,123400,64,857,6.95,93.05,173,10,25,27,654,216,362,53,0,0,11,38,108,11,24,3828
799,711,88,227,484,1939,829,177500,113,686,14.14,85.86,111,44,68,85,412,8,377,112,0,0,0,63,86,0,0,3829
674,653,21,415,238,1964,1606,333900,574,100,85.16,14.84,127,8,134,146,200,29,125,26,0,0,0,86,138,78,133,3830
771,740,31,496,244,1982,1037,264700,610,161,79.12,20.88,173,207,159,48,43,0,26,36,13,0,0,167,199,42,45,3831
743,617,126,572,45,1995,0,237200,635,108,85.46,14.54,148,106,240,50,78,14,16,15,0,0,0,196,167,96,11,3832
821,796,25,657,139,1987,1215,274100,733,88,89.28,10.72,366,231,229,7,40,0,19,54,0,10,22,239,244,158,117,3833
899,864,35,580,284,1990,927,279600,642,257,71.41,28.59,600,118,115,0,52,72,278,55,0,11,13,223,168,13,20,3834
933,910,23,757,153,1991,1135,340900,817,116,87.57,12.43,363,151,84,11,120,0,34,11,0,0,34,97,157,171,150,3835
1269,1269,0,1144,125,1989,1534,288100,1269,0,100.00,0.00,442,147,275,42,104,0,0,0,0,18,12,298,239,84,195,3836
1791,1733,58,1127,606,2003,1586,213000,1534,257,85.65,14.35,345,103,200,37,0,0,55,29,44,0,13,286,206,0,0,3837
1286,1227,59,894,333,2004,1434,334300,1102,184,85.69,14.31,733,13,30,55,20,11,93,171,23,12,0,48,148,85,189,3838
517,287,230,243,44,1990,1280,393900,459,58,88.78,11.22,59,84,104,0,98,0,70,0,13,0,0,19,120,60,63,3839
410,393,17,363,30,1993,0,392500,395,15,96.34,3.66,294,24,14,55,12,0,16,0,0,42,12,28,98,79,84,3840
563,563,0,563,0,2004,0,354100,537,26,95.38,4.62,469,0,9,11,0,0,0,0,21,0,11,7,246,69,135,3841
638,638,0,498,140,2002,1645,256000,529,109,82.92,17.08,473,30,103,50,8,0,49,58,0,0,23,60,225,53,76,3842
549,549,0,501,48,1997,0,182300,387,162,70.49,29.51,303,72,138,0,103,0,14,12,0,0,14,336,148,77,15,3843
920,827,93,368,459,1980,1267,31300,161,759,17.50,82.50,214,132,355,126,23,0,94,105,61,35,307,133,11,11,0,3844
1119,954,165,749,205,1986,1197,231900,808,311,72.21,27.79,465,223,180,94,55,0,84,56,0,0,0,327,244,118,175,3845
1347,525,822,402,123,1990,685,165800,773,574,57.39,42.61,359,376,198,35,273,0,88,0,0,0,45,291,31,36,0,3846
536,507,29,419,88,1974,0,175300,410,126,76.49,23.51,61,68,146,61,119,0,26,0,0,0,104,227,33,25,0,3847
241,241,0,190,51,1977,0,16700,44,197,18.26,81.74,43,53,93,0,82,0,45,0,0,0,145,70,11,0,0,3848
864,809,55,301,508,1969,657,64700,357,507,41.32,58.68,140,116,220,95,332,182,401,15,0,0,190,46,0,12,9,3849
535,499,36,380,119,1992,1505,218500,300,235,56.07,43.93,112,90,99,29,38,0,0,0,0,0,135,143,90,0,0,3850
205,173,32,117,56,1974,827,130200,138,67,67.32,32.68,23,9,65,0,95,0,14,0,0,0,75,53,18,0,10,3851
621,621,0,470,151,1973,644,192900,546,75,87.92,12.08,119,14,98,102,296,15,71,12,0,0,0,345,16,14,11,3852
286,268,18,233,35,1988,0,158300,180,106,62.94,37.06,160,89,119,19,33,0,21,0,0,0,138,223,16,10,12,3853
324,324,0,252,72,1998,717,95000,278,46,85.80,14.20,154,18,0,23,83,53,120,0,0,0,82,10,0,13,0,3854
193,193,0,182,11,1984,0,232400,169,24,87.56,12.44,24,20,134,12,213,34,119,0,0,0,75,89,86,0,0,3855
574,557,17,460,97,1991,1000,245500,441,133,76.83,23.17,250,69,41,40,77,0,11,17,59,35,44,187,54,39,14,3856
585,529,56,480,49,1979,1181,151100,409,176,69.91,30.09,153,155,259,96,31,0,42,84,0,0,16,314,127,0,0,3857
391,391,0,374,17,2003,0,368800,375,16,95.91,4.09,196,38,113,8,0,0,0,11,0,0,79,28,58,105,27,3858
596,596,0,494,102,1996,1135,218800,317,279,53.19,46.81,321,208,104,46,16,13,38,23,0,0,61,274,155,25,55,3859
891,788,103,634,154,1993,1082,192500,708,183,79.46,20.54,405,103,199,29,57,0,162,23,0,0,89,232,188,14,11,3860
491,491,0,300,191,1998,1130,354300,420,71,85.54,14.46,189,59,162,20,23,6,32,9,0,9,37,68,199,40,27,3861
1297,1256,41,656,600,2001,1131,200600,1017,280,78.41,21.59,555,123,164,23,102,76,139,130,125,30,24,342,33,30,38,3862
489,471,18,326,145,1994,1280,247200,405,84,82.82,17.18,221,6,140,39,185,0,72,26,0,0,71,195,79,35,26,3863
373,343,30,298,45,1989,1225,137500,282,91,75.60,24.40,161,28,96,24,49,0,20,19,0,0,50,207,47,0,15,3864
555,463,92,383,80,1985,1313,475000,530,25,95.50,4.50,261,94,84,35,99,0,28,31,9,12,15,15,38,60,281,3865
303,218,85,152,66,1964,616,133900,244,59,80.53,19.47,43,12,25,18,161,30,15,0,0,0,47,94,7,0,0,3866
786,575,211,482,93,1987,1061,196900,605,181,76.97,23.03,294,195,146,55,145,0,0,0,0,0,32,224,65,25,95,3867
1456,777,679,583,194,1986,1095,489600,1260,196,86.54,13.46,481,297,269,157,175,22,150,36,4,0,19,92,97,89,217,3868
788,635,153,390,245,1953,578,152700,616,172,78.17,21.83,131,52,121,91,536,127,100,16,0,0,63,205,58,47,68,3869
1420,588,832,512,76,1991,1132,684400,1315,105,92.61,7.39,815,290,238,105,184,5,22,70,42,0,7,54,93,28,431,3870
758,682,76,589,93,1973,1525,284100,659,99,86.94,13.06,316,102,204,0,179,35,53,68,13,0,32,180,107,70,109,3871
620,582,38,498,84,1977,540,260600,520,100,83.87,16.13,178,14,81,29,168,0,72,0,0,0,0,116,101,39,90,3872
569,471,98,338,133,1984,616,164400,352,217,61.86,38.14,183,50,153,55,42,21,29,6,0,0,136,148,39,3,17,3873
504,301,203,138,163,1995,1018,485700,379,125,75.20,24.80,117,31,22,57,55,27,23,0,0,6,11,9,27,6,23,3874
993,545,448,489,56,1978,762,228200,748,245,75.33,24.67,320,145,152,142,258,0,45,34,0,0,56,273,113,20,67,3875
636,447,189,327,120,1978,494,145200,450,186,70.75,29.25,169,71,90,51,161,10,3,0,0,0,96,153,33,10,32,3876
976,939,37,628,311,1990,797,219700,472,504,48.36,51.64,404,101,128,23,76,11,69,0,0,0,128,207,209,13,13,3877
454,394,60,287,107,1985,724,183600,354,100,77.97,22.03,147,68,139,36,69,0,14,0,0,0,121,165,85,24,0,3878
615,610,5,468,142,1992,687,231200,461,154,74.96,25.04,243,125,107,21,59,17,104,0,0,0,67,181,127,28,6,3879
1459,1369,90,1204,165,1990,925,195100,813,646,55.72,44.28,596,108,217,84,173,13,63,0,14,0,116,471,155,65,79,3880
333,308,25,233,75,1979,467,79300,183,150,54.95,45.05,126,119,56,41,7,32,0,7,0,0,117,74,28,11,0,3881
530,485,45,284,201,1985,505,77900,398,132,75.09,24.91,176,57,130,115,13,79,35,0,17,0,107,104,12,11,13,3882
675,599,76,471,128,1978,718,161700,499,176,73.93,26.07,200,137,121,121,108,33,115,7,0,0,70,243,90,15,21,3883
623,502,121,421,81,1991,1165,310900,435,188,69.82,30.18,157,49,148,25,190,0,37,11,0,0,78,153,43,107,50,3884
415,333,82,233,100,1958,765,122000,344,71,82.89,17.11,109,36,79,9,318,32,101,4,0,0,80,121,60,44,13,3885
376,260,116,137,123,1983,695,112500,234,142,62.23,37.77,95,40,82,4,113,6,26,10,0,0,77,98,38,0,28,3886
767,617,150,491,126,1981,742,216000,597,170,77.84,22.16,164,120,259,54,53,0,14,38,0,0,48,235,83,19,5,3887
213,193,20,147,46,1989,1125,132000,166,47,77.93,22.07,79,46,65,26,53,26,22,0,0,0,133,88,0,0,0,3888
862,811,51,648,163,1985,885,257300,652,210,75.64,24.36,399,152,85,48,165,28,22,17,22,0,66,151,198,116,50,3889
366,298,68,238,60,1981,902,150000,240,126,65.57,34.43,121,49,95,14,119,16,35,0,0,0,73,157,38,0,11,3890
604,480,124,363,117,1976,988,174400,455,149,75.33,24.67,281,28,113,63,153,13,43,39,0,0,81,226,98,33,12,3891
276,205,71,152,53,1967,0,280600,218,58,78.99,21.01,170,87,99,0,125,0,65,66,0,0,40,144,42,58,21,3892
494,412,82,320,92,1979,938,290400,364,130,73.68,26.32,161,22,170,51,110,0,21,0,0,0,11,194,127,13,0,3893
533,465,68,336,129,1962,619,179900,441,92,82.74,17.26,55,59,95,61,137,13,13,6,0,0,82,148,46,0,25,3894
389,325,64,214,111,1961,1000,309100,345,44,88.69,11.31,93,6,34,0,222,0,38,16,3,6,12,43,86,28,69,3895
1159,1043,116,829,214,1993,468,294900,879,280,75.84,24.16,511,218,238,79,200,0,95,22,19,0,95,492,199,89,162,3896
516,466,50,339,127,1991,443,307100,271,245,52.52,47.48,334,68,71,0,66,0,0,18,0,0,37,147,150,69,87,3897
554,435,119,340,95,1970,595,114500,409,145,73.83,26.17,113,37,104,48,231,31,7,0,0,0,177,101,40,3,32,3898
518,504,14,334,170,1964,752,155400,487,31,94.02,5.98,80,107,33,86,220,63,47,0,6,0,47,171,38,20,11,3899
523,467,56,377,90,1965,882,166100,506,17,96.75,3.25,38,64,154,106,130,0,42,25,0,0,41,289,43,0,52,3900
412,381,31,308,73,1971,673,112500,364,48,88.35,11.65,109,83,29,28,225,18,136,0,0,0,58,106,49,0,14,3901
644,635,9,526,109,1974,830,205100,473,171,73.45,26.55,336,67,41,27,149,48,58,0,0,0,97,207,95,0,38,3902
260,204,56,138,66,1947,898,226600,241,19,92.69,7.31,8,26,14,72,93,12,22,0,0,0,15,109,19,14,13,3903
678,650,28,422,228,1983,1013,158600,549,129,80.97,19.03,211,78,121,0,225,0,62,23,0,0,96,348,53,0,11,3904
254,179,75,110,69,1979,725,208300,174,80,68.50,31.50,46,10,78,0,89,17,31,0,0,0,53,84,0,9,0,3905
511,190,321,159,31,1987,950,193300,421,90,82.39,17.61,139,83,150,109,45,0,3,14,0,0,28,94,66,34,0,3906
458,458,0,313,145,1952,766,146300,367,91,80.13,19.87,12,16,0,44,371,13,24,16,0,0,12,254,69,20,0,3907
574,443,131,37,406,1939,473,86300,172,402,29.97,70.03,13,30,63,82,409,306,125,21,0,0,32,43,0,0,0,3908
771,746,25,599,147,1979,1121,262700,659,112,85.47,14.53,188,149,218,65,110,0,15,0,0,0,45,355,257,0,26,3909
243,226,17,173,53,1984,1094,123800,176,67,72.43,27.57,93,30,73,7,85,16,24,0,0,0,60,125,6,0,3,3910
605,605,0,499,106,1991,630,157600,510,95,84.30,15.70,134,57,193,31,189,34,69,12,0,0,94,181,76,0,12,3911
885,740,145,553,187,1978,941,416900,798,87,90.17,9.83,340,115,130,77,200,26,66,55,11,3,16,85,150,73,274,3912
1269,1164,105,925,239,1994,1354,345600,1133,136,89.28,10.72,676,205,125,45,64,9,43,53,21,27,19,154,364,154,194,3913
1170,1098,72,844,254,1992,1371,328400,1088,82,92.99,7.01,642,179,90,66,171,4,13,50,50,12,16,161,396,171,178,3914
533,519,14,485,34,1982,0,368200,487,46,91.37,8.63,298,73,49,0,133,0,0,0,0,0,18,178,159,21,139,3915
527,440,87,237,203,1939,808,176000,394,133,74.76,25.24,74,0,121,30,457,76,108,44,35,0,0,142,96,9,28,3916
301,232,69,195,37,1988,1681,455900,233,68,77.41,22.59,59,90,13,17,93,0,11,21,0,0,9,13,42,51,47,3917
277,226,51,105,121,1968,0,213200,191,86,68.95,31.05,18,0,94,35,206,134,67,0,0,0,28,68,21,0,14,3918
240,240,0,134,106,1974,0,139000,144,96,60.00,40.00,51,28,74,10,220,28,152,30,0,0,52,51,47,0,0,3919
458,387,71,281,106,1967,503,121200,318,140,69.43,30.57,83,33,87,36,211,61,53,12,6,0,77,213,4,0,3,3920
572,507,65,372,135,1957,625,116400,494,78,86.36,13.64,103,99,51,9,277,20,51,0,0,0,129,187,27,11,0,3921
474,329,145,261,68,1961,555,112500,321,153,67.72,32.28,47,30,75,58,305,25,39,6,0,0,154,142,53,5,0,3922
1100,675,425,431,244,1991,879,396500,870,230,79.09,20.91,384,197,210,65,182,58,101,50,22,0,20,78,92,33,208,3923
243,208,35,25,183,1973,997,212500,78,165,32.10,67.90,83,18,46,37,163,50,175,34,0,0,18,0,0,0,0,3924
593,593,0,478,115,1994,1474,366100,560,33,94.44,5.56,118,102,124,73,138,0,9,43,10,0,11,110,179,50,82,3925
584,559,25,385,174,1966,1005,213700,490,94,83.90,16.10,96,69,83,248,244,0,164,18,0,0,28,351,119,0,11,3926
1254,851,403,738,113,1986,1181,277600,1179,75,94.02,5.98,562,187,263,33,153,0,65,19,0,0,23,174,356,87,136,3927
746,568,178,439,129,1984,1272,206100,659,87,88.34,11.66,435,110,44,79,48,0,32,30,0,0,32,282,114,30,58,3928
889,692,197,534,158,1985,0,266800,839,50,94.38,5.62,374,111,117,158,34,0,0,47,0,0,19,151,265,122,68,3929
729,672,57,332,340,1982,840,295300,538,191,73.80,26.20,147,150,145,72,232,67,108,73,11,0,19,60,190,54,72,3930
452,432,20,0,432,2000,1423,0,432,20,95.58,4.42,121,13,124,22,83,0,92,181,58,0,0,17,0,0,0,3931
712,353,359,247,106,1974,858,485300,667,45,93.68,6.32,201,54,158,99,238,0,0,0,17,12,12,54,58,50,124,3932
1007,858,149,759,99,1991,881,335300,894,113,88.78,11.22,417,138,172,25,38,23,93,59,38,0,10,166,132,83,148,3933
835,673,162,380,293,1981,1142,418300,644,191,77.13,22.87,258,154,135,52,225,69,209,52,13,0,0,55,110,80,122,3934
876,724,152,606,118,1995,1096,324800,781,95,89.16,10.84,472,75,114,48,236,10,11,127,36,0,0,165,222,49,152,3935
399,399,0,216,183,1949,927,103600,373,26,93.48,6.52,0,10,85,20,548,30,265,0,0,0,76,262,0,0,0,3936
366,366,0,308,58,1951,1258,123600,357,9,97.54,2.46,13,15,0,0,427,0,22,23,0,5,125,256,0,0,0,3937
383,370,13,305,65,1945,921,112100,383,0,100.00,0.00,0,0,0,0,279,0,0,25,0,0,53,137,15,0,0,3938
951,884,67,783,101,1967,1305,202300,943,8,99.16,0.84,116,65,71,387,163,0,0,0,15,0,31,592,142,18,4,3939
386,386,0,386,0,1993,0,233100,386,0,100.00,0.00,318,17,20,0,17,0,0,0,0,0,0,173,119,30,0,3940
316,293,23,268,25,1976,1125,236000,307,9,97.15,2.85,44,41,159,69,10,0,10,0,4,0,28,129,137,0,0,3941
401,401,0,351,50,1980,0,240000,401,0,100.00,0.00,186,39,142,19,0,0,0,24,0,0,0,190,139,10,23,3942
708,679,29,620,59,1989,0,277900,708,0,100.00,0.00,333,77,196,44,3,0,0,0,12,0,0,145,334,128,11,3943
581,539,42,476,63,1963,970,371300,572,9,98.45,1.55,121,26,42,125,154,0,0,0,0,0,0,112,176,48,116,3944
821,757,64,525,232,1968,1060,246800,747,74,90.99,9.01,38,64,32,288,217,14,108,20,0,11,0,297,164,25,0,3945
958,958,0,708,250,1961,730,133700,626,332,65.34,34.66,49,72,243,139,515,24,280,44,0,0,92,503,41,0,0,3946
1197,1184,13,351,833,1991,750,129000,348,849,29.07,70.93,379,92,236,118,194,111,462,25,0,0,130,176,24,0,0,3947
398,398,0,310,88,1974,1050,177800,363,35,91.21,8.79,11,17,227,0,118,17,29,16,0,0,38,200,12,0,0,3948
1426,1268,158,502,766,1995,872,215000,653,773,45.79,54.21,399,129,476,87,13,0,503,77,0,0,28,307,88,0,0,3949
634,585,49,365,220,1966,878,165900,487,147,76.81,23.19,48,55,94,96,293,28,204,11,0,0,27,285,31,0,0,3950
788,738,50,387,351,1977,1098,147700,481,307,61.04,38.96,294,9,183,16,266,108,97,11,33,73,14,359,0,0,0,3951
279,249,30,223,26,1973,0,185300,279,0,100.00,0.00,47,28,103,60,9,0,0,0,0,0,0,118,112,17,0,3952
512,502,10,395,107,1974,853,182100,465,47,90.82,9.18,78,52,389,28,18,0,86,42,0,0,11,383,32,0,0,3953
223,207,16,176,31,1967,816,90000,112,111,50.22,49.78,21,14,67,62,158,0,170,0,0,0,94,24,9,0,0,3954
472,472,0,410,62,1955,0,140100,472,0,100.00,0.00,17,0,15,0,364,0,0,59,0,0,0,320,17,0,0,3955
853,810,43,606,204,1978,917,301300,733,120,85.93,14.07,317,123,225,30,100,0,33,70,40,0,17,207,223,63,108,3956
2044,1513,531,1388,125,1995,1375,317600,1839,205,89.97,10.03,1053,507,499,83,43,0,75,197,38,0,14,628,225,125,374,3957
730,670,60,584,86,1977,0,228500,563,167,77.12,22.88,190,47,401,21,175,36,96,32,0,0,21,124,242,79,122,3958
1053,341,712,268,73,1984,995,252300,852,201,80.91,19.09,133,281,165,143,200,11,58,0,19,0,27,87,72,25,16,3959
1156,1033,123,695,338,1981,578,155900,773,383,66.87,33.13,531,121,142,115,135,85,127,37,0,0,178,217,102,62,73,3960
355,327,28,248,79,1975,809,151100,234,121,65.92,34.08,114,15,184,22,6,0,111,0,0,0,60,168,0,0,0,3961
1061,980,81,904,76,1991,956,159200,687,374,64.75,35.25,424,277,189,162,103,0,193,42,0,0,210,303,180,15,42,3962
500,481,19,353,128,1971,1009,234100,461,39,92.20,7.80,115,32,137,39,127,0,15,8,15,0,11,196,162,19,0,3963
818,768,50,634,134,1987,1159,276700,776,42,94.87,5.13,342,324,140,48,0,0,94,31,0,0,0,142,400,96,42,3964
497,475,22,354,121,1990,521,239400,382,115,76.86,23.14,193,22,98,33,52,42,39,0,0,0,29,119,83,11,40,3965
705,566,139,392,174,1981,1086,224000,553,152,78.44,21.56,274,94,178,36,53,16,84,113,0,0,63,160,75,42,70,3966
465,465,0,368,97,1986,0,232200,442,23,95.05,4.95,69,167,160,0,18,0,29,24,0,0,0,200,151,0,10,3967
432,409,23,393,16,1980,0,227500,432,0,100.00,0.00,14,175,188,0,13,0,0,10,13,0,9,173,185,0,0,3968
360,360,0,337,23,1984,771,228500,286,74,79.44,20.56,97,47,86,11,124,0,25,0,0,0,41,112,95,32,47,3969
579,579,0,410,169,1980,1090,0,219,360,37.82,62.18,129,92,136,45,72,0,21,0,0,0,176,179,0,9,11,3970
944,944,0,570,374,1975,790,161800,642,302,68.01,31.99,63,57,314,199,427,41,280,33,0,0,110,561,11,0,0,3971
1332,1178,154,147,1031,1998,748,154100,220,1112,16.52,83.48,767,129,183,0,135,61,882,36,0,0,35,104,0,0,0,3972
505,469,36,320,149,1956,631,109300,423,82,83.76,16.24,31,9,75,25,418,44,56,21,0,0,158,194,0,0,0,3973
1256,1256,0,603,653,1996,1220,198300,309,947,24.60,75.40,1240,112,10,65,61,75,275,86,46,65,0,423,238,15,72,3974
439,382,57,326,56,1979,0,383800,420,19,95.67,4.33,245,46,38,24,13,0,0,69,0,0,13,23,61,45,144,3975
698,668,30,262,406,1946,786,314000,361,337,51.72,48.28,43,89,140,18,326,53,186,35,89,0,17,27,95,26,7,3976
786,694,92,662,32,1994,0,374300,773,13,98.35,1.65,434,74,278,25,12,0,0,9,17,0,33,56,372,194,130,3977
441,441,0,118,323,1979,717,316700,116,325,26.30,73.70,126,14,27,19,188,37,109,92,0,0,0,22,96,8,10,3978
1061,901,160,790,111,1993,882,308200,935,126,88.12,11.88,498,169,186,58,67,0,120,41,0,0,0,195,282,103,124,3979
936,684,252,529,155,1987,867,273800,691,245,73.82,26.18,359,170,120,113,72,0,29,43,0,0,6,206,135,56,152,3980
1806,1679,127,1212,467,1998,903,312000,1350,456,74.75,25.25,928,152,152,42,145,52,268,35,0,40,67,247,403,165,109,3981
778,556,222,359,197,1978,917,162800,531,247,68.25,31.75,336,157,124,69,90,89,22,0,0,0,39,391,102,4,0,3982
417,417,0,132,285,1991,593,120600,177,240,42.45,57.55,139,13,64,0,251,65,0,0,0,0,25,204,24,0,21,3983
548,512,36,307,205,1980,779,119700,402,146,73.36,26.64,126,57,135,42,170,53,140,10,0,0,101,133,24,16,0,3984
872,650,222,390,260,1992,700,237300,687,185,78.78,21.22,199,94,147,109,195,29,237,13,15,0,20,124,189,28,49,3985
778,634,144,566,68,1993,1725,374300,728,50,93.57,6.43,383,143,231,85,38,42,29,46,0,0,43,113,113,76,107,3986
663,495,168,469,26,1998,0,407900,637,26,96.08,3.92,610,18,19,17,23,0,0,5,26,0,0,53,160,167,150,3987
1002,624,378,546,78,1991,0,285400,790,212,78.84,21.16,577,175,362,0,11,0,0,65,0,0,0,206,329,174,125,3988
853,754,99,526,228,1994,968,339400,811,42,95.08,4.92,497,60,92,23,92,0,92,47,0,14,18,187,160,76,89,3989
663,602,61,441,161,1995,863,214100,481,182,72.55,27.45,392,115,97,30,54,39,40,49,0,0,10,345,171,0,8,3990
1453,1278,175,944,334,1980,939,472200,1062,391,73.09,26.91,302,225,237,63,406,97,108,60,0,0,0,42,223,135,441,3991
671,640,31,177,463,1975,905,443100,223,448,33.23,66.77,207,13,65,34,317,0,214,61,56,0,0,25,44,59,97,3992
212,182,30,125,57,1979,474,100800,181,31,85.38,14.62,52,70,79,27,31,68,18,0,10,0,84,31,14,0,0,3993
575,482,93,170,312,1957,608,134800,15,560,2.61,97.39,22,56,110,18,393,40,106,51,0,9,19,143,12,32,9,3994
286,286,0,123,163,1982,732,108100,85,201,29.72,70.28,178,113,62,0,106,10,188,96,0,25,18,52,12,0,0,3995
749,724,25,244,480,2001,881,206000,392,357,52.34,47.66,370,111,0,0,0,77,32,0,0,0,11,267,82,0,0,3996
1559,1431,128,448,983,1998,790,253700,491,1068,31.49,68.51,909,200,181,67,0,46,497,90,70,113,0,169,244,14,9,3997
386,386,0,325,61,1978,943,151300,85,301,22.02,77.98,204,135,153,46,0,0,18,0,0,0,288,190,11,0,31,3998
909,727,182,578,149,1979,970,301000,581,328,63.92,36.08,387,37,181,136,168,13,166,72,46,0,12,96,168,51,234,3999
693,659,34,611,48,1994,779,342300,624,69,90.04,9.96,459,149,128,0,22,0,27,0,0,0,10,65,294,161,201,4000
856,731,125,9,722,1987,1169,0,692,164,80.84,19.16,314,257,151,184,137,0,121,240,39,0,0,0,0,0,9,4001
1435,1246,189,346,900,2003,847,207300,528,907,36.79,63.21,736,40,163,42,28,134,344,58,33,0,55,209,111,0,14,4002
546,509,37,421,88,1980,0,224600,392,154,71.79,28.21,187,64,87,31,73,0,0,12,0,0,32,194,103,24,11,4003
394,394,0,317,77,1973,871,274100,258,136,65.48,34.52,96,57,60,0,83,0,15,0,0,0,17,144,44,30,0,4004
602,510,92,267,243,1969,675,155200,388,214,64.45,35.55,62,134,172,165,184,37,227,23,0,0,26,257,19,0,0,4005
1037,587,450,511,76,1981,0,354500,999,38,96.34,3.66,147,95,138,79,75,13,17,11,0,0,75,78,160,74,32,4006
761,761,0,617,144,1995,0,304500,664,97,87.25,12.75,354,63,193,56,40,0,43,35,0,0,0,260,209,64,58,4007
512,371,141,218,153,1972,792,170700,394,118,76.95,23.05,42,33,119,37,221,0,71,11,0,0,37,210,78,15,13,4008
1082,947,135,586,361,1951,1524,258500,772,310,71.35,28.65,135,146,74,105,706,9,96,109,132,174,0,139,392,38,0,4009
1117,893,224,403,490,1993,724,340200,588,529,52.64,47.36,692,76,142,48,0,52,521,38,0,0,0,42,149,56,63,4010
461,461,0,244,217,1973,946,246600,324,137,70.28,29.72,235,16,144,117,139,0,116,244,0,0,0,60,182,35,14,4011
735,619,116,275,344,1986,991,224600,434,301,59.05,40.95,354,35,126,17,186,77,101,59,0,0,0,212,143,0,48,4012
254,254,0,229,25,1977,0,350000,182,72,71.65,28.35,180,14,41,42,50,0,0,0,0,0,0,61,90,78,98,4013
1070,770,300,587,183,1985,1106,395100,1002,68,93.64,6.36,533,299,118,92,96,43,82,65,0,0,13,159,203,30,355,4014
359,272,87,195,77,1963,1199,334300,359,0,100.00,0.00,68,35,74,28,152,11,0,0,0,0,0,35,96,20,73,4015
507,476,31,190,286,1987,1244,231900,246,261,48.52,51.48,186,128,142,23,11,0,123,62,17,14,37,163,52,22,0,4016
442,387,55,344,43,1980,818,317800,385,57,87.10,12.90,143,34,65,35,216,28,28,0,0,0,11,109,166,34,86,4017
735,675,60,565,110,1990,0,115800,664,71,90.34,9.66,62,58,209,118,137,30,0,0,0,0,64,80,0,13,0,4018
675,620,55,351,269,1974,609,156200,414,261,61.33,38.67,119,19,98,112,291,137,101,0,0,0,113,151,12,0,6,4019
434,385,49,144,241,1977,627,340000,215,219,49.54,50.46,79,21,66,81,161,57,139,0,0,0,15,122,0,14,24,4020
590,515,75,136,379,1971,551,254300,105,485,17.80,82.20,0,12,176,88,310,114,256,0,0,0,32,39,9,19,44,4021
833,717,116,153,564,1939,560,104100,119,714,14.29,85.71,45,6,63,99,468,234,232,0,0,10,16,13,0,0,0,4022
379,379,0,225,154,1939,855,245600,285,94,75.20,24.80,0,33,80,22,290,41,102,24,0,0,11,148,54,0,11,4023
501,501,0,427,74,1949,1129,169800,485,16,96.81,3.19,0,0,13,17,513,16,46,67,0,0,0,414,0,0,0,4024
450,425,25,300,125,1943,945,265300,388,62,86.22,13.78,12,40,0,35,346,0,65,13,0,0,0,197,105,21,32,4025
803,716,87,54,662,1983,671,157400,87,716,10.83,89.17,351,198,271,20,0,100,470,40,0,98,0,68,0,0,0,4026
422,414,8,380,34,1956,1224,165800,405,17,95.97,4.03,16,0,45,43,326,0,31,24,0,0,11,318,46,0,0,4027
284,284,0,95,189,1975,736,164500,163,121,57.39,42.61,17,71,136,42,17,34,37,24,0,0,42,129,0,0,0,4028
360,360,0,336,24,1975,0,207900,258,102,71.67,28.33,107,65,129,0,62,0,18,0,0,0,37,191,105,0,0,4029
738,738,0,738,0,1993,0,283900,738,0,100.00,0.00,476,112,52,0,11,0,18,0,0,0,0,119,436,61,17,4030
655,613,42,613,0,1975,0,201800,655,0,100.00,0.00,71,86,196,110,96,0,39,60,0,0,18,241,101,8,42,4031
763,763,0,725,38,1990,0,313800,709,54,92.92,7.08,368,115,255,0,25,0,15,0,0,0,38,182,176,8,298,4032
667,647,20,525,122,1995,753,348500,529,138,79.31,20.69,366,62,75,39,173,80,100,0,0,23,143,121,76,46,105,4033
451,435,16,342,93,1984,0,250700,410,41,90.91,9.09,255,81,132,0,11,0,43,85,0,0,14,93,129,70,45,4034
625,564,61,313,251,1946,676,166700,481,144,76.96,23.04,15,75,139,83,405,91,187,34,0,0,18,201,51,10,0,4035
701,673,28,536,137,1985,1320,326500,637,64,90.87,9.13,323,50,168,16,50,0,18,20,0,0,18,153,177,63,62,4036
1336,1128,208,906,222,1987,1223,314400,1240,96,92.81,7.19,458,130,399,179,99,0,135,52,0,0,23,162,328,39,293,4037
681,432,249,324,108,1991,681,174000,446,235,65.49,34.51,132,130,137,154,84,3,57,0,0,0,88,168,31,20,23,4038
414,371,43,181,190,1939,860,81300,395,19,95.41,4.59,0,0,37,0,322,14,43,12,0,0,126,96,0,0,0,4039
431,416,15,96,320,1945,674,85000,211,220,48.96,51.04,0,0,180,10,344,31,230,16,0,0,96,18,0,0,0,4040
371,289,82,264,25,1955,0,213900,371,0,100.00,0.00,7,12,10,58,303,0,8,0,0,0,31,113,119,8,12,4041
527,491,36,316,175,1940,805,127100,470,57,89.18,10.82,81,0,20,72,324,24,101,19,0,0,156,121,36,6,0,4042
645,554,91,132,422,1939,534,106700,290,355,44.96,55.04,33,60,128,105,423,165,299,0,11,28,31,134,9,0,0,4043
257,170,87,128,42,1968,692,175000,168,89,65.37,34.63,15,93,126,0,68,0,37,0,0,0,125,96,3,0,15,4044
568,547,21,287,260,1979,693,163100,347,221,61.09,38.91,53,27,230,55,259,0,220,0,0,0,43,291,30,40,0,4045
442,359,83,301,58,1979,971,206700,363,79,82.13,17.87,166,12,78,25,112,0,67,11,0,0,28,213,60,0,4,4046
544,284,260,199,85,1974,0,185800,342,202,62.87,37.13,177,82,267,134,57,0,48,0,0,0,105,101,24,18,38,4047
393,272,121,185,87,1972,677,202600,307,86,78.12,21.88,66,36,61,46,131,11,37,0,0,0,102,48,19,3,19,4048
244,212,32,129,83,1977,409,83500,129,115,52.87,47.13,23,84,113,17,88,64,20,0,0,0,89,60,11,0,0,4049
546,503,43,225,278,1968,563,135500,240,306,43.96,56.04,73,0,96,17,501,168,167,53,0,0,14,158,0,0,0,4050
542,334,208,276,58,1990,0,242600,392,150,72.32,27.68,202,108,37,48,46,0,0,0,0,0,0,52,89,52,32,4051
533,476,57,239,237,1992,582,253100,298,235,55.91,44.09,257,9,115,90,129,64,123,7,29,0,0,105,158,32,28,4052
355,305,50,200,105,1980,443,101400,210,145,59.15,40.85,101,91,58,8,35,48,8,3,0,0,69,87,8,2,0,4053
403,365,38,232,133,1976,689,188100,261,142,64.76,35.24,90,43,191,34,113,19,75,19,15,0,35,48,23,0,5,4054
358,209,149,134,75,1987,767,220000,267,91,74.58,25.42,75,52,86,16,78,5,16,0,0,0,12,99,55,11,3,4055
372,308,64,150,158,1973,0,119200,241,131,64.78,35.22,38,28,63,11,61,0,0,0,0,0,82,30,20,11,0,4056
311,274,37,255,19,1976,0,170200,238,73,76.53,23.47,124,127,68,43,106,0,58,0,0,0,123,124,18,58,55,4057
916,871,45,133,738,1968,1396,165800,500,416,54.59,45.41,49,103,276,437,132,15,219,332,61,0,17,49,86,0,0,4058
680,672,8,595,77,1994,1259,343000,640,40,94.12,5.88,258,97,299,48,96,0,62,63,0,0,75,150,202,128,98,4059
534,498,36,460,38,1987,0,235300,466,68,87.27,12.73,810,172,156,0,7,0,19,81,128,14,12,415,328,52,0,4060
728,595,133,504,91,1981,0,304300,582,146,79.95,20.05,111,177,205,79,68,11,38,96,0,10,38,139,221,41,28,4061
364,355,9,198,157,1975,895,264800,251,113,68.96,31.04,63,49,130,56,61,20,90,68,0,0,0,93,45,33,0,4062
447,393,54,337,56,1977,1604,390400,410,37,91.72,8.28,139,20,142,55,57,0,8,0,0,9,12,46,42,90,139,4063
607,584,23,536,48,1978,820,259300,488,119,80.40,19.60,102,54,57,62,240,0,9,24,10,0,53,139,138,64,44,4064
301,246,55,150,96,1961,1188,187100,296,5,98.34,1.66,18,11,30,156,163,0,12,53,66,0,0,232,15,0,0,4065
457,457,0,316,141,1990,1133,263200,413,44,90.37,9.63,224,14,106,68,16,0,0,0,5,0,0,196,124,53,50,4066
782,782,0,672,110,1999,1137,291500,700,82,89.51,10.49,296,34,122,17,75,0,56,0,0,0,13,87,206,98,14,4067
1035,1004,31,627,377,2002,1330,238200,875,160,84.54,15.46,497,214,148,48,8,0,106,114,26,0,8,119,370,46,17,4068
406,396,10,343,53,1975,1685,291400,396,10,97.54,2.46,22,43,239,101,0,0,45,34,0,26,0,22,149,56,48,4069
640,606,34,387,219,2001,1297,245800,514,126,80.31,19.69,339,81,87,0,14,0,31,31,13,0,0,52,275,43,27,4070
790,741,49,200,541,1979,1011,243100,386,404,48.86,51.14,120,208,342,156,18,66,431,64,18,10,93,62,67,0,0,4071
624,581,43,413,168,1978,1353,247100,532,92,85.26,14.74,103,93,320,49,0,0,0,98,10,0,0,191,266,0,0,4072
580,536,44,406,130,1989,1151,200600,547,33,94.31,5.69,191,331,53,0,0,0,0,40,0,0,0,439,96,0,0,4073
702,702,0,32,670,1985,909,0,78,624,11.11,88.89,72,329,156,30,298,177,398,143,0,0,0,26,0,0,16,4074
832,694,138,400,294,1978,1282,182900,630,202,75.72,24.28,221,192,312,106,57,13,75,168,23,7,46,336,220,0,0,4075
449,449,0,227,222,1967,1095,202400,296,153,65.92,34.08,241,178,50,63,212,0,199,134,0,0,14,177,138,19,0,4076
464,421,43,410,11,1973,0,183600,423,41,91.16,8.84,0,10,215,56,40,0,27,0,0,0,0,198,86,10,0,4077
2782,2699,83,1164,1535,1998,924,277400,1268,1514,45.58,54.42,1647,280,179,283,262,221,1033,151,82,74,149,358,337,69,77,4078
917,902,15,839,63,1975,796,352300,845,72,92.15,7.85,394,107,142,13,208,0,46,0,0,0,16,160,172,158,216,4079
1433,1433,0,662,771,1957,881,227300,938,495,65.46,34.54,369,130,107,78,611,113,379,171,0,0,14,189,262,41,0,4080
1132,1008,124,902,106,1989,954,381100,1044,88,92.23,7.77,529,267,88,43,74,0,21,26,0,19,19,42,304,78,398,4081
829,531,298,464,67,1989,1335,455800,736,93,88.78,11.22,331,152,173,43,99,23,82,19,4,4,11,67,28,102,254,4082
613,440,173,353,87,1975,854,275000,465,148,75.86,24.14,123,193,44,103,119,17,121,11,0,0,17,117,126,0,46,4083
827,583,244,475,108,1993,643,194100,609,218,73.64,26.36,239,104,149,152,79,0,0,19,0,0,0,125,59,35,83,4084
352,264,88,200,64,1978,0,240000,277,75,78.69,21.31,104,85,94,28,0,0,24,11,0,0,13,135,46,16,14,4085
1175,797,378,650,147,1990,1288,146200,828,347,70.47,29.53,710,79,263,199,59,17,16,19,0,0,187,630,133,31,32,4086
872,640,232,494,146,1994,935,178200,615,257,70.53,29.47,422,46,188,26,52,0,40,40,0,0,35,289,131,5,6,4087
839,687,152,570,117,1977,1520,156500,698,141,83.19,16.81,417,252,380,33,49,0,104,57,0,0,63,420,62,0,15,4088
513,234,279,155,79,1987,0,290100,362,151,70.57,29.43,122,38,216,47,243,0,32,0,0,0,13,90,33,46,139,4089
476,443,33,257,186,1965,617,97900,350,126,73.53,26.47,61,33,100,55,275,98,87,0,0,0,95,125,5,4,0,4090
1160,1043,117,638,405,1984,810,192400,711,449,61.29,38.71,503,296,235,84,52,54,83,9,0,31,171,319,278,47,38,4091
341,313,28,96,217,1945,744,137500,217,124,63.64,36.36,0,0,12,32,253,55,79,12,0,0,35,62,8,0,0,4092
328,303,25,98,205,1969,656,297400,173,155,52.74,47.26,27,82,83,0,138,73,69,0,0,0,14,77,25,11,0,4093
627,573,54,394,179,1985,1138,158900,528,99,84.21,15.79,232,73,182,50,141,52,60,72,9,0,55,298,110,0,0,4094
419,359,60,338,21,1980,981,250000,381,38,90.93,9.07,270,59,78,55,59,0,0,51,0,0,0,167,111,60,22,4095
560,525,35,455,70,1984,852,338200,499,61,89.11,10.89,197,26,57,0,164,0,20,11,0,0,18,118,44,52,107,4096
972,931,41,829,102,1996,1614,320000,907,65,93.31,6.69,413,128,46,35,68,0,51,0,0,0,32,129,332,73,35,4097
1353,1259,94,1095,164,2000,1309,241000,1311,42,96.90,3.10,819,75,159,39,64,0,12,0,12,0,24,403,358,132,92,4098
712,712,0,687,25,1993,0,396000,652,60,91.57,8.43,353,74,123,56,21,14,29,0,0,0,15,80,223,51,202,4099
650,549,101,280,269,1973,613,125800,363,287,55.85,44.15,162,72,251,0,243,93,206,0,0,0,155,146,44,0,0,4100
591,540,51,404,136,1991,1250,298300,447,144,75.63,24.37,273,73,77,0,54,0,36,0,0,13,29,64,261,55,19,4101
810,577,233,422,155,1991,1163,424500,671,139,82.84,17.16,108,77,69,121,191,50,89,25,0,0,0,109,133,42,73,4102
362,362,0,323,39,1956,0,154100,362,0,100.00,0.00,0,0,13,88,307,0,28,85,0,0,32,263,0,0,0,4103
296,246,50,178,68,1957,841,133900,228,68,77.03,22.97,0,0,14,0,284,0,93,12,0,0,30,131,0,0,0,4104
489,489,0,451,38,1955,1310,163500,489,0,100.00,0.00,11,0,0,50,438,15,24,80,0,0,49,291,40,0,0,4105
420,346,74,245,101,1944,871,126700,377,43,89.76,10.24,22,0,10,21,425,10,176,44,0,0,64,135,0,0,12,4106
577,525,52,428,97,1944,0,107200,552,25,95.67,4.33,0,20,36,65,434,37,178,23,0,0,30,287,0,0,0,4107
483,441,42,318,123,1948,1033,84000,483,0,100.00,0.00,0,46,59,12,453,0,111,0,0,0,127,239,12,0,0,4108
736,705,31,634,71,1967,905,121800,671,65,91.17,8.83,78,22,181,50,334,0,92,17,0,0,74,386,16,0,8,4109
525,505,20,252,253,1939,793,156500,453,72,86.29,13.71,25,38,0,41,513,38,183,18,0,0,55,186,51,9,21,4110
430,302,128,182,120,1939,926,110400,364,66,84.65,15.35,47,12,47,0,292,0,178,25,0,0,21,154,0,0,0,4111
436,417,19,26,391,1939,508,0,65,371,14.91,85.09,29,0,64,46,412,288,143,20,0,0,14,47,14,0,0,4112
447,357,90,180,177,1939,646,91500,354,93,79.19,20.81,14,0,54,0,248,28,50,0,0,0,36,125,14,0,0,4113
607,573,34,260,313,1971,788,108300,327,280,53.87,46.13,36,89,142,46,409,97,121,13,29,0,208,125,0,11,0,4114
735,659,76,49,610,1970,809,120500,76,659,10.34,89.66,66,28,80,22,320,126,214,0,0,0,0,33,0,0,49,4115
544,517,27,235,282,1954,870,106600,342,202,62.87,37.13,56,105,186,112,324,72,312,46,0,0,104,249,0,0,0,4116
667,534,133,432,102,1991,985,374600,531,136,79.61,20.39,269,94,65,74,146,0,7,18,15,0,30,119,112,92,146,4117
495,472,23,206,266,1995,866,0,162,333,32.73,67.27,458,40,76,49,48,90,315,100,0,0,41,100,25,0,0,4118
262,254,8,218,36,1971,825,228900,198,64,75.57,24.43,26,0,76,70,172,0,33,15,23,0,69,23,92,28,61,4119
480,480,0,301,179,1965,912,188200,412,68,85.83,14.17,44,24,36,94,339,22,79,87,19,0,0,176,154,0,0,4120
623,598,25,524,74,1983,1487,289300,537,86,86.20,13.80,359,102,71,22,102,0,40,0,17,0,21,171,300,99,8,4121
584,553,31,329,224,1972,1180,162100,502,82,85.96,14.04,91,50,81,20,316,8,88,95,0,0,64,247,40,8,0,4122
400,385,15,197,188,1956,1105,255000,340,60,85.00,15.00,84,12,38,29,250,0,64,72,21,6,2,91,100,25,18,4123
307,292,15,234,58,1963,1080,256900,279,28,90.88,9.12,75,20,28,26,127,0,3,38,0,0,3,72,98,33,21,4124
978,922,56,752,170,1980,1053,319500,857,121,87.63,12.37,336,166,234,81,229,10,118,84,0,0,35,75,428,147,149,4125
535,494,41,400,94,1996,980,341400,413,122,77.20,22.80,170,42,140,10,28,0,0,0,0,0,0,110,168,75,8,4126
566,566,0,394,172,1977,867,200900,393,173,69.43,30.57,218,61,203,88,66,12,110,45,13,0,47,194,85,0,50,4127
527,436,91,345,91,1975,1196,234300,418,109,79.32,20.68,216,13,36,15,202,0,8,118,0,0,0,107,132,20,43,4128
677,590,87,505,85,1986,844,168600,447,230,66.03,33.97,224,98,236,24,77,10,108,0,0,0,98,171,95,40,61,4129
693,636,57,442,194,1960,1144,269200,629,64,90.76,9.24,207,49,94,68,288,3,85,72,17,13,12,131,249,47,61,4130
748,642,106,452,190,1957,699,117400,568,180,75.94,24.06,54,31,156,76,527,45,92,4,13,8,247,190,16,19,24,4131
817,739,78,622,117,1977,1078,193900,502,315,61.44,38.56,263,214,181,55,172,10,181,8,0,9,78,317,122,22,20,4132
493,493,0,120,373,1991,864,144000,126,367,25.56,74.44,160,74,123,52,89,16,302,15,0,0,13,94,10,0,0,4133
494,471,23,384,87,1969,682,188200,451,43,91.30,8.70,138,26,118,45,171,0,120,11,0,0,25,179,153,10,0,4134
287,287,0,212,75,1967,0,142900,240,47,83.62,16.38,95,23,106,27,116,0,68,43,0,0,39,161,45,0,0,4135
528,416,112,301,115,1987,831,154600,216,312,40.91,59.09,101,125,168,24,73,27,24,8,0,0,158,99,35,3,51,4136
641,607,34,553,54,1996,0,197000,350,291,54.60,45.40,353,98,33,11,52,0,39,0,0,0,63,314,95,0,28,4137
1650,1596,54,1226,370,2001,1307,274900,1343,307,81.39,18.61,986,72,192,36,150,0,44,63,25,0,56,421,482,132,62,4138
444,413,31,219,194,1964,955,113400,368,76,82.88,17.12,43,9,74,41,301,39,114,19,0,0,87,139,32,0,0,4139
478,409,69,240,169,1972,620,96700,383,95,80.13,19.87,107,89,84,51,127,114,81,0,0,0,130,62,55,0,0,4140
876,876,0,339,537,1953,854,128100,721,155,82.31,17.69,89,21,123,65,706,64,484,19,0,0,156,245,0,11,0,4141
394,394,0,334,60,1968,1353,226000,380,14,96.45,3.55,48,41,129,70,157,46,36,0,13,0,11,219,111,9,0,4142
486,428,58,193,235,1958,851,109200,437,49,89.92,10.08,48,46,58,140,198,0,160,25,0,0,102,163,30,0,0,4143
617,602,15,433,169,1948,775,181000,496,121,80.39,19.61,21,0,66,51,688,0,136,80,0,0,50,431,28,0,21,4144
422,383,39,121,262,1957,709,89700,215,207,50.95,49.05,11,45,32,31,274,79,127,34,0,0,91,42,0,0,0,4145
749,691,58,541,150,1985,660,171600,609,140,81.31,18.69,157,79,245,119,129,52,113,21,0,0,30,458,44,11,0,4146
542,487,55,341,146,1980,0,165400,436,106,80.44,19.56,50,106,28,93,86,0,61,0,0,0,121,124,12,0,23,4147
1414,1324,90,606,718,1980,750,190000,809,605,57.21,42.79,136,123,257,84,329,167,231,73,0,0,62,297,30,21,0,4148
266,266,0,116,150,1994,894,574100,147,119,55.26,44.74,82,54,102,12,52,0,86,0,0,0,58,51,40,0,25,4149
1192,1018,174,318,700,1980,744,0,393,799,32.97,67.03,418,187,423,32,289,88,557,44,15,94,293,101,65,14,0,4150
1099,305,794,263,42,1976,781,225000,872,227,79.34,20.66,148,82,265,287,275,15,10,25,0,0,11,163,39,18,77,4151
509,401,108,326,75,1982,1196,279200,399,110,78.39,21.61,302,134,33,46,13,0,0,0,0,0,35,176,200,25,36,4152
291,291,0,117,174,1954,862,192700,166,125,57.04,42.96,95,38,44,43,189,15,110,12,0,0,30,135,0,0,0,4153
149,112,37,61,51,1954,790,127600,108,41,72.48,27.52,11,8,54,41,224,51,31,8,12,0,58,118,0,0,0,4154
586,546,40,283,263,1941,720,104000,497,89,84.81,15.19,28,100,0,12,372,34,87,43,22,0,90,201,0,0,0,4155
807,734,73,478,256,1981,940,227600,576,231,71.38,28.62,232,59,64,74,185,5,106,43,0,0,25,202,102,4,14,4156
274,218,56,218,0,1979,0,191400,184,90,67.15,32.85,14,54,33,18,115,0,15,77,0,0,0,57,40,0,45,4157
1054,1013,41,772,241,1986,910,217500,837,217,79.41,20.59,307,180,145,90,234,53,138,50,0,0,105,314,155,11,81,4158
886,843,43,635,208,1991,788,209800,443,443,50.00,50.00,430,93,213,119,72,16,136,48,16,0,126,279,183,85,38,4159
283,261,22,174,87,1955,957,237100,238,45,84.10,15.90,131,0,82,20,109,0,82,11,0,0,19,73,86,23,18,4160
810,810,0,665,145,1978,1037,218300,554,256,68.40,31.60,148,151,169,78,316,0,143,74,0,0,68,88,251,33,48,4161
1108,995,113,843,152,1997,1193,289000,908,200,81.95,18.05,473,37,135,20,293,12,29,104,0,0,61,234,252,61,191,4162
962,469,493,382,87,1984,950,400000,913,49,94.91,5.09,375,145,209,39,97,0,84,0,0,0,0,185,82,35,109,4163
928,766,162,555,211,1983,1094,278300,685,243,73.81,26.19,367,163,169,85,95,11,40,24,2,3,55,211,73,34,138,4164
1262,1136,126,845,291,1984,870,255000,964,298,76.39,23.61,344,253,177,77,266,76,192,11,0,7,0,280,486,28,15,4165
831,814,17,675,139,1994,1224,667000,806,25,96.99,3.01,372,136,108,55,0,8,0,8,22,0,0,8,55,50,497,4166
348,325,23,102,223,1939,553,102100,216,132,62.07,37.93,0,60,50,22,272,116,120,11,0,0,111,46,0,0,0,4167
879,779,100,654,125,1992,793,248300,544,335,61.89,38.11,362,108,268,53,106,13,52,0,0,0,57,181,296,45,108,4168
818,679,139,334,345,1988,974,146600,305,513,37.29,62.71,450,267,24,70,93,35,151,120,11,0,49,359,87,31,0,4169
141,90,51,16,74,1939,0,0,74,67,52.48,47.52,47,16,122,103,18,198,16,18,15,0,16,0,0,0,0,4170
352,352,0,292,60,1979,1714,196300,352,0,100.00,0.00,18,36,177,42,0,0,0,0,0,0,0,168,45,0,0,4171
377,321,56,156,165,1970,493,181600,255,122,67.64,32.36,44,0,92,0,177,55,67,5,0,0,50,55,22,0,41,4172
685,685,0,594,91,1990,988,233100,565,120,82.48,17.52,276,131,253,18,42,18,0,48,0,0,11,378,169,39,11,4173
326,326,0,219,107,1985,1250,230300,233,93,71.47,28.53,91,210,9,31,0,0,10,26,0,0,0,84,61,41,0,4174
361,361,0,328,33,1991,0,352600,348,13,96.40,3.60,155,120,0,0,0,0,0,10,0,39,26,19,86,79,16,4175
408,408,0,394,14,1987,0,349000,392,16,96.08,3.92,223,191,15,21,8,0,0,40,0,0,17,18,185,137,37,4176
353,353,0,327,26,1981,1906,343400,322,31,91.22,8.78,100,91,64,33,132,0,8,0,33,0,0,8,192,61,72,4177
288,288,0,230,58,1978,0,350400,288,0,100.00,0.00,16,95,49,90,66,0,0,34,0,0,0,46,111,79,11,4178
941,941,0,886,55,2002,0,485100,691,250,73.43,26.57,359,220,216,23,0,0,47,31,0,52,133,13,10,185,291,4179
613,613,0,369,244,1984,0,256200,484,129,78.96,21.04,190,253,11,26,52,44,52,88,0,0,14,43,218,19,20,4180
329,329,0,240,89,1987,1232,343100,271,58,82.37,17.63,54,187,18,11,0,0,0,0,0,26,0,17,130,76,21,4181
207,207,0,207,0,1970,0,197700,207,0,100.00,0.00,69,35,125,79,15,0,13,27,0,0,0,132,151,0,0,4182
650,628,22,204,424,1960,903,199000,399,251,61.38,38.62,68,18,113,37,439,112,172,69,0,0,0,153,127,0,0,4183
623,577,46,310,267,1975,1185,239800,208,415,33.39,66.61,93,62,270,210,117,0,135,105,0,0,49,190,241,25,7,4184
989,892,97,189,703,1986,1052,174500,167,822,16.89,83.11,229,322,447,84,0,28,536,248,0,0,166,37,11,0,0,4185
493,493,0,322,171,1974,878,107900,82,411,16.63,83.37,56,40,390,92,114,13,206,10,0,35,32,198,69,0,0,4186
705,668,37,589,79,1988,1778,405000,705,0,100.00,0.00,206,190,217,85,0,0,15,0,0,0,13,0,336,177,101,4187
421,411,10,398,13,1969,0,482600,411,10,97.62,2.38,36,122,149,120,146,0,0,108,15,0,0,0,148,15,287,4188
442,362,80,334,28,1967,0,408600,346,96,78.28,21.72,43,29,158,68,57,0,47,0,0,0,0,0,60,123,125,4189
375,348,27,299,49,1982,1669,337300,363,12,96.80,3.20,10,179,110,16,0,0,0,11,28,0,12,13,159,50,0,4190
748,730,18,653,77,1985,1797,463300,739,9,98.80,1.20,358,179,247,0,0,0,31,0,0,46,0,0,94,266,321,4191
482,428,54,420,8,1980,0,569700,442,40,91.70,8.30,70,148,30,109,10,0,0,0,0,0,0,17,57,31,255,4192
485,451,34,411,40,1970,1500,355800,485,0,100.00,0.00,48,80,110,211,60,0,28,9,0,0,0,37,200,93,81,4193
845,738,107,224,514,1985,1085,195000,113,732,13.37,86.63,117,380,101,0,18,0,172,136,34,0,0,132,75,16,0,4194
604,604,0,581,23,1991,0,288700,578,26,95.70,4.30,266,93,0,48,147,0,15,0,46,19,26,41,322,38,32,4195
654,645,9,574,71,1993,1556,312200,621,33,94.95,5.05,357,119,119,114,59,0,0,0,42,0,0,38,309,184,111,4196
428,356,72,18,338,1986,1047,0,56,372,13.08,86.92,74,135,297,0,38,15,302,138,0,0,0,0,37,10,0,4197
710,710,0,643,67,2003,2470,377400,710,0,100.00,0.00,441,60,73,29,46,0,0,25,36,8,0,11,209,234,47,4198
615,615,0,558,57,1979,1776,329000,609,6,99.02,0.98,243,79,256,10,0,0,0,15,48,49,0,61,217,122,39,4199
611,584,27,556,28,1986,1911,317600,511,100,83.63,16.37,110,420,22,113,81,0,0,33,26,8,0,79,440,78,30,4200
660,614,46,558,56,1971,0,588700,527,133,79.85,20.15,91,117,134,116,246,0,0,0,36,0,14,16,116,135,387,4201
686,608,78,296,312,1986,929,306300,335,351,48.83,51.17,74,187,385,64,107,0,191,168,0,0,0,203,111,23,37,4202
543,543,0,268,275,1976,1086,350000,355,188,65.38,34.62,152,42,77,148,176,0,193,24,10,0,0,37,143,49,98,4203
591,499,92,187,312,1975,1061,138300,174,417,29.44,70.56,139,67,165,51,169,0,232,103,0,0,18,58,117,12,0,4204
492,492,0,132,360,1976,977,175000,127,365,25.81,74.19,86,27,14,87,163,6,128,57,0,0,0,29,101,0,0,4205
566,556,10,485,71,1979,1773,471500,463,103,81.80,18.20,103,119,114,49,53,0,0,18,0,0,60,12,42,104,172,4206
331,331,0,177,154,1939,942,267200,260,71,78.55,21.45,0,22,40,23,195,0,72,6,48,0,0,34,53,4,23,4207
389,389,0,298,91,1983,1478,255300,310,79,79.69,20.31,54,26,82,33,36,10,0,14,0,0,0,70,48,65,24,4208
875,875,0,663,212,1997,1685,262300,774,101,88.46,11.54,413,14,112,11,10,0,0,0,37,0,15,59,365,27,8,4209
510,422,88,377,45,1954,2050,245200,510,0,100.00,0.00,46,31,16,61,254,0,59,12,22,11,5,42,242,0,15,4210
422,409,13,391,18,1955,0,383700,422,0,100.00,0.00,32,0,33,35,301,0,0,23,10,0,0,0,200,24,112,4211
510,510,0,256,254,1974,1074,215700,224,286,43.92,56.08,15,330,180,124,105,0,92,98,28,0,39,64,185,73,31,4212
534,534,0,198,336,1966,880,204300,136,398,25.47,74.53,49,70,159,135,213,0,276,40,89,0,0,142,66,0,0,4213
311,311,0,67,244,1953,909,281600,167,144,53.70,46.30,0,32,110,16,53,0,103,0,0,0,0,13,32,0,16,4214
771,572,199,95,477,1971,988,235600,219,552,28.40,71.60,77,23,115,148,120,0,132,183,13,0,19,49,40,0,47,4215
410,410,0,355,55,1963,0,254100,405,5,98.78,1.22,55,12,23,81,260,0,19,0,21,0,0,105,190,31,0,4216
366,300,66,254,46,1952,1559,250000,366,0,100.00,0.00,20,27,46,178,244,60,50,0,10,0,0,55,192,40,35,4217
485,456,29,434,22,1985,0,511500,474,11,97.73,2.27,96,186,89,59,79,0,0,55,0,0,0,38,42,11,318,4218
477,477,0,271,206,1987,1722,290500,317,160,66.46,33.54,321,101,87,14,65,0,13,75,26,0,0,56,196,14,114,4219
719,660,59,650,10,1989,0,373800,719,0,100.00,0.00,109,123,209,14,57,45,0,0,0,29,0,26,123,119,170,4220
459,436,23,226,210,1987,979,0,131,328,28.54,71.46,164,223,12,34,17,0,151,86,0,0,65,30,41,15,26,4221
424,416,8,392,24,1986,0,582500,390,34,91.98,8.02,76,199,51,9,9,0,0,0,0,0,0,18,9,147,170,4222
346,300,46,255,45,1986,827,463600,216,130,62.43,37.57,105,85,50,58,63,0,10,10,0,0,43,0,26,47,197,4223
537,537,0,522,15,1999,0,621700,486,51,90.50,9.50,241,105,18,78,40,0,0,0,0,0,0,43,10,52,348,4224
721,721,0,317,404,1985,1414,211900,165,556,22.88,77.12,111,266,48,111,111,0,39,327,0,0,0,72,36,0,11,4225
434,434,0,434,0,1985,0,421200,363,71,83.64,16.36,140,122,51,17,0,0,0,0,0,0,17,10,97,93,113,4226
637,629,8,502,127,1989,1402,497900,576,61,90.42,9.58,208,199,105,25,38,0,20,8,9,0,0,34,65,61,260,4227
277,277,0,231,46,1983,1911,292500,277,0,100.00,0.00,18,38,307,0,14,0,0,13,12,0,0,45,245,12,0,4228
580,580,0,492,88,1983,679,520700,540,40,93.10,6.90,202,70,122,33,47,0,14,26,10,19,11,37,44,78,234,4229
536,536,0,504,32,1976,0,364100,507,29,94.59,5.41,27,118,47,70,80,0,0,4,18,0,11,6,131,79,93,4230
386,354,32,335,19,1984,0,445900,346,40,89.64,10.36,81,175,43,9,94,0,0,19,0,0,0,0,66,63,254,4231
474,437,37,388,49,1980,0,295100,474,0,100.00,0.00,273,13,98,215,9,0,0,60,0,0,14,144,237,123,0,4232
479,479,0,446,33,1983,0,364100,433,46,90.40,9.60,186,208,135,20,160,0,21,125,0,0,15,98,240,34,161,4233
548,524,24,223,301,1964,945,255200,307,241,56.02,43.98,25,67,45,84,213,0,137,54,0,0,11,62,83,28,8,4234
388,351,37,283,68,1967,1056,228600,316,72,81.44,18.56,152,30,26,18,189,8,5,9,10,0,8,81,167,53,45,4235
351,258,93,218,40,1975,0,359400,351,0,100.00,0.00,155,28,50,43,89,0,0,10,0,0,0,29,122,49,99,4236
471,442,29,343,99,1987,1639,264200,463,8,98.30,1.70,204,53,83,105,57,0,13,9,0,0,27,98,178,134,33,4237
695,671,24,628,43,1980,1207,258900,511,184,73.53,26.47,204,268,151,23,35,0,0,38,0,0,80,104,233,82,109,4238
595,549,46,500,49,1974,1971,354700,459,136,77.14,22.86,74,97,157,248,178,0,30,16,16,0,50,15,244,105,237,4239
372,362,10,228,134,1992,1129,247400,254,118,68.28,31.72,216,150,107,68,7,36,186,110,0,0,0,36,58,26,38,4240
681,634,47,567,67,1993,2158,316200,673,8,98.83,1.17,309,151,13,0,25,0,0,0,0,0,0,12,287,137,62,4241
503,454,49,423,31,1989,0,610200,452,51,89.86,10.14,200,95,81,69,25,0,0,29,27,29,0,26,35,17,266,4242
680,599,81,484,115,1988,1528,206800,142,538,20.88,79.12,361,324,27,39,0,14,0,111,13,43,0,283,158,74,13,4243
615,547,68,267,280,1985,1260,231400,350,265,56.91,43.09,160,345,111,48,60,0,82,222,31,0,0,52,268,0,0,4244
717,656,61,495,161,1980,1737,267100,606,111,84.52,15.48,152,146,231,40,58,0,39,0,0,0,22,217,169,42,80,4245
378,312,66,294,18,1983,0,228900,378,0,100.00,0.00,33,303,89,27,0,0,4,19,10,0,0,113,297,0,9,4246
464,464,0,424,40,1970,1591,256400,443,21,95.47,4.53,12,0,114,265,6,0,0,12,0,0,30,49,207,71,0,4247
410,399,11,345,54,1997,1667,311600,410,0,100.00,0.00,295,126,39,0,0,0,0,0,48,0,8,13,265,89,13,4248
734,679,55,89,590,1977,1019,101300,0,734,0.00,100.00,47,103,265,65,0,0,332,48,0,0,0,100,0,0,0,4249
541,502,39,445,57,1987,0,317500,541,0,100.00,0.00,19,439,15,0,12,0,0,0,0,0,15,14,225,160,16,4250
783,772,11,594,178,1973,802,283800,553,230,70.63,29.37,24,189,240,200,0,48,112,13,0,0,28,64,228,104,46,4251
537,537,0,219,318,1982,1255,216800,303,234,56.42,43.58,170,184,57,76,112,9,114,151,0,0,0,26,134,0,0,4252
338,299,39,165,134,1964,1188,258600,311,27,92.01,7.99,0,17,147,126,135,8,120,30,56,0,0,64,135,0,0,4253
734,734,0,549,185,1979,1493,207800,520,214,70.84,29.16,114,196,178,110,0,11,11,26,7,0,48,190,253,19,0,4254
399,350,49,336,14,1969,0,362900,399,0,100.00,0.00,54,0,118,189,0,0,0,0,11,0,0,110,83,33,72,4255
689,649,40,589,60,1988,1826,414500,440,249,63.86,36.14,187,147,71,0,27,0,0,19,0,26,14,40,120,66,100,4256
470,461,9,436,25,1968,0,632500,443,27,94.26,5.74,69,12,152,199,70,0,0,0,42,0,0,11,12,83,319,4257
331,331,0,22,309,1994,1519,0,83,248,25.08,74.92,28,200,131,0,0,0,0,120,113,24,10,0,0,0,38,4258
606,514,92,127,387,1984,886,178100,196,410,32.34,67.66,193,81,201,71,49,65,248,185,0,0,6,34,48,0,0,4259
505,467,38,329,138,1985,946,203300,314,191,62.18,37.82,138,143,40,19,33,0,70,37,18,7,0,53,188,0,0,4260
761,679,82,184,495,1988,1012,156300,264,497,34.69,65.31,278,292,92,19,136,0,331,167,62,0,0,137,58,0,0,4261
555,458,97,190,268,1985,1045,190200,233,322,41.98,58.02,226,215,124,0,53,29,215,149,0,0,10,103,54,0,0,4262
513,474,39,206,268,1951,850,180300,397,116,77.39,22.61,66,0,194,65,145,52,212,64,0,0,21,71,24,0,0,4263
597,560,37,289,271,1958,1250,171900,490,107,82.08,17.92,69,95,75,50,332,64,107,64,16,0,0,219,121,27,3,4264
356,345,11,101,244,1966,722,124500,110,246,30.90,69.10,37,132,149,56,48,16,281,54,0,0,0,23,11,0,0,4265
610,610,0,388,222,1980,1196,403300,497,113,81.48,18.52,104,37,78,225,77,0,35,16,58,10,0,12,147,69,136,4266
302,285,17,285,0,1983,0,584500,302,0,100.00,0.00,39,52,170,22,31,0,0,0,19,0,0,0,46,27,210,4267
415,381,34,310,71,1971,1712,356500,348,67,83.86,16.14,67,94,73,143,97,40,0,10,35,44,2,38,104,71,51,4268
559,524,35,221,303,1963,954,284900,273,286,48.84,51.16,37,82,92,146,343,40,252,71,0,0,12,61,237,13,14,4269
395,347,48,347,0,1966,0,332300,395,0,100.00,0.00,46,26,71,132,23,0,28,13,45,0,12,29,120,26,25,4270
434,434,0,434,0,1987,0,335600,434,0,100.00,0.00,71,197,49,10,75,0,0,0,0,8,12,61,254,26,11,4271
360,360,0,337,23,1975,1641,259000,360,0,100.00,0.00,70,22,161,173,9,0,0,32,29,0,0,65,257,13,9,4272
814,789,25,653,136,1993,1927,264400,474,340,58.23,41.77,409,96,127,0,12,9,0,29,52,0,18,149,259,34,34,4273
778,739,39,665,74,1987,2146,580700,771,7,99.10,0.90,309,160,108,98,56,0,0,46,22,22,0,9,68,104,415,4274
682,682,0,525,157,1991,1412,369400,592,90,86.80,13.20,246,322,51,20,0,0,0,0,70,0,11,27,259,155,96,4275
905,852,53,815,37,1993,0,377700,750,155,82.87,17.13,392,99,37,0,28,0,0,0,0,0,128,11,95,205,117,4276
464,431,33,431,0,1986,0,434500,452,12,97.41,2.59,233,116,143,0,13,0,0,0,0,0,0,35,129,96,245,4277
471,422,49,298,124,1969,1259,316700,405,66,85.99,14.01,54,19,97,265,48,43,0,11,14,0,23,97,167,46,42,4278
578,567,11,463,104,2004,0,398000,578,0,100.00,0.00,400,8,21,0,75,0,0,9,9,0,0,18,75,180,178,4279
489,414,75,303,111,1974,1538,205500,439,50,89.78,10.22,220,37,83,15,136,0,19,0,0,0,0,93,256,42,35,4280
591,559,32,492,67,1986,1101,300600,522,69,88.32,11.68,162,95,105,9,84,0,10,10,0,0,18,136,127,18,65,4281
574,533,41,387,146,1986,1890,0,237,337,41.29,58.71,544,87,121,26,15,0,0,32,171,53,207,0,105,42,59,4282
420,393,27,351,42,1992,1056,712900,399,21,95.00,5.00,170,68,44,53,35,0,0,0,0,0,0,0,39,45,286,4283
392,361,31,361,0,1970,0,325200,392,0,100.00,0.00,45,85,249,87,0,0,0,0,57,14,0,31,220,100,24,4284
362,362,0,352,10,1987,0,513400,362,0,100.00,0.00,108,275,12,0,0,0,0,0,25,0,0,12,88,40,204,4285
515,515,0,492,23,1986,0,394200,499,16,96.89,3.11,211,172,97,40,28,0,0,0,0,0,0,108,160,86,111,4286
1051,1014,37,929,85,2005,0,441000,1038,13,98.76,1.24,504,53,57,37,59,73,37,0,10,25,9,40,193,140,116,4287
501,501,0,429,72,1985,2383,554500,501,0,100.00,0.00,21,485,18,0,24,0,0,0,34,23,0,11,40,164,276,4288
256,256,0,256,0,1985,0,642300,256,0,100.00,0.00,24,175,21,0,13,0,0,0,0,0,0,11,10,42,170,4289
317,293,24,284,9,1985,0,777100,317,0,100.00,0.00,34,223,10,24,12,12,0,10,0,0,0,0,31,30,220,4290
631,605,26,316,289,1980,1165,317400,255,376,40.41,59.59,108,162,55,111,129,9,199,138,0,26,37,27,59,28,42,4291
776,776,0,385,391,1989,1484,228900,276,500,35.57,64.43,309,422,181,49,0,34,148,145,46,12,9,183,214,116,22,4292
425,387,38,333,54,1987,2235,386600,425,0,100.00,0.00,146,85,44,72,162,0,17,46,32,0,0,14,185,63,152,4293
566,515,51,369,146,1984,1344,405800,388,178,68.55,31.45,173,172,203,76,40,8,15,113,38,0,0,34,158,125,126,4294
586,471,115,281,190,1988,1690,435000,401,185,68.43,31.57,277,135,26,67,15,0,0,79,10,22,0,51,130,41,187,4295
815,754,61,638,116,1971,2844,1020800,806,9,98.90,1.10,135,124,204,129,217,0,0,8,27,20,0,34,8,30,641,4296
545,520,25,422,98,1962,2580,711900,516,29,94.68,5.32,27,0,27,156,271,0,0,12,19,33,30,10,0,26,334,4297
324,324,0,324,0,1974,0,904000,324,0,100.00,0.00,21,96,59,151,46,0,15,0,0,0,0,10,12,0,336,4298
869,869,0,455,414,1986,1430,409000,365,504,42.00,58.00,307,457,280,23,0,0,145,345,43,8,9,131,102,37,219,4299
484,484,0,484,0,1991,0,876900,484,0,100.00,0.00,110,253,31,0,36,0,0,0,0,0,0,0,12,36,346,4300
519,456,63,365,91,1985,1516,243600,519,0,100.00,0.00,109,180,117,56,26,0,0,25,11,0,55,131,266,0,0,4301
466,418,48,386,32,1978,722,325900,414,52,88.84,11.16,82,123,140,81,15,0,0,23,0,0,0,70,117,75,97,4302
486,438,48,286,152,1973,1038,387400,304,182,62.55,37.45,84,31,120,98,89,0,95,20,0,25,0,16,134,78,54,4303
634,634,0,479,155,1988,1049,421700,478,156,75.39,24.61,333,172,37,45,62,0,26,0,9,36,13,55,66,183,226,4304
417,369,48,339,30,1975,0,259000,417,0,100.00,0.00,35,36,176,32,0,0,0,0,0,0,0,13,195,27,44,4305
594,594,0,351,243,1995,1563,415000,419,175,70.54,29.46,484,28,74,39,38,0,0,133,28,0,0,0,91,112,220,4306
273,273,0,250,23,1973,0,607400,273,0,100.00,0.00,43,0,96,112,33,0,0,0,0,40,0,0,0,31,213,4307
737,686,51,686,0,1973,0,974400,737,0,100.00,0.00,53,190,193,181,72,0,0,12,0,0,0,10,7,0,660,4308
470,427,43,122,305,1981,386,256300,121,349,25.74,74.26,105,0,76,65,59,66,74,36,12,0,0,63,54,0,0,4309
654,614,40,533,81,1989,2740,699400,650,4,99.39,0.61,222,243,42,0,78,0,0,0,10,78,0,8,32,74,305,4310
426,389,37,379,10,1985,0,820500,411,15,96.48,3.52,123,207,58,17,36,0,0,0,17,0,17,0,11,40,356,4311
918,820,98,366,454,1977,1581,490900,247,671,26.91,73.09,303,150,143,163,109,7,29,145,91,106,11,42,76,17,287,4312
663,612,51,386,226,1995,1529,726700,302,361,45.55,54.45,450,15,12,0,0,0,18,155,18,0,0,0,112,13,143,4313
664,664,0,425,239,1950,1400,455300,442,222,66.57,33.43,144,19,63,6,436,0,40,99,73,35,10,0,61,186,151,4314
368,361,7,185,176,1961,1121,379600,207,161,56.25,43.75,0,80,91,75,231,0,156,115,0,0,0,0,43,35,85,4315
590,544,46,518,26,1956,0,481600,575,15,97.46,2.54,16,68,34,33,365,0,0,34,63,0,0,0,138,116,165,4316
633,570,63,506,64,1959,2043,484900,633,0,100.00,0.00,50,35,66,147,266,0,0,20,21,32,0,0,41,78,303,4317
1182,1182,0,536,646,1992,1411,226300,273,909,23.10,76.90,266,121,215,21,155,24,97,235,37,0,16,165,96,33,30,4318
541,533,8,381,152,1942,1409,459800,503,38,92.98,7.02,35,0,39,25,407,0,21,31,22,10,0,10,100,153,120,4319
852,852,0,494,358,1998,1095,362700,490,362,57.51,42.49,307,124,33,174,189,30,208,137,47,0,0,15,223,55,31,4320
868,798,70,296,502,1982,1139,374800,388,480,44.70,55.30,122,76,86,94,287,146,113,67,59,0,14,17,116,111,22,4321
576,524,52,304,220,1968,1090,291500,306,270,53.13,46.88,118,174,21,28,321,24,93,13,74,0,18,152,135,101,0,4322
738,682,56,385,297,1964,1125,411000,425,313,57.59,42.41,106,104,28,83,380,42,104,89,9,0,0,20,196,122,108,4323
475,402,73,237,165,1956,1139,421200,303,172,63.79,36.21,80,60,41,27,244,0,86,62,11,0,0,14,95,89,27,4324
712,712,0,101,611,1978,1149,180800,15,697,2.11,97.89,187,89,161,122,138,0,317,129,0,139,0,68,29,15,0,4325
395,395,0,356,39,1950,1829,758100,383,12,96.96,3.04,31,17,38,65,225,0,29,13,0,0,0,25,24,0,214,4326
515,449,66,350,99,1954,1258,549100,474,41,92.04,7.96,4,54,27,40,430,0,38,35,53,28,0,7,33,70,269,4327
347,302,45,225,77,1954,941,364200,299,48,86.17,13.83,0,0,99,45,253,13,95,13,63,0,0,16,35,56,67,4328
502,502,0,263,239,1954,1012,299200,348,154,69.32,30.68,73,74,115,77,191,0,300,22,14,0,0,23,65,46,28,4329
756,756,0,421,335,1980,1274,413800,466,290,61.64,38.36,46,116,60,104,210,0,50,84,15,0,26,62,172,82,30,4330
430,430,0,375,55,1954,1616,349500,414,16,96.28,3.72,58,28,149,82,303,0,85,49,17,0,14,29,186,65,73,4331
511,437,74,401,36,1958,0,536200,511,0,100.00,0.00,0,18,40,30,382,0,0,0,12,0,0,20,83,90,265,4332
917,790,127,235,555,1975,532,220500,87,830,9.49,90.51,179,329,120,344,195,449,179,129,14,0,0,50,123,0,77,4333
2227,1843,384,373,1470,2001,858,303500,454,1773,20.39,79.61,558,165,404,139,125,35,541,206,46,0,11,99,140,64,28,4334
555,504,51,341,163,1971,1403,301100,301,254,54.23,45.77,24,47,259,73,164,22,67,46,10,0,8,38,285,61,13,4335
588,534,54,260,274,1988,1127,385400,351,237,59.69,40.31,135,59,76,46,358,0,146,153,10,3,15,19,129,61,15,4336
895,757,138,694,63,1994,1051,257800,655,240,73.18,26.82,391,220,103,76,156,0,93,8,0,0,44,243,314,62,73,4337
643,623,20,578,45,1959,1387,577800,617,26,95.96,4.04,62,71,67,74,290,0,0,0,0,10,9,0,72,69,365,4338
701,649,52,284,365,1964,749,123400,426,275,60.77,39.23,39,45,184,203,317,101,182,0,0,0,140,214,0,0,0,4339
1107,1046,61,164,882,1970,1013,237500,0,1107,0.00,100.00,370,52,107,71,785,147,601,158,27,15,0,91,139,16,0,4340
2650,2514,136,515,1999,2003,1338,373100,31,2619,1.17,98.83,671,16,181,25,572,230,505,193,47,42,0,0,107,34,8,4341
1564,1461,103,265,1196,2001,1533,236600,9,1555,0.58,99.42,787,21,25,30,534,0,328,350,98,122,7,114,157,10,8,4342
839,839,0,278,561,1962,1019,0,163,676,19.43,80.57,31,0,115,209,410,68,272,192,0,15,0,70,13,0,25,4343
647,606,41,239,367,1970,1393,590500,250,397,38.64,61.36,289,83,47,15,214,0,66,105,13,22,0,21,143,53,158,4344
545,514,31,230,284,1950,1360,898100,207,338,37.98,62.02,24,15,25,42,415,0,151,42,35,21,0,16,15,49,152,4345
1106,962,144,465,497,1950,1555,615000,384,722,34.72,65.28,53,61,82,218,660,0,197,220,68,10,0,0,73,73,314,4346
1318,1178,140,288,890,1980,1377,432100,124,1194,9.41,90.59,242,153,126,187,205,0,201,194,30,82,0,76,83,26,128,4347
1088,1001,87,125,876,1971,1416,448100,97,991,8.92,91.08,341,143,66,29,264,0,204,272,96,10,0,0,77,0,132,4348
1002,1002,0,312,690,1964,1468,507000,258,744,25.75,74.25,76,57,151,217,540,0,309,253,29,0,0,28,115,59,147,4349
451,441,10,317,124,1939,1773,924300,353,98,78.27,21.73,6,13,13,0,370,0,6,18,8,0,0,10,13,39,301,4350
627,627,0,494,133,1953,1164,419400,565,62,90.11,9.89,84,0,51,55,306,0,0,56,18,0,32,35,143,83,112,4351
435,402,33,114,288,1939,1318,483300,229,206,52.64,47.36,80,38,13,5,340,0,32,115,5,6,16,0,94,52,55,4352
515,469,46,123,346,1944,1158,389100,222,293,43.11,56.89,175,47,99,51,287,33,71,196,0,0,0,27,74,51,147,4353
1090,1024,66,121,903,1987,1193,1017500,44,1046,4.04,95.96,319,370,32,45,271,28,434,267,94,16,0,18,43,37,100,4354
1092,1092,0,172,920,1965,1249,323000,8,1084,0.73,99.27,281,89,20,408,462,58,397,348,44,0,0,15,32,0,158,4355
893,743,150,205,538,1964,995,313800,32,861,3.58,96.42,54,47,57,65,675,0,204,222,30,74,0,67,61,27,0,4356
535,421,114,80,341,1939,0,557700,22,513,4.11,95.89,71,61,25,0,414,211,107,13,0,39,12,11,35,10,29,4357
442,442,0,172,270,1954,1341,287500,106,336,23.98,76.02,58,24,81,16,231,41,65,155,24,34,0,49,15,9,18,4358
593,507,86,318,189,1939,1815,439100,334,259,56.32,43.68,183,26,6,0,165,0,0,175,26,11,0,0,59,56,29,4359
694,679,15,549,130,1939,1792,700100,613,81,88.33,11.67,68,12,34,15,475,0,13,33,0,44,0,47,43,63,323,4360
731,713,18,199,514,1939,1200,455400,121,610,16.55,83.45,51,0,72,59,565,31,306,114,100,17,0,62,23,17,46,4361
1229,1229,0,152,1077,1983,1573,240700,146,1083,11.88,88.12,141,13,0,54,487,41,276,105,0,36,0,7,72,13,50,4362
808,602,206,433,169,1962,1431,1062500,355,453,43.94,56.06,50,25,88,244,261,0,38,30,106,68,0,16,67,29,263,4363
387,387,0,317,70,1939,1750,905000,345,42,89.15,10.85,0,94,12,11,290,0,0,11,22,44,0,0,0,0,330,4364
597,597,0,391,206,1939,1455,752100,445,152,74.54,25.46,11,0,0,0,593,0,45,0,55,16,0,9,22,28,419,4365
696,653,43,385,268,1939,1713,624000,343,353,49.28,50.72,100,49,23,53,452,0,104,86,38,29,13,40,91,27,185,4366
457,457,0,296,161,1939,1193,667800,365,92,79.87,20.13,39,58,37,0,369,0,36,141,22,40,0,0,0,38,226,4367
605,590,15,401,189,1943,1702,840700,438,167,72.40,27.60,65,26,50,50,444,0,91,15,69,35,0,35,33,17,323,4368
523,415,108,144,271,1976,1508,367300,224,299,42.83,57.17,116,0,0,40,255,19,53,7,7,0,0,6,120,65,48,4369
524,489,35,353,136,1939,1392,578600,423,101,80.73,19.27,12,14,0,12,418,0,94,13,8,20,5,0,6,136,118,4370
592,592,0,477,115,1943,1486,604600,577,15,97.47,2.53,32,41,12,104,477,33,11,69,21,48,0,14,82,105,272,4371
750,711,39,466,245,1950,1698,455600,532,218,70.93,29.07,33,16,41,78,451,0,43,116,31,55,9,45,13,116,110,4372
645,570,75,488,82,1951,1125,909800,615,30,95.35,4.65,94,12,25,83,487,0,27,0,13,13,0,16,15,50,523,4373
888,792,96,339,453,1976,1286,503600,294,594,33.11,66.89,135,300,142,122,205,70,302,141,21,0,33,71,50,31,58,4374
623,592,31,292,300,1966,1368,450000,235,388,37.72,62.28,0,44,208,180,204,0,51,117,0,0,0,90,118,76,121,4375
727,692,35,369,323,1953,1072,517300,402,325,55.30,44.70,107,87,37,49,347,36,188,28,0,0,7,12,68,138,137,4376
547,502,45,425,77,1944,3063,627500,518,29,94.70,5.30,91,0,14,6,492,0,12,67,32,65,0,0,31,33,327,4377
755,647,108,0,647,1963,1006,0,0,755,0.00,100.00,15,0,163,150,190,0,428,47,0,0,0,0,0,0,0,4378
660,605,55,24,581,1939,949,0,0,660,0.00,100.00,22,29,86,109,576,65,478,163,14,0,0,15,0,0,0,4379
537,511,26,431,80,1939,0,719400,501,36,93.30,6.70,21,24,0,0,497,0,24,0,8,37,0,23,10,70,292,4380
744,744,0,40,704,1965,1399,557700,161,583,21.64,78.36,129,91,14,105,387,16,412,110,90,21,0,0,0,15,15,4381
623,606,17,339,267,1953,1503,558500,401,222,64.37,35.63,25,20,90,54,344,0,84,45,50,8,0,0,28,62,146,4382
515,439,76,343,96,1949,1830,612800,461,54,89.51,10.49,28,25,34,50,428,0,34,68,29,11,0,0,17,59,315,4383
1520,1494,26,373,1121,1998,1453,394500,207,1313,13.62,86.38,618,191,190,110,201,210,213,287,104,0,0,95,154,56,0,4384
527,464,63,282,182,1939,1770,702300,386,141,73.24,26.76,13,9,0,25,415,0,26,44,35,28,7,0,33,41,248,4385
466,410,56,96,314,1989,1031,484400,116,350,24.89,75.11,340,27,35,43,183,8,276,91,23,23,0,0,65,54,29,4386
1211,1125,86,173,952,1982,1531,559300,234,977,19.32,80.68,157,236,73,247,249,22,290,168,61,162,0,0,60,42,110,4387
465,436,29,250,186,1939,1385,518500,311,154,66.88,33.12,0,8,63,61,381,0,19,85,0,0,0,0,41,80,248,4388
452,452,0,234,218,1944,1526,497000,270,182,59.73,40.27,15,0,22,38,478,26,100,30,15,0,0,29,77,58,125,4389
478,437,41,216,221,1947,1857,341200,307,171,64.23,35.77,35,12,0,57,478,11,67,156,96,16,0,14,35,111,76,4390
632,632,0,338,294,1939,1871,493300,477,155,75.47,24.53,39,0,51,31,465,0,46,50,28,0,0,0,72,180,176,4391
669,620,49,473,147,1939,1165,537600,669,0,100.00,0.00,33,0,0,30,627,0,0,14,30,0,0,14,171,132,269,4392
647,606,41,414,192,1944,1045,529400,525,122,81.14,18.86,97,0,16,0,538,0,75,84,74,0,0,16,69,249,84,4393
683,660,23,416,244,1939,1226,451600,510,173,74.67,25.33,20,44,139,66,467,76,150,22,71,12,0,48,62,132,94,4394
535,535,0,463,72,1939,0,598200,524,11,97.94,2.06,58,0,38,27,388,0,13,23,14,0,0,32,40,76,298,4395
636,562,74,371,191,1939,1212,553300,407,229,63.99,36.01,120,37,34,0,374,0,35,80,34,26,0,23,114,99,154,4396
553,510,43,501,9,1986,0,255900,443,110,80.11,19.89,138,146,217,0,8,0,17,12,0,0,0,176,222,32,11,4397
620,602,18,423,179,1982,1206,194800,522,98,84.19,15.81,278,165,181,23,48,0,0,114,0,0,7,286,189,40,5,4398
395,339,56,287,52,2003,1321,217800,328,67,83.04,16.96,141,22,7,8,93,0,0,12,26,8,28,21,127,27,10,4399
768,674,94,604,70,1996,1744,281300,768,0,100.00,0.00,603,81,0,16,37,0,29,0,27,0,15,195,301,39,78,4400
157,157,0,146,11,1972,0,0,0,157,0.00,100.00,0,54,19,90,23,89,0,0,0,0,14,23,0,0,0,4401
299,278,21,194,84,1939,0,354000,270,29,90.30,9.70,0,0,10,43,353,22,104,13,62,0,0,0,100,80,25,4402
354,310,44,230,80,1963,2143,427800,333,21,94.07,5.93,20,0,93,112,132,0,0,72,19,66,0,0,32,61,107,4403
244,244,0,230,14,1955,0,147900,228,16,93.44,6.56,15,0,27,66,188,0,11,0,0,0,28,171,40,0,0,4404
543,421,122,142,279,1986,858,352900,264,279,48.62,51.38,163,108,61,71,124,34,128,40,0,0,25,36,63,43,79,4405
412,412,0,292,120,1982,1140,290200,294,118,71.36,28.64,30,49,93,92,0,0,78,20,34,0,0,45,66,21,0,4406
485,428,57,334,94,1958,1380,140200,429,56,88.45,11.55,16,28,44,116,376,0,85,38,0,0,219,222,0,0,0,4407
564,564,0,451,113,1983,1284,235800,550,14,97.52,2.48,126,38,356,31,41,0,70,28,0,29,0,131,239,47,31,4408
571,571,0,545,26,1987,0,238300,466,105,81.61,18.39,333,39,73,11,38,11,0,15,0,0,27,63,268,35,75,4409
942,904,38,288,616,1970,754,136900,337,605,35.77,64.23,238,109,100,105,648,169,466,150,0,0,0,252,30,0,14,4410
201,174,27,124,50,1983,0,212700,201,0,100.00,0.00,139,69,49,0,0,0,16,19,0,0,0,52,65,72,0,4411
344,252,92,108,144,1982,738,245500,229,115,66.57,33.43,45,58,51,14,40,0,10,15,0,0,50,34,32,28,14,4412
402,305,97,235,70,1964,1676,167000,386,16,96.02,3.98,184,63,130,146,189,0,167,72,25,0,0,369,14,12,0,4413
262,262,0,203,59,1993,1537,319500,238,24,90.84,9.16,83,13,17,32,36,0,17,0,0,11,0,28,36,19,43,4414
474,474,0,231,243,1957,877,228800,408,66,86.08,13.92,17,23,0,84,188,0,9,40,25,0,0,104,134,0,0,4415
627,627,0,561,66,1995,0,304700,560,67,89.31,10.69,427,123,55,31,73,16,8,15,0,0,8,62,242,136,168,4416
906,849,57,114,735,1983,932,222100,130,776,14.35,85.65,193,344,311,69,98,3,716,61,8,0,16,17,71,11,3,4417
769,750,19,628,122,1995,1148,92800,406,363,52.80,47.20,536,67,37,14,18,0,74,125,0,0,257,141,19,30,12,4418
626,586,40,262,324,1985,923,206300,330,296,52.72,47.28,158,97,196,62,17,13,246,39,0,0,28,114,55,19,16,4419
404,404,0,388,16,1977,0,332900,378,26,93.56,6.44,33,83,165,40,38,0,0,0,0,0,9,91,101,123,11,4420
529,454,75,454,0,1982,0,360900,529,0,100.00,0.00,113,90,206,39,43,0,36,34,35,0,0,12,155,28,113,4421
678,678,0,266,412,1970,867,234200,333,345,49.12,50.88,125,97,118,111,167,66,268,16,18,0,0,93,141,0,16,4422
566,516,50,397,119,1976,1125,160800,471,95,83.22,16.78,297,21,17,35,381,14,98,91,45,0,23,260,145,12,32,4423
952,890,62,404,486,1976,709,183500,511,441,53.68,46.32,158,116,166,117,293,0,194,72,33,15,14,302,42,15,17,4424
725,690,35,472,218,1947,1202,379100,383,342,52.83,47.17,307,42,62,110,283,0,122,129,46,0,0,30,198,60,100,4425
553,532,21,347,185,1952,949,211300,443,110,80.11,19.89,21,66,154,54,386,28,88,66,15,0,10,191,136,18,36,4426
538,487,51,368,119,1959,1412,1039200,538,0,100.00,0.00,117,68,52,63,257,0,13,0,0,61,0,0,0,0,359,4427
340,312,28,168,144,1958,597,145800,193,147,56.76,43.24,99,36,37,58,256,60,46,3,0,54,113,134,65,0,0,4428
508,508,0,146,362,1985,882,376000,198,310,38.98,61.02,101,148,123,40,0,0,109,38,35,0,51,0,71,80,28,4429
665,649,16,507,142,1976,1060,389500,590,75,88.72,11.28,163,129,106,67,186,0,45,20,39,35,11,28,248,53,123,4430
610,590,20,486,104,1974,1151,369300,573,37,93.93,6.07,177,54,130,0,112,0,81,12,0,0,22,121,115,38,84,4431
632,632,0,539,93,1973,1164,228500,535,97,84.65,15.35,261,68,148,65,185,11,8,0,0,0,54,400,183,0,53,4432
415,355,60,311,44,1987,581,120900,264,151,63.61,36.39,182,50,81,9,172,0,0,0,0,0,119,248,30,13,0,4433
305,230,75,230,0,1995,0,314700,283,22,92.79,7.21,65,0,61,20,45,26,0,0,0,0,0,55,44,27,0,4434
596,494,102,252,242,1980,812,123100,302,294,50.67,49.33,105,131,201,28,144,32,73,0,0,0,74,312,54,0,20,4435
994,847,147,108,739,1979,1214,1093800,0,994,0.00,100.00,88,0,178,116,239,88,248,195,36,54,0,0,0,0,0,4436
482,426,56,356,70,1979,700,260500,362,120,75.10,24.90,206,45,56,76,94,11,74,0,0,7,44,139,6,77,31,4437
320,187,133,187,0,1972,0,146900,227,93,70.94,29.06,104,65,74,15,57,0,6,0,0,0,87,114,32,0,0,4438
564,517,47,344,173,1986,616,217500,380,184,67.38,32.62,241,263,200,69,53,33,232,49,0,0,0,289,79,8,19,4439
354,354,0,240,114,1991,1238,420200,245,109,69.21,30.79,199,182,12,0,0,0,78,78,0,0,0,24,67,66,65,4440
403,358,45,261,97,1975,630,165100,240,163,59.55,40.45,5,11,125,75,132,17,78,0,0,0,62,139,10,0,0,4441
737,714,23,363,351,1939,1795,468700,617,120,83.72,16.28,59,15,42,11,466,12,30,109,34,19,0,16,126,119,128,4442
1886,1775,111,1423,352,0,2100,473300,1561,325,82.77,17.23,1363,11,35,30,25,0,8,55,11,45,0,29,178,262,792,4443
374,374,0,289,85,1958,627,162500,356,18,95.19,4.81,28,0,62,42,185,0,51,7,0,0,19,209,31,0,0,4444
582,558,24,462,96,1963,1917,334100,582,0,100.00,0.00,104,87,115,78,169,0,0,45,0,0,0,60,192,123,133,4445
287,269,18,234,35,1972,0,167200,269,18,93.73,6.27,139,12,35,26,215,29,57,0,0,0,61,122,59,0,21,4446
486,486,0,188,298,1973,935,194600,188,298,38.68,61.32,80,62,107,44,136,0,133,31,0,0,0,114,119,0,0,4447
112,112,0,0,112,1939,1120,0,9,103,8.04,91.96,0,0,11,12,147,12,104,19,0,11,0,0,0,0,0,4448
191,191,0,102,89,1955,734,117500,128,63,67.02,32.98,46,16,16,23,276,75,82,0,0,0,17,124,16,0,0,4449
992,905,87,693,212,1939,1080,306300,859,133,86.59,13.41,22,0,126,42,903,0,180,138,51,19,13,245,199,138,110,4450
870,870,0,676,194,1991,1273,195000,870,0,100.00,0.00,466,71,61,86,132,36,32,60,0,0,54,443,191,0,0,4451
774,774,0,756,18,1986,0,175200,732,42,94.57,5.43,263,41,215,0,0,0,0,33,0,0,24,426,9,0,27,4452
611,611,0,376,235,1968,713,318200,391,220,63.99,36.01,0,54,201,357,111,67,138,0,14,0,0,108,264,32,60,4453
620,460,160,265,195,1962,753,172100,380,240,61.29,38.71,133,14,18,22,278,35,81,14,0,0,51,216,8,0,11,4454
709,564,145,509,55,1959,1904,410400,670,39,94.50,5.50,0,87,133,73,449,0,50,30,0,0,17,61,229,115,240,4455
577,472,105,396,76,1980,448,174100,421,156,72.96,27.04,147,31,94,67,134,17,49,0,0,0,79,138,44,6,0,4456
711,605,106,529,76,1991,711,189600,502,209,70.60,29.40,188,124,130,137,52,23,94,0,0,0,35,194,96,0,91,4457
379,316,63,213,103,1973,550,208700,307,72,81.00,19.00,117,29,77,22,131,0,18,3,0,0,23,169,66,3,47,4458
387,387,0,379,8,1978,0,549200,377,10,97.42,2.58,111,101,37,126,64,0,0,0,0,0,9,9,72,115,234,4459
440,408,32,326,82,1980,1042,200000,298,142,67.73,32.27,163,52,187,19,114,0,13,7,0,0,43,206,159,10,25,4460
607,531,76,407,124,1987,1020,275800,508,99,83.69,16.31,190,100,92,3,145,10,57,8,0,0,59,124,137,7,57,4461
610,530,80,414,116,1993,1381,212500,448,162,73.44,26.56,221,97,60,53,117,0,9,30,0,0,32,153,77,79,68,4462
611,611,0,558,53,1976,947,255700,593,18,97.05,2.95,68,131,9,62,122,0,33,53,0,0,0,65,129,23,89,4463
874,819,55,713,106,1990,1119,263000,731,143,83.64,16.36,367,150,161,62,171,15,8,19,4,0,13,284,322,178,31,4464
497,466,31,452,14,1997,0,378000,428,69,86.12,13.88,227,103,76,37,31,0,7,0,0,0,0,23,247,59,106,4465
737,696,41,673,23,1989,0,465800,725,12,98.37,1.63,232,266,51,11,13,0,0,0,12,61,0,12,92,188,195,4466
386,326,60,130,196,1966,999,189300,256,130,66.32,33.68,29,57,61,18,155,0,47,40,0,0,11,72,96,16,12,4467
408,408,0,278,130,1980,1086,314700,254,154,62.25,37.75,114,41,50,142,14,0,53,15,25,0,0,53,192,23,0,4468
711,623,88,368,255,1985,1300,212000,447,264,62.87,37.13,85,362,16,49,179,46,137,92,44,0,0,185,131,0,19,4469
373,357,16,298,59,1972,870,298000,315,58,84.45,15.55,29,52,118,149,35,0,49,8,26,0,0,23,128,52,28,4470
894,894,0,600,294,2003,1240,172500,687,207,76.85,23.15,425,67,23,27,27,0,0,63,0,0,70,233,101,0,27,4471
686,686,0,420,266,1978,1071,232700,537,149,78.28,21.72,249,62,210,143,56,0,105,11,0,0,0,264,217,13,75,4472
738,708,30,595,113,1996,1268,358700,604,134,81.84,18.16,360,70,117,56,40,12,18,22,7,3,17,94,167,74,191,4473
501,463,38,392,71,1975,0,199600,363,138,72.46,27.54,197,28,184,86,0,12,31,13,0,0,119,42,165,48,54,4474
575,550,25,472,78,2001,2225,310400,532,43,92.52,7.48,401,46,53,14,61,0,0,27,23,6,22,28,300,132,37,4475
447,414,33,324,90,1994,1781,239600,447,0,100.00,0.00,426,0,10,0,59,0,0,0,59,0,0,50,368,10,0,4476
353,353,0,90,263,1990,946,223200,115,238,32.58,67.42,120,143,11,0,106,45,82,85,6,0,10,19,87,0,0,4477
971,961,10,778,183,2005,2087,427700,889,82,91.56,8.44,537,38,11,7,13,0,0,0,32,0,10,0,43,277,132,4478
729,686,43,138,548,1983,1018,214700,245,484,33.61,66.39,52,117,115,16,138,30,166,49,13,0,16,88,45,0,0,4479
518,518,0,272,246,1977,1554,225000,468,50,90.35,9.65,189,56,168,101,173,0,166,42,30,44,12,102,237,0,0,4480
345,325,20,207,118,1963,1293,235900,307,38,88.99,11.01,41,24,108,81,242,0,91,27,8,0,10,84,242,12,0,4481
271,257,14,215,42,1967,1358,257500,249,22,91.88,8.12,47,8,27,60,155,0,130,0,21,0,0,16,94,18,18,4482
689,669,20,432,237,1978,1519,0,366,323,53.12,46.88,209,50,128,163,23,0,60,6,0,0,191,44,161,21,10,4483
911,838,73,118,720,1987,1113,242700,181,730,19.87,80.13,214,305,92,18,83,8,219,211,92,0,0,30,62,14,0,4484
242,242,0,106,136,1973,1448,184900,205,37,84.71,15.29,112,0,0,32,12,0,16,0,0,0,0,49,32,12,0,4485
347,347,0,290,57,1993,1732,234100,347,0,100.00,0.00,253,180,11,41,0,0,0,79,10,0,0,73,309,14,0,4486
366,333,33,321,12,1984,1214,370600,255,111,69.67,30.33,74,107,113,0,28,0,0,12,9,0,7,65,116,35,78,4487
658,621,37,513,108,1984,1264,422700,576,82,87.54,12.46,222,155,133,56,64,0,11,12,13,0,9,14,89,81,370,4488
742,632,110,565,67,1978,0,462000,662,80,89.22,10.78,255,77,238,88,39,0,61,0,0,0,16,12,185,133,290,4489
670,670,0,575,95,1983,0,480800,653,17,97.46,2.54,125,224,90,38,61,0,0,27,0,0,32,59,17,90,313,4490
379,357,22,294,63,1984,1049,404300,347,32,91.56,8.44,147,101,69,26,48,0,13,0,0,0,25,22,68,80,146,4491
1106,1047,59,721,326,1995,1092,200000,982,124,88.79,11.21,520,43,130,117,104,39,15,105,19,0,26,341,268,0,55,4492
658,588,70,505,83,1984,1347,495500,614,44,93.31,6.69,191,138,134,100,268,0,30,38,45,14,0,0,69,98,408,4493
824,758,66,706,52,1982,0,484000,805,19,97.69,2.31,251,135,181,45,154,0,57,30,0,0,0,22,107,132,335,4494
536,525,11,392,133,1981,1489,580200,536,0,100.00,0.00,88,137,126,104,80,0,11,10,24,8,16,28,76,79,247,4495
1006,918,88,238,680,1972,828,209000,295,711,29.32,70.68,410,168,196,104,156,123,476,21,0,111,0,45,28,0,9,4496
663,542,121,210,332,1957,991,142100,424,239,63.95,36.05,10,8,50,35,347,19,117,33,0,39,0,202,26,0,0,4497
544,471,73,205,266,1960,1059,214100,333,211,61.21,38.79,158,24,218,20,158,10,209,32,35,27,24,0,58,16,58,4498
288,263,25,159,104,1943,0,137800,193,95,67.01,32.99,0,0,12,100,134,0,60,49,0,0,0,50,45,16,0,4499
576,541,35,447,94,1950,1123,245700,542,34,94.10,5.90,55,59,16,17,419,0,52,154,0,0,23,168,74,63,32,4500
416,416,0,84,332,1957,0,114300,229,187,55.05,44.95,83,0,42,41,600,349,133,66,0,0,10,22,15,0,0,4501
562,482,80,277,205,1949,859,171300,429,133,76.33,23.67,0,68,69,31,488,31,169,55,15,0,0,251,43,0,0,4502
615,593,22,42,551,1973,1028,220000,11,604,1.79,98.21,68,52,265,48,54,48,287,57,0,24,9,28,24,0,0,4503
570,456,114,315,141,1975,1294,483300,340,230,59.65,40.35,65,71,375,97,69,0,26,74,0,0,25,53,117,117,215,4504
434,414,20,273,141,1963,1758,421400,273,161,62.90,37.10,59,12,36,121,123,0,12,0,26,39,12,12,105,85,26,4505
384,384,0,161,223,1965,1254,386600,219,165,57.03,42.97,41,68,97,24,177,0,100,52,21,0,12,0,135,41,35,4506
564,564,0,361,203,1969,1500,592600,345,219,61.17,38.83,52,81,170,227,28,0,2,175,16,0,0,42,64,5,207,4507
356,356,0,188,168,1988,1506,553600,197,159,55.34,44.66,98,95,177,75,72,29,122,141,54,17,0,20,19,27,88,4508
734,621,113,364,257,1966,1293,602100,470,264,64.03,35.97,50,32,206,198,347,0,185,151,79,54,0,25,69,10,193,4509
1252,1217,35,566,651,1996,1810,443000,453,799,36.18,63.82,794,124,114,47,10,13,281,18,30,277,37,19,36,72,228,4510
567,567,0,458,109,1975,1172,1118900,470,97,82.89,17.11,70,73,279,55,48,0,0,0,0,0,15,0,29,0,441,4511
654,596,58,514,82,1991,955,385000,535,119,81.80,18.20,294,62,86,22,89,0,22,6,5,7,32,16,154,143,119,4512
351,312,39,238,74,1983,597,227700,205,146,58.40,41.60,111,18,76,21,165,40,142,0,0,0,19,78,82,0,16,4513
502,477,25,424,53,1987,1632,281500,459,43,91.43,8.57,239,131,115,40,34,0,0,19,0,0,30,121,217,123,28,4514
668,626,42,489,137,1992,1311,282500,640,28,95.81,4.19,339,174,138,0,13,0,7,58,0,0,14,120,323,136,6,4515
1504,1189,315,1111,78,1993,1438,320700,1433,71,95.28,4.72,600,239,210,268,91,0,0,21,15,16,0,348,353,73,208,4516
726,630,96,388,242,1958,1242,270000,542,184,74.66,25.34,110,60,152,77,180,0,76,33,0,0,60,159,63,53,129,4517
854,841,13,739,102,1980,1528,249500,785,69,91.92,8.08,356,169,325,0,129,0,60,75,0,0,27,230,292,86,0,4518
539,505,34,478,27,1980,0,268400,462,77,85.71,14.29,311,181,89,37,209,14,7,0,39,0,10,244,348,42,96,4519
764,703,61,669,34,1991,0,345500,746,18,97.64,2.36,431,148,94,37,17,0,16,10,0,0,23,22,300,113,135,4520
381,361,20,257,104,1960,1329,167900,353,28,92.65,7.35,45,39,47,72,211,0,0,64,0,0,44,222,56,0,0,4521
332,309,23,249,60,1962,1210,118600,297,35,89.46,10.54,25,27,38,64,177,0,20,44,24,0,0,222,0,0,0,4522
311,311,0,287,24,1966,0,347200,311,0,100.00,0.00,0,0,0,129,281,0,0,16,0,49,13,70,249,13,0,4523
797,797,0,639,158,1982,879,158600,602,195,75.53,24.47,299,95,160,35,87,0,0,63,0,0,52,337,135,27,0,4524
438,417,21,356,61,1967,1069,163600,438,0,100.00,0.00,12,39,60,86,198,0,46,38,10,0,27,215,40,0,6,4525
629,590,39,463,127,1957,998,170900,594,35,94.44,5.56,56,12,32,72,338,0,0,78,0,0,24,267,115,14,12,4526
711,688,23,577,111,1985,1255,368600,638,73,89.73,10.27,238,111,84,53,111,0,18,0,0,26,0,67,207,106,149,4527
503,418,85,353,65,1992,1703,326800,455,48,90.46,9.54,247,57,43,8,99,0,12,39,43,0,0,8,175,107,62,4528
826,674,152,643,31,1995,0,380100,703,123,85.11,14.89,277,146,107,0,42,0,13,0,16,0,0,71,171,110,178,4529
668,627,41,178,449,2003,1481,287700,186,482,27.84,72.16,441,77,23,16,0,0,78,321,83,0,0,0,42,0,0,4530
377,377,0,238,139,1986,917,253700,228,149,60.48,39.52,157,86,83,0,28,0,0,0,73,0,0,56,181,0,0,4531
600,600,0,345,255,1966,1470,328700,304,296,50.67,49.33,26,34,235,302,87,0,91,83,10,10,0,158,59,82,121,4532
531,465,66,317,148,1975,1627,582100,413,118,77.78,22.22,62,202,37,107,167,0,13,67,62,0,0,52,27,72,212,4533
1085,988,97,596,392,1993,589,253400,542,543,49.95,50.05,438,160,146,50,24,172,80,62,50,39,53,96,155,70,0,4534
1016,795,221,516,279,1983,1113,201600,851,165,83.76,16.24,207,110,71,68,381,36,73,71,0,14,26,268,104,65,13,4535
342,342,0,101,241,1959,528,294800,121,221,35.38,64.62,20,0,0,9,266,0,73,14,0,0,0,105,38,19,9,4536
402,380,22,48,332,1945,727,0,98,304,24.38,75.62,14,18,0,56,459,238,135,14,0,0,14,11,8,15,37,4537
767,681,86,597,84,1986,1700,350500,737,30,96.09,3.91,432,181,127,77,20,0,0,32,0,0,0,54,261,152,238,4538
913,824,89,581,243,1996,1439,377400,794,119,86.97,13.03,364,102,131,41,99,0,0,53,0,23,0,121,154,70,222,4539
435,373,62,338,35,1985,1089,201400,345,90,79.31,20.69,104,68,234,84,124,0,79,0,0,0,13,253,207,13,49,4540
464,464,0,448,16,1992,0,185800,353,111,76.08,23.92,148,21,121,46,31,10,18,0,0,0,0,218,90,7,24,4541
564,564,0,385,179,1994,0,299500,362,202,64.18,35.82,197,33,93,118,57,0,77,8,0,0,0,126,130,43,35,4542
672,601,71,435,166,1989,1048,211800,533,139,79.32,20.68,252,21,108,40,116,25,117,63,32,0,18,148,59,27,11,4543
965,965,0,591,374,1991,776,180500,668,297,69.22,30.78,343,81,264,8,37,0,44,100,11,0,25,454,91,0,8,4544
625,625,0,461,164,1976,764,216300,454,171,72.64,27.36,181,52,110,111,200,0,14,0,0,0,78,256,166,56,12,4545
319,319,0,307,12,1972,0,271800,319,0,100.00,0.00,71,0,131,58,30,0,26,0,0,0,0,79,153,14,0,4546
471,396,75,296,100,1949,754,103400,243,228,51.59,48.41,75,17,86,44,272,48,113,66,0,0,150,75,32,0,0,4547
300,300,0,127,173,1948,709,122700,179,121,59.67,40.33,0,26,17,18,332,49,151,0,0,0,32,148,13,0,0,4548
201,159,42,104,55,1944,799,87100,201,0,100.00,0.00,10,40,28,0,135,0,96,0,0,0,0,71,0,0,0,4549
581,566,15,440,126,1987,1098,161300,438,143,75.39,24.61,452,140,86,8,69,0,14,63,13,0,51,325,245,0,0,4550
586,505,81,437,68,1991,1277,172100,386,200,65.87,34.13,302,88,51,76,47,7,24,67,11,0,38,241,116,6,8,4551
709,586,123,208,378,1993,1163,143400,160,549,22.57,77.43,198,275,24,11,45,0,277,97,0,0,70,14,42,0,0,4552
595,559,36,85,474,1968,939,178800,77,518,12.94,87.06,186,63,93,56,205,0,295,202,28,0,0,20,15,9,0,4553
689,689,0,578,111,1989,1745,367800,689,0,100.00,0.00,247,204,126,0,0,0,0,0,77,13,0,28,249,127,83,4554
934,773,161,400,373,1993,1261,207600,412,522,44.11,55.89,435,264,49,49,97,15,178,186,19,0,173,166,146,0,0,4555
482,449,33,265,184,1977,1017,263800,342,140,70.95,29.05,200,37,120,80,126,0,16,30,84,0,9,91,188,145,0,4556
855,828,27,761,67,1992,1198,458100,849,6,99.30,0.70,395,50,135,62,188,0,0,0,0,0,0,18,123,126,512,4557
328,328,0,283,45,1981,0,529200,328,0,100.00,0.00,57,169,112,65,0,0,0,0,50,0,0,43,66,59,185,4558
703,670,33,592,78,1993,1375,397700,642,61,91.32,8.68,493,186,15,37,21,0,28,25,0,0,0,56,186,186,238,4559
582,559,23,480,79,1983,0,577900,582,0,100.00,0.00,33,172,156,41,0,0,0,0,0,0,0,0,21,122,246,4560
324,301,23,301,0,1992,0,566600,324,0,100.00,0.00,125,51,55,48,73,0,34,0,0,0,0,0,50,30,219,4561
443,414,29,340,74,1981,1411,641700,414,29,93.45,6.55,51,198,87,29,11,0,0,0,0,0,0,0,23,11,314,4562
743,743,0,469,274,1988,1964,292100,743,0,100.00,0.00,333,138,131,100,31,0,20,22,56,9,0,21,429,114,7,4563
412,386,26,240,146,1967,979,234000,243,169,58.98,41.02,0,24,85,322,21,0,101,68,0,0,0,112,159,12,0,4564
345,345,0,316,29,1993,2097,311800,345,0,100.00,0.00,185,107,29,12,11,0,0,27,10,13,0,14,199,43,38,4565
257,257,0,230,27,1991,2250,255200,257,0,100.00,0.00,119,133,0,16,8,0,0,25,30,0,0,27,128,10,24,4566
504,467,37,391,76,1974,1792,253800,504,0,100.00,0.00,97,20,289,110,10,0,50,0,9,0,0,154,256,48,9,4567
494,467,27,404,63,1987,1989,310400,457,37,92.51,7.49,82,177,146,108,70,0,0,56,0,0,0,85,252,110,47,4568
805,779,26,493,286,1994,1514,173600,448,357,55.65,44.35,211,199,99,67,50,0,53,23,5,0,171,118,175,0,49,4569
553,553,0,387,166,1974,732,187900,410,143,74.14,25.86,175,110,82,65,153,43,48,0,0,0,10,252,119,0,7,4570
187,187,0,187,0,1973,0,256600,147,40,78.61,21.39,35,45,38,23,137,0,23,0,0,0,45,106,83,11,10,4571
811,749,62,707,42,1988,0,241700,631,180,77.81,22.19,257,22,134,36,167,0,16,0,10,0,36,329,141,25,59,4572
652,565,87,301,264,1991,770,364800,511,141,78.37,21.63,178,0,32,81,88,13,70,14,0,0,18,91,67,18,9,4573
146,146,0,61,85,2003,0,283700,90,56,61.64,38.36,119,40,93,0,0,40,56,0,13,0,11,38,20,0,36,4574
480,464,16,278,186,1977,737,222000,390,90,81.25,18.75,79,33,79,20,85,0,16,11,0,0,16,52,71,22,108,4575
450,323,127,300,23,1977,554,134700,279,171,62.00,38.00,78,63,94,30,42,0,7,7,0,0,60,157,19,0,16,4576
472,440,32,409,31,1989,0,179700,268,204,56.78,43.22,161,32,73,70,91,0,12,0,0,0,101,120,66,16,65,4577
297,277,20,196,81,1968,484,9999,12,285,4.04,95.96,30,58,127,123,41,47,101,0,0,0,177,9,10,0,5,4578
482,435,47,188,247,1939,919,117600,482,0,100.00,0.00,30,0,28,8,373,8,50,21,0,0,51,204,0,6,0,4579
429,399,30,312,87,1967,1292,159000,415,14,96.74,3.26,10,0,0,104,308,0,105,28,0,0,10,258,21,0,0,4580
495,418,77,177,241,1964,710,121700,294,201,59.39,40.61,62,0,121,120,294,56,210,0,0,0,58,196,0,0,0,4581
338,338,0,262,76,1985,1367,302900,281,57,83.14,16.86,0,48,60,46,93,0,0,14,12,0,0,31,78,84,28,4582
337,337,0,294,43,1978,1813,358900,337,0,100.00,0.00,42,130,225,0,0,0,0,33,68,0,0,0,91,164,41,4583
508,508,0,384,124,1984,0,229700,353,155,69.49,30.51,21,281,142,0,7,0,0,0,0,0,186,76,155,7,27,4584
677,655,22,507,148,1977,970,299800,554,123,81.83,18.17,229,24,88,146,11,0,14,0,74,0,15,34,209,126,26,4585
357,322,35,260,62,1962,809,127500,254,103,71.15,28.85,26,47,57,90,179,0,73,14,0,0,44,184,13,14,27,4586
686,640,46,524,116,1992,1333,216800,560,126,81.63,18.37,214,23,72,18,180,0,67,42,0,0,32,205,86,20,14,4587
511,444,67,323,121,1968,828,176200,414,97,81.02,18.98,197,56,115,23,162,39,136,0,0,0,50,226,25,0,16,4588
558,461,97,319,142,1985,794,203000,433,125,77.60,22.40,225,61,154,9,137,27,79,0,0,0,79,137,73,8,109,4589
523,504,19,489,15,1973,0,917000,505,18,96.56,3.44,84,84,256,69,97,0,68,0,0,16,0,0,59,0,447,4590
509,476,33,428,48,1966,2088,389400,498,11,97.84,2.16,15,0,13,387,18,11,0,0,13,0,8,15,72,165,114,4591
423,415,8,231,184,1968,1510,504200,296,127,69.98,30.02,0,27,15,365,26,0,19,64,79,14,0,0,7,80,136,4592
304,285,19,139,146,1963,638,177900,216,88,71.05,28.95,111,44,36,38,169,94,80,0,14,0,0,149,16,0,6,4593
367,327,40,305,22,1972,0,448600,367,0,100.00,0.00,25,16,116,127,55,0,0,0,0,45,14,0,53,94,119,4594
495,438,57,125,313,1991,969,161400,95,400,19.19,80.81,102,271,83,0,25,0,261,91,0,0,11,41,24,12,0,4595
794,728,66,286,442,1971,1081,208200,357,437,44.96,55.04,44,177,127,152,114,14,147,0,0,0,71,91,152,10,13,4596
456,415,41,352,63,1991,1742,285900,456,0,100.00,0.00,69,103,65,66,50,0,11,18,9,14,0,76,134,46,15,4597
322,322,0,298,24,1966,0,278200,322,0,100.00,0.00,0,0,23,214,33,0,0,17,18,0,0,122,113,0,0,4598
832,781,51,432,349,1999,1493,224400,493,339,59.25,40.75,370,15,35,85,74,0,0,145,18,22,8,72,177,39,58,4599
488,375,113,284,91,1991,0,309400,488,0,100.00,0.00,258,92,31,30,130,0,65,0,0,0,15,16,247,44,61,4600
1013,884,129,0,884,1985,1213,0,32,981,3.16,96.84,312,368,85,209,0,14,439,477,19,0,0,0,0,0,0,4601
398,398,0,324,74,1967,1347,241700,398,0,100.00,0.00,0,0,113,350,26,0,0,0,0,0,0,73,369,47,0,4602
523,523,0,205,318,1993,1033,278300,336,187,64.24,35.76,190,83,52,53,57,48,36,123,0,0,0,20,181,10,0,4603
473,473,0,230,243,1989,501,253600,294,179,62.16,37.84,94,213,49,89,61,29,78,0,0,0,0,95,148,0,13,4604
465,465,0,433,32,1985,0,374600,465,0,100.00,0.00,134,290,8,0,7,0,7,0,0,31,18,0,193,149,32,4605
634,634,0,599,35,1998,0,373000,619,15,97.63,2.37,445,89,37,61,65,0,0,0,13,44,0,40,272,70,211,4606
675,635,40,56,579,1991,854,168300,188,487,27.85,72.15,426,15,80,26,267,155,289,122,5,0,0,39,138,7,0,4607
416,372,44,108,264,1976,1164,229600,126,290,30.29,69.71,51,64,59,82,99,0,148,28,22,0,0,96,34,0,0,4608
409,370,39,174,196,1999,0,257900,175,234,42.79,57.21,99,112,142,57,51,0,43,56,18,0,0,89,141,0,10,4609
446,419,27,288,131,1975,1024,336800,213,233,47.76,52.24,63,67,113,97,126,0,0,20,0,0,0,29,169,65,115,4610
448,369,79,104,265,1978,837,0,55,393,12.28,87.72,17,130,98,147,45,0,190,24,0,0,37,0,14,0,0,4611
383,361,22,113,248,1977,1040,238800,123,260,32.11,67.89,66,123,89,63,81,49,200,56,9,0,0,14,74,0,0,4612
843,832,11,331,501,1968,1064,274200,329,514,39.03,60.97,18,46,339,126,267,0,291,53,0,0,26,0,199,36,70,4613
473,446,27,437,9,1959,0,333500,473,0,100.00,0.00,12,37,59,222,162,0,0,61,0,0,0,92,179,80,55,4614
533,492,41,368,124,1955,1423,262200,526,7,98.69,1.31,91,10,84,101,277,0,72,97,0,0,0,156,160,57,21,4615
634,618,16,261,357,1978,1092,166500,191,443,30.13,69.87,113,398,54,28,100,45,177,115,38,6,37,142,53,7,0,4616
483,443,40,149,294,1968,878,172800,116,367,24.02,75.98,35,234,131,145,110,116,275,132,18,0,0,0,47,18,0,4617
389,340,49,301,39,1961,1513,286700,389,0,100.00,0.00,39,20,31,108,131,0,29,11,31,0,0,12,203,31,0,4618
374,374,0,179,195,1957,992,260700,320,54,85.56,14.44,89,0,0,61,348,0,169,66,0,0,24,60,66,40,32,4619
922,609,313,504,105,1961,1189,380200,912,10,98.92,1.08,260,76,51,42,338,0,52,40,43,0,0,24,123,116,268,4620
714,695,19,569,126,1980,1786,434400,574,140,80.39,19.61,379,151,76,34,79,0,0,123,26,0,14,11,75,119,303,4621
482,482,0,290,192,1984,653,271400,272,210,56.43,43.57,185,194,107,80,61,0,186,23,16,0,7,88,201,0,55,4622
411,398,13,298,100,1970,1250,290500,350,61,85.16,14.84,171,0,73,94,60,0,39,49,8,0,51,13,113,77,37,4623
462,462,0,415,47,1995,0,803100,378,84,81.82,18.18,391,57,52,15,0,0,14,0,0,0,0,17,123,0,323,4624
462,453,9,433,20,1986,0,410700,441,21,95.45,4.55,107,58,109,82,30,0,0,0,0,0,14,19,81,63,200,4625
442,381,61,311,70,1974,1026,299600,365,77,82.58,17.42,51,29,93,117,116,0,0,28,12,11,35,112,93,72,43,4626
594,594,0,539,55,1980,1661,458400,586,8,98.65,1.35,152,242,41,133,103,0,0,9,9,0,10,21,100,110,311,4627
756,738,18,500,238,1983,1157,334600,514,242,67.99,32.01,139,316,104,70,33,0,33,112,7,11,34,82,152,167,64,4628
594,539,55,380,159,1989,754,191500,402,192,67.68,32.32,315,19,91,26,108,0,10,7,0,0,36,285,132,50,0,4629
302,302,0,266,36,1968,0,215800,245,57,81.13,18.87,63,11,111,16,62,0,11,0,0,0,0,89,85,16,13,4630
525,516,9,421,95,1986,1558,350400,468,57,89.14,10.86,151,130,22,85,103,0,0,0,0,37,0,44,210,91,85,4631
770,723,47,647,76,1992,877,282400,648,122,84.16,15.84,252,109,230,34,262,37,73,8,10,0,77,270,251,95,21,4632
512,396,116,208,188,1990,871,183000,288,224,56.25,43.75,83,13,169,35,140,20,112,21,0,0,104,93,62,0,11,4633
476,476,0,134,342,1950,839,125800,331,145,69.54,30.46,0,54,52,91,358,28,235,12,0,0,62,144,47,0,0,4634
392,369,23,145,224,1939,666,140800,183,209,46.68,53.32,53,31,17,8,196,0,133,41,11,0,0,77,0,0,0,4635
315,293,22,177,116,1950,746,132500,242,73,76.83,23.17,0,12,46,40,159,8,85,37,5,0,0,73,9,0,0,4636
673,561,112,442,119,1985,709,194900,430,243,63.89,36.11,244,99,110,42,152,0,42,0,0,0,47,265,227,29,37,4637
819,819,0,713,106,1988,1210,184300,552,267,67.40,32.60,232,99,199,94,112,0,115,0,0,0,126,269,134,18,47,4638
599,533,66,466,67,1972,1726,663100,557,42,92.99,7.01,62,55,98,282,115,0,0,0,29,10,0,8,93,102,323,4639
548,522,26,410,112,1977,1456,402600,514,34,93.80,6.20,33,114,124,197,129,0,0,14,40,0,0,70,244,192,37,4640
488,488,0,114,374,1991,1143,418600,169,319,34.63,65.37,181,124,234,0,29,0,175,242,30,0,0,0,23,72,0,4641
856,856,0,352,504,1988,1627,422700,390,466,45.56,54.44,263,318,61,87,96,36,23,353,35,27,0,12,74,60,156,4642
484,484,0,426,58,1973,0,632200,484,0,100.00,0.00,100,102,64,199,31,0,0,13,15,12,26,0,27,13,390,4643
585,585,0,337,248,1996,858,419900,263,322,44.96,55.04,426,12,13,15,38,0,68,51,12,16,0,17,71,102,97,4644
522,483,39,275,208,1985,1426,808200,354,168,67.82,32.18,173,157,93,46,54,0,11,130,42,0,0,7,51,8,244,4645
885,885,0,467,418,1973,1372,536900,253,632,28.59,71.41,130,100,323,164,211,90,52,108,60,0,0,27,118,26,309,4646
278,278,0,238,40,1984,0,242400,265,13,95.32,4.68,35,123,52,0,7,0,42,0,11,0,0,23,141,0,0,4647
518,472,46,399,73,1963,0,983700,518,0,100.00,0.00,24,37,53,173,195,0,1,0,0,15,13,9,0,24,406,4648
575,511,64,412,99,1992,1005,326800,491,84,85.39,14.61,252,84,140,83,79,0,67,6,42,0,16,136,144,63,65,4649
927,927,0,369,558,1987,1225,215600,445,482,48.00,52.00,51,706,99,33,11,68,180,249,63,0,7,176,51,0,20,4650
640,640,0,91,549,1987,1009,189700,77,563,12.03,87.97,270,198,74,133,50,108,201,55,58,0,0,102,36,14,0,4651
524,483,41,250,233,1967,830,450600,266,258,50.76,49.24,11,14,147,221,84,65,149,0,0,0,0,16,60,37,77,4652
522,522,0,296,226,1971,907,446400,354,168,67.82,32.18,92,61,37,44,279,0,124,0,0,13,11,21,53,39,190,4653
521,459,62,380,79,1967,1799,479700,436,85,83.69,16.31,108,0,71,169,178,0,33,0,13,0,0,33,84,132,219,4654
1369,1346,23,241,1105,1970,860,147600,180,1189,13.15,86.85,96,465,155,395,365,20,873,107,56,0,35,122,141,0,0,4655
633,581,52,7,574,1982,855,0,56,577,8.85,91.15,39,81,191,73,60,50,327,13,0,0,0,10,12,0,0,4656
648,617,31,411,206,1973,569,478600,490,158,75.62,24.38,170,48,77,24,348,0,29,11,27,15,18,71,129,133,149,4657
374,354,20,263,91,1963,984,246000,325,49,86.90,13.10,5,7,0,55,287,0,10,36,0,0,17,133,102,0,27,4658
828,726,102,519,207,1995,1037,238200,467,361,56.40,43.60,684,165,16,32,60,0,72,140,35,0,118,162,248,91,47,4659
598,579,19,313,266,1983,990,349200,266,332,44.48,55.52,188,148,47,47,40,0,128,26,0,0,0,54,111,77,32,4660
437,437,0,236,201,1960,2221,714300,306,131,70.02,29.98,241,26,24,12,87,0,58,93,15,44,12,0,12,26,117,4661
450,450,0,381,69,1976,3046,550700,450,0,100.00,0.00,128,89,218,30,8,0,12,16,11,50,0,0,9,33,321,4662
427,385,42,352,33,1970,2542,1881600,427,0,100.00,0.00,62,38,65,61,141,0,3,11,3,3,4,0,0,0,292,4663
666,666,0,579,87,1979,2375,458600,658,8,98.80,1.20,250,87,276,36,49,0,36,0,0,20,0,0,168,263,175,4664
681,590,91,198,392,1996,1313,170300,147,534,21.59,78.41,305,276,188,10,0,20,156,166,55,0,83,169,71,0,0,4665
502,502,0,379,123,1978,1945,277700,486,16,96.81,3.19,105,56,110,212,53,0,30,24,0,11,11,29,339,73,0,4666
386,356,30,340,16,1983,0,276800,351,35,90.93,9.07,45,188,39,0,42,0,0,27,9,0,0,57,162,33,26,4667
667,623,44,471,152,1968,922,191600,548,119,82.16,17.84,265,15,13,96,226,0,124,53,16,0,0,159,163,64,0,4668
558,515,43,449,66,1977,1640,253900,292,266,52.33,47.67,54,146,139,116,115,0,16,25,9,11,65,100,246,52,20,4669
396,371,25,339,32,1989,641,486700,325,71,82.07,17.93,191,113,0,17,0,0,0,0,0,18,11,37,84,27,144,4670
566,566,0,558,8,1994,0,458800,512,54,90.46,9.54,378,74,110,15,9,0,9,41,0,0,9,23,81,93,273,4671
318,288,30,241,47,1995,1173,266100,318,0,100.00,0.00,237,13,17,0,59,0,0,36,85,0,0,56,137,12,0,4672
679,649,30,518,131,1999,1561,327100,679,0,100.00,0.00,424,141,0,0,0,0,0,0,26,0,15,25,368,62,69,4673
320,320,0,301,19,1980,0,585000,309,11,96.56,3.44,46,52,101,39,113,0,8,8,0,0,8,0,17,33,236,4674
1171,1099,72,595,504,1993,839,173200,610,561,52.09,47.91,644,148,174,25,61,65,92,27,12,79,99,372,129,39,45,4675
359,351,8,294,57,1969,1004,178400,330,29,91.92,8.08,57,48,67,139,147,0,87,31,0,0,24,182,54,0,14,4676
529,485,44,199,286,1963,963,97100,365,164,69.00,31.00,65,159,148,106,222,17,234,70,0,0,57,138,4,11,0,4677
758,685,73,434,251,1970,721,243800,543,215,71.64,28.36,249,73,139,91,141,18,130,43,0,0,22,132,117,61,139,4678
335,273,62,167,106,1941,685,152300,267,68,79.70,20.30,92,0,0,14,215,7,71,61,0,0,16,152,14,0,0,4679
549,549,0,371,178,1978,833,179000,406,143,73.95,26.05,240,92,69,10,168,0,18,0,0,0,62,275,101,23,26,4680
584,478,106,310,168,1977,618,146800,232,352,39.73,60.27,96,38,131,53,133,20,28,11,0,0,71,181,37,0,0,4681
657,657,0,622,35,1968,0,304600,657,0,100.00,0.00,32,90,87,200,14,0,0,22,13,0,0,29,208,128,23,4682
430,430,0,380,50,1967,0,351700,406,24,94.42,5.58,66,55,75,72,77,0,21,9,11,20,0,21,70,7,149,4683
591,591,0,495,96,1971,1222,342700,575,16,97.29,2.71,84,42,244,185,34,0,0,0,0,0,0,127,283,102,77,4684
1073,1008,65,728,280,2004,1409,259700,695,378,64.77,35.23,197,39,20,117,89,0,0,77,54,0,0,107,148,21,10,4685
688,421,267,217,204,1981,570,243400,485,203,70.49,29.51,141,47,87,6,39,72,38,7,0,0,0,41,25,34,41,4686
525,442,83,401,41,1991,765,230600,525,0,100.00,0.00,308,54,26,0,115,0,67,51,21,0,9,176,136,28,0,4687
920,789,131,428,361,1993,724,169900,502,418,54.57,45.43,400,63,132,70,116,24,137,25,0,0,189,185,33,0,19,4688
510,462,48,338,124,1944,998,169000,499,11,97.84,2.16,36,17,33,66,414,0,117,32,0,0,14,304,75,0,0,4689
310,277,33,72,205,1959,660,213300,130,180,41.94,58.06,0,0,0,0,242,0,43,0,0,0,1,120,0,0,0,4690
201,201,0,188,13,1953,0,202900,201,0,100.00,0.00,26,12,0,19,174,0,26,0,26,0,13,141,12,0,13,4691
903,903,0,709,194,2001,1358,279500,835,68,92.47,7.53,576,68,18,0,225,30,44,10,18,0,25,106,445,116,19,4692
326,251,75,44,207,1966,930,88500,120,206,36.81,63.19,12,55,34,67,187,28,201,27,0,11,0,39,32,0,0,4693
832,691,141,668,23,1992,0,390700,772,60,92.79,7.21,244,99,114,105,66,0,18,0,9,0,12,71,120,94,189,4694
378,344,34,336,8,1993,0,295200,322,56,85.19,14.81,299,50,44,31,0,0,8,0,0,0,0,11,235,53,94,4695
370,370,0,330,40,1991,0,463200,339,31,91.62,8.38,170,37,108,0,77,0,20,30,0,0,4,46,133,49,49,4696
442,428,14,338,90,1980,1156,339800,384,58,86.88,13.12,42,162,117,88,15,0,30,65,21,0,0,0,165,90,11,4697
531,531,0,411,120,1988,1331,196500,512,19,96.42,3.58,413,72,157,80,35,0,70,162,26,0,0,273,172,0,15,4698
582,535,47,463,72,1992,1653,303300,465,117,79.90,20.10,281,97,84,39,8,0,45,7,36,0,0,78,152,80,61,4699
442,427,15,248,179,1988,1286,205500,299,143,67.65,32.35,256,134,26,27,6,0,18,71,68,0,85,94,34,21,8,4700
278,278,0,239,39,1991,848,366500,256,22,92.09,7.91,83,96,69,9,40,9,27,0,10,0,7,0,86,85,41,4701
506,506,0,439,67,1988,0,286300,506,0,100.00,0.00,158,94,73,16,15,0,0,0,12,0,0,41,168,104,15,4702
661,600,61,525,75,1963,1352,471600,602,59,91.07,8.93,34,24,135,171,253,0,45,0,0,21,0,14,78,139,290,4703
531,484,47,411,73,1967,1821,414500,518,13,97.55,2.45,81,63,63,53,175,0,13,0,0,0,0,21,105,155,141,4704
628,594,34,470,124,1955,1799,398000,628,0,100.00,0.00,23,22,47,32,477,0,0,39,13,0,0,30,209,118,192,4705
602,602,0,432,170,1948,1815,297700,594,8,98.67,1.33,39,0,31,18,484,0,0,59,0,0,5,73,325,81,20,4706
374,374,0,252,122,1966,1127,350000,291,83,77.81,22.19,121,9,65,68,197,0,37,23,0,46,0,47,149,88,70,4707
452,432,20,260,172,1957,582,369200,333,119,73.67,26.33,109,7,49,16,190,14,15,0,16,0,9,40,142,72,63,4708
359,353,6,329,24,1958,1125,526800,353,6,98.33,1.67,21,0,38,147,209,0,0,0,0,24,0,0,44,86,252,4709
291,291,0,227,64,1960,1654,363800,246,45,84.54,15.46,54,11,30,158,112,0,10,0,0,0,20,51,177,87,10,4710
317,317,0,254,63,1973,1736,332900,317,0,100.00,0.00,50,19,166,185,37,0,0,0,29,0,24,34,271,66,0,4711
526,526,0,461,65,1979,950,356900,377,149,71.67,28.33,62,215,150,0,48,13,0,0,24,0,0,73,115,197,53,4712
502,502,0,487,15,1967,0,409200,403,99,80.28,19.72,59,41,76,119,177,0,0,0,22,0,0,20,120,169,130,4713
505,455,50,225,230,1960,1403,275000,451,54,89.31,10.69,83,33,57,109,180,16,0,38,0,18,0,0,176,146,9,4714
308,272,36,214,58,1947,1016,459600,250,58,81.17,18.83,11,14,35,80,319,0,51,32,24,30,6,75,73,45,64,4715
435,389,46,275,114,1949,1399,503900,279,156,64.14,35.86,34,10,145,182,306,0,179,92,0,15,9,50,79,71,121,4716
367,327,40,306,21,1961,0,265500,355,12,96.73,3.27,117,0,11,149,43,9,11,13,27,29,0,35,112,28,32,4717
432,432,0,304,128,1948,0,530700,356,76,82.41,17.59,44,33,55,31,212,68,0,25,0,0,0,30,26,67,159,4718
441,380,61,259,121,1959,1806,534500,427,14,96.83,3.17,57,31,70,109,256,0,53,15,0,0,0,0,89,104,166,4719
790,765,25,282,483,1960,0,268800,434,356,54.94,45.06,90,28,119,24,385,69,153,125,0,0,0,49,137,44,0,4720
514,514,0,348,166,1948,1055,267000,445,69,86.58,13.42,13,0,27,31,463,0,21,50,15,0,0,135,262,51,0,4721
659,616,43,193,423,1951,833,271100,350,309,53.11,46.89,106,18,17,49,280,0,166,23,21,0,0,58,113,0,8,4722
1227,1157,70,189,968,1993,1281,169700,37,1190,3.02,96.98,655,349,186,162,60,117,345,528,106,0,0,195,11,0,0,4723
504,504,0,376,128,1972,2062,479100,449,55,89.09,10.91,14,72,86,205,28,0,28,0,0,0,0,16,54,125,165,4724
531,516,15,444,72,1989,1526,369700,516,15,97.18,2.82,130,37,35,153,49,0,26,0,20,0,0,0,171,114,46,4725
297,297,0,267,30,1973,0,511300,266,31,89.56,10.44,24,23,102,56,66,0,0,0,0,0,0,0,75,69,127,4726
560,560,0,378,182,1969,1148,334900,454,106,81.07,18.93,158,15,45,163,135,0,52,35,5,0,0,19,176,69,127,4727
658,588,70,353,235,1977,672,209100,398,260,60.49,39.51,28,103,117,101,208,19,99,30,7,0,65,157,116,0,23,4728
716,358,358,256,102,1988,867,516400,565,151,78.91,21.09,208,340,204,46,47,0,32,0,0,0,33,0,97,48,130,4729
946,733,213,616,117,1989,0,309100,586,360,61.95,38.05,215,144,178,61,354,14,31,16,0,0,59,171,205,32,184,4730
1771,488,1283,425,63,1987,0,322800,1491,280,84.19,15.81,330,289,342,105,324,0,27,0,0,0,18,57,10,10,112,4731
659,649,10,530,119,1986,0,259900,500,159,75.87,24.13,186,153,207,30,120,43,75,0,0,0,0,290,131,13,18,4732
460,425,35,409,16,1980,1600,935200,457,3,99.35,0.65,180,52,50,34,150,0,2,5,3,10,3,3,7,16,403,4733
707,652,55,125,527,1998,913,186700,204,503,28.85,71.15,298,14,47,16,112,32,217,34,0,0,0,43,14,12,0,4734
484,390,94,209,181,1939,1066,276700,230,254,47.52,52.48,0,30,29,0,465,9,205,100,48,0,0,36,88,38,0,4735
512,512,0,427,85,1942,1301,360500,494,18,96.48,3.52,10,0,10,17,400,0,8,17,0,10,0,22,132,91,107,4736
510,510,0,430,80,1987,2035,273000,500,10,98.04,1.96,267,232,11,0,0,0,0,13,78,0,9,8,189,151,34,4737
313,313,0,223,90,1955,0,280300,313,0,100.00,0.00,0,15,13,0,260,0,0,14,15,0,19,54,186,0,0,4738
413,413,0,301,112,1954,1298,297500,379,34,91.77,8.23,36,0,48,57,476,0,69,60,0,0,0,14,375,33,13,4739
841,805,36,446,359,1972,909,270200,280,561,33.29,66.71,78,102,325,204,79,167,212,26,0,12,11,87,222,35,16,4740
267,240,27,198,42,1976,1181,272300,198,69,74.16,25.84,13,53,63,25,166,0,10,45,0,5,15,18,138,36,0,4741
410,410,0,191,219,1959,1310,340600,344,66,83.90,16.10,32,30,18,0,340,0,0,18,41,0,0,26,218,50,25,4742
489,424,65,281,143,1973,1167,483300,277,212,56.65,43.35,62,26,111,217,78,0,29,60,23,0,16,58,92,47,93,4743
821,775,46,362,413,1995,813,389300,384,437,46.77,53.23,260,26,46,0,203,98,57,79,36,0,32,54,73,10,13,4744
164,149,15,88,61,1939,1924,448800,11,153,6.71,93.29,9,0,0,11,129,0,0,0,0,0,0,0,11,58,42,4745
470,455,15,181,274,1981,1085,239300,43,427,9.15,90.85,59,319,38,75,49,0,92,147,9,0,10,55,123,8,0,4746
619,489,130,27,462,1981,721,253100,46,573,7.43,92.57,198,40,8,18,277,281,162,39,0,0,0,0,13,0,12,4747
321,284,37,173,111,1962,848,397700,229,92,71.34,28.66,42,0,41,89,123,10,79,0,0,0,0,20,92,65,29,4748
546,515,31,336,179,1985,1097,355700,450,96,82.42,17.58,113,60,132,10,89,0,11,0,0,0,56,76,96,10,98,4749
473,382,91,330,52,1974,0,316900,309,164,65.33,34.67,76,110,149,158,0,0,11,13,0,0,45,121,118,0,116,4750
468,390,78,357,33,1977,0,360800,458,10,97.86,2.14,0,27,381,0,0,0,0,15,14,0,0,0,275,104,0,4751
1102,835,267,84,751,2003,1730,0,0,1102,0.00,100.00,139,232,0,0,0,0,53,69,13,0,0,35,119,8,0,4752
522,484,38,376,108,1989,2078,337900,484,38,92.72,7.28,272,13,12,30,62,0,0,16,57,0,0,14,194,40,68,4753
374,374,0,347,27,1967,0,352900,374,0,100.00,0.00,25,42,111,168,18,0,0,50,27,0,0,34,112,84,57,4754
475,381,94,319,62,1992,1369,442700,355,120,74.74,25.26,211,92,58,45,47,0,50,0,0,0,7,38,47,84,192,4755
349,340,9,155,185,1972,997,278400,181,168,51.86,48.14,42,31,72,166,142,14,197,20,73,0,0,14,46,0,0,4756
366,366,0,253,113,1962,1179,345700,329,37,89.89,10.11,79,20,0,65,236,0,20,33,0,0,0,24,159,119,45,4757
432,432,0,291,141,1957,1128,456100,390,42,90.28,9.72,54,37,66,5,356,0,105,0,24,0,0,27,241,85,36,4758
328,328,0,250,78,1944,1847,366100,315,13,96.04,3.96,12,13,4,37,236,0,0,18,0,37,0,24,61,77,0,4759
623,561,62,350,211,1946,868,356000,460,163,73.84,26.16,86,0,28,0,368,50,118,0,0,0,18,37,145,66,19,4760
635,597,38,228,369,2004,828,346200,286,349,45.04,54.96,499,13,69,65,69,374,122,18,0,0,0,0,41,128,0,4761
534,493,41,274,219,1997,1193,325000,184,350,34.46,65.54,245,92,17,48,272,0,44,198,48,0,0,125,70,15,84,4762
582,541,41,395,146,1951,1027,447400,402,180,69.07,30.93,128,26,24,42,330,0,105,79,18,16,0,12,49,99,172,4763
590,590,0,395,195,1953,1712,523400,401,189,67.97,32.03,83,25,25,66,432,0,102,25,81,14,0,36,58,57,185,4764
384,384,0,357,27,1955,0,485000,384,0,100.00,0.00,51,0,19,0,329,0,14,15,15,0,0,0,153,127,75,4765
840,785,55,628,157,1967,1202,662500,632,208,75.24,24.76,91,156,46,160,341,0,66,43,71,16,0,40,57,29,373,4766
262,262,0,262,0,1975,0,177200,262,0,100.00,0.00,71,26,49,67,49,0,0,0,0,0,15,154,51,20,22,4767
415,392,23,368,24,1954,880,561900,415,0,100.00,0.00,27,0,0,66,362,0,0,0,0,0,10,0,82,31,220,4768
984,911,73,716,195,1990,1066,162200,516,468,52.44,47.56,538,210,184,0,34,0,42,126,0,0,131,576,34,14,0,4769
602,602,0,473,129,1969,1192,409300,504,98,83.72,16.28,217,143,125,203,73,0,0,274,44,0,0,15,87,242,99,4770
393,286,107,220,66,1985,514,0,188,205,47.84,52.16,129,176,198,18,61,42,90,0,0,0,190,62,102,0,14,4771
1062,659,403,512,147,1989,737,459000,942,120,88.70,11.30,276,161,178,50,75,5,102,20,0,3,0,30,91,54,266,4772
664,577,87,512,65,1976,1083,253100,569,95,85.69,14.31,224,115,161,156,53,0,0,22,11,0,80,83,387,53,32,4773
748,748,0,684,64,2004,1763,262700,701,47,93.72,6.28,221,61,0,20,34,0,18,0,9,0,10,24,169,24,27,4774
570,495,75,400,95,1988,1317,298500,462,108,81.05,18.95,216,87,123,74,26,0,57,0,18,0,10,138,90,100,68,4775
538,490,48,396,94,1976,1375,338800,479,59,89.03,10.97,175,90,86,32,116,0,51,26,7,0,10,82,94,58,116,4776
601,552,49,451,101,1977,953,324200,428,173,71.21,28.79,237,86,65,17,63,0,0,0,0,0,8,124,165,62,46,4777
669,611,58,478,133,1993,881,228800,438,231,65.47,34.53,358,105,114,20,5,36,58,38,7,0,42,128,137,59,57,4778
440,440,0,332,108,1954,989,317900,417,23,94.77,5.23,17,41,88,58,164,44,34,41,38,0,11,62,66,17,10,4779
339,331,8,202,129,1955,1208,321300,302,37,89.09,10.91,63,35,8,36,196,0,35,0,19,35,10,50,107,11,0,4780
391,357,34,150,207,1939,805,284400,219,172,56.01,43.99,23,0,17,33,219,0,117,48,34,0,0,5,54,0,0,4781
442,418,24,112,306,1969,683,309500,199,243,45.02,54.98,194,45,46,99,99,132,114,50,5,5,15,15,28,21,0,4782
1017,949,68,303,646,1979,958,287900,625,392,61.46,38.54,302,37,176,0,352,172,117,90,13,10,0,64,237,0,0,4783
462,462,0,237,225,1958,1237,479100,298,164,64.50,35.50,57,31,61,70,308,0,75,61,15,0,0,0,89,73,130,4784
477,438,39,257,181,1956,1381,321100,396,81,83.02,16.98,0,9,58,0,404,0,10,0,0,0,23,27,261,76,14,4785
375,354,21,209,145,1974,1500,342100,341,34,90.93,9.07,92,0,79,0,117,7,96,1,33,0,0,0,24,69,44,4786
958,925,33,528,397,1977,1202,194200,736,222,76.83,23.17,251,52,532,15,133,15,169,37,15,0,98,215,224,13,42,4787
615,583,32,393,190,1979,1061,191300,407,208,66.18,33.82,28,263,241,122,36,122,178,42,11,0,0,172,128,0,0,4788
918,591,327,249,342,1979,970,189900,546,372,59.48,40.52,97,140,235,247,82,0,296,126,0,0,0,296,22,0,0,4789
640,483,157,410,73,1990,0,229900,630,10,98.44,1.56,278,167,48,0,402,31,126,44,0,0,0,406,247,29,0,4790
1006,974,32,804,170,1980,1257,279100,789,217,78.43,21.57,479,126,225,50,34,51,20,75,12,30,42,212,271,68,98,4791
704,617,87,468,149,1990,1150,262500,578,126,82.10,17.90,289,91,119,43,126,14,43,28,0,0,10,202,169,42,47,4792
737,660,77,585,75,1990,1412,265600,643,94,87.25,12.75,333,248,103,59,40,0,19,40,19,0,7,322,162,144,29,4793
412,412,0,362,50,1994,0,343500,403,9,97.82,2.18,309,38,56,0,0,0,32,0,11,0,0,89,85,137,49,4794
310,274,36,268,6,1988,0,435000,304,6,98.06,1.94,81,155,56,10,9,0,17,9,0,0,0,18,50,86,131,4795
292,269,23,255,14,1982,0,417300,234,58,80.14,19.86,151,15,91,0,119,0,54,15,0,0,0,73,66,35,133,4796
371,371,0,312,59,1979,0,340400,319,52,85.98,14.02,172,97,116,14,27,0,0,0,14,0,11,70,138,104,81,4797
716,422,294,324,98,1987,1620,309300,689,27,96.23,3.77,154,60,129,65,193,0,0,8,0,0,12,73,154,69,157,4798
685,578,107,443,135,1982,1008,371100,617,68,90.07,9.93,150,88,176,36,52,0,43,77,11,0,10,82,125,45,83,4799
254,254,0,171,83,1960,1573,296900,209,45,82.28,17.72,25,13,14,35,186,0,0,0,20,10,0,19,102,91,0,4800
1525,1273,252,753,520,1998,1157,235800,767,758,50.30,49.70,843,67,66,44,150,25,268,129,0,0,9,209,374,28,62,4801
1023,973,50,964,9,1993,0,723000,1006,17,98.34,1.66,363,122,149,41,66,0,0,30,0,17,0,0,16,55,588,4802
1240,1148,92,1130,18,2002,0,220700,1240,0,100.00,0.00,512,43,141,0,0,0,0,0,20,0,12,497,108,15,0,4803
659,641,18,287,354,2003,1011,253600,524,135,79.51,20.49,384,150,35,13,64,94,34,53,67,0,12,140,143,12,0,4804
882,882,0,818,64,1994,1809,263700,746,136,84.58,15.42,693,145,107,16,82,28,26,37,97,31,80,130,408,90,23,4805
542,476,66,376,100,1994,871,284400,349,193,64.39,35.61,470,73,64,10,16,0,81,46,9,0,55,86,169,56,87,4806
406,406,0,302,104,1981,984,169200,374,32,92.12,7.88,97,0,52,62,178,0,43,25,29,0,0,121,101,0,0,4807
424,424,0,394,30,1959,0,343100,424,0,100.00,0.00,0,145,72,87,219,0,54,0,15,0,0,17,184,168,65,4808
522,522,0,400,122,1994,1588,297100,480,42,91.95,8.05,376,106,15,37,45,0,0,30,48,0,36,36,249,102,56,4809
444,395,49,395,0,1985,0,283400,444,0,100.00,0.00,151,269,15,0,0,0,28,11,0,0,8,34,149,78,97,4810
637,637,0,39,598,1979,902,205700,87,550,13.66,86.34,203,202,157,103,23,83,527,21,0,0,0,23,0,0,0,4811
626,556,70,233,323,1974,853,143900,327,299,52.24,47.76,155,78,113,40,195,0,212,29,0,0,61,91,112,0,24,4812
314,226,88,162,64,1954,840,127100,248,66,78.98,21.02,51,26,65,21,151,3,29,9,0,0,128,52,30,0,5,4813
486,425,61,253,172,1974,568,119500,259,227,53.29,46.71,84,14,49,130,196,0,99,47,0,0,77,206,0,0,8,4814
358,358,0,146,212,1960,979,104900,197,161,55.03,44.97,126,0,38,0,106,0,61,0,0,0,47,58,66,0,0,4815
547,514,33,474,40,2008,1917,296200,508,39,92.87,7.13,333,75,30,0,0,0,29,26,0,0,0,44,243,49,21,4816
585,585,0,229,356,1990,897,155400,208,377,35.56,64.44,459,125,129,0,49,0,445,45,0,0,71,74,9,0,0,4817
342,342,0,238,104,1982,1439,366000,268,74,78.36,21.64,30,192,64,35,67,0,79,27,17,0,0,30,103,57,36,4818
588,588,0,556,32,1972,0,218800,538,50,91.50,8.50,80,28,143,36,216,12,44,49,13,0,11,176,183,0,15,4819
815,717,98,626,91,1972,1216,277200,659,156,80.86,19.14,66,24,390,210,27,0,8,28,30,0,8,83,397,75,22,4820
548,448,100,188,260,2003,1411,337500,75,473,13.69,86.31,345,32,20,17,109,0,59,109,44,8,31,28,25,15,44,4821
656,607,49,192,415,1977,784,185300,255,401,38.87,61.13,8,77,212,131,40,0,235,28,0,0,0,56,103,0,0,4822
417,417,0,367,50,1968,2519,435500,410,7,98.32,1.68,37,49,107,161,23,0,0,11,0,0,9,17,63,82,165,4823
371,366,5,328,38,1979,0,307300,362,9,97.57,2.43,104,19,141,91,76,4,9,0,37,0,5,36,197,23,112,4824
1132,1060,72,1005,55,1992,1441,336400,1109,23,97.97,2.03,520,202,234,76,74,0,10,74,11,11,19,198,377,129,253,4825
333,299,34,190,109,1966,950,128100,278,55,83.48,16.52,64,40,88,20,144,18,52,12,0,0,9,151,9,48,41,4826
892,820,72,708,112,1984,914,189200,561,331,62.89,37.11,402,154,182,62,130,23,15,82,0,0,121,249,199,58,8,4827
852,811,41,614,197,1987,1663,414900,833,19,97.77,2.23,396,89,168,81,129,0,30,37,0,27,0,33,94,116,295,4828
229,229,0,208,21,1951,0,206800,229,0,100.00,0.00,48,0,10,34,254,0,13,18,34,0,0,95,112,0,40,4829
358,358,0,149,209,1976,1114,256300,250,108,69.83,30.17,61,24,157,123,28,0,70,12,0,0,6,64,182,15,0,4830
394,379,15,331,48,1989,0,251900,283,111,71.83,28.17,253,117,74,48,97,0,52,0,0,0,79,93,254,7,74,4831
360,348,12,315,33,1988,0,219000,280,80,77.78,22.22,137,57,33,9,42,0,0,9,0,0,0,52,95,22,17,4832
739,708,31,347,361,1992,956,204500,371,368,50.20,49.80,448,67,23,83,110,12,131,74,9,63,10,127,212,27,0,4833
536,514,22,459,55,1990,2074,327500,391,145,72.95,27.05,358,43,34,124,91,0,99,0,11,0,0,73,235,32,122,4834
159,120,39,77,43,1969,0,163800,134,25,84.28,15.72,23,29,70,4,136,7,30,7,0,0,56,34,46,2,12,4835
675,338,337,178,160,1978,875,267600,478,197,70.81,29.19,98,72,59,4,327,69,47,13,0,0,62,51,54,0,22,4836
1023,915,108,754,161,1992,0,203500,513,510,50.15,49.85,411,160,256,35,68,0,99,0,0,0,152,442,94,15,81,4837
550,492,58,311,181,1967,672,168600,383,167,69.64,30.36,40,27,34,43,428,55,39,12,0,0,96,216,72,13,0,4838
404,368,36,329,39,1985,1044,225700,349,55,86.39,13.61,43,69,136,6,71,0,74,42,0,0,45,107,24,11,22,4839
680,597,83,309,288,1995,931,145500,185,495,27.21,72.79,252,193,63,0,59,30,140,11,0,0,184,57,68,19,6,4840
329,329,0,276,53,1970,0,300800,329,0,100.00,0.00,116,0,159,130,97,0,58,0,0,0,0,213,208,11,12,4841
335,335,0,203,132,1953,657,99300,189,146,56.42,43.58,56,23,39,87,238,29,152,12,0,0,182,68,0,0,0,4842
741,727,14,333,394,1978,1184,272900,333,408,44.94,55.06,254,144,297,121,0,0,195,110,15,0,65,83,152,38,11,4843
543,476,67,81,395,1993,935,142400,70,473,12.89,87.11,282,103,135,49,46,0,424,14,0,43,0,59,12,0,0,4844
540,527,13,380,147,1972,826,356700,430,110,79.63,20.37,166,59,119,59,203,0,141,0,0,0,0,25,173,108,112,4845
888,888,0,725,163,2001,1456,243400,888,0,100.00,0.00,756,76,21,0,0,0,0,0,50,0,18,211,563,11,0,4846
885,412,473,351,61,1971,827,238500,785,100,88.70,11.30,134,133,82,71,371,40,45,28,0,0,35,129,58,8,58,4847
696,618,78,501,117,1983,1273,271800,477,219,68.53,31.47,220,114,178,75,52,13,85,20,0,0,50,119,78,74,90,4848
691,596,95,233,363,1975,848,143000,177,514,25.62,74.38,73,257,153,91,45,90,84,0,0,45,34,209,121,0,0,4849
404,404,0,0,404,1970,772,0,44,360,10.89,89.11,45,40,176,149,0,129,222,12,0,15,0,0,0,0,0,4850
575,468,107,291,177,1989,770,229900,397,178,69.04,30.96,204,87,92,14,166,34,106,25,0,0,24,171,116,25,24,4851
394,355,39,237,118,1958,616,138000,275,119,69.80,30.20,39,9,185,132,97,0,225,0,0,0,39,80,36,0,15,4852
408,408,0,228,180,1986,878,151700,85,323,20.83,79.17,143,141,88,0,30,0,18,14,34,93,40,69,27,19,0,4853
460,460,0,416,44,1969,1725,348300,460,0,100.00,0.00,22,0,263,223,16,0,0,13,12,0,0,14,250,225,10,4854
591,136,455,128,8,1977,0,190000,521,70,88.16,11.84,216,54,125,147,38,0,0,0,0,0,0,53,30,7,40,4855
730,720,10,607,113,1999,1972,353800,698,32,95.62,4.38,379,88,66,16,59,0,52,0,14,14,0,25,189,154,127,4856
350,350,0,28,322,1986,1293,0,53,297,15.14,84.86,202,26,92,41,124,13,201,28,125,81,0,0,0,0,0,4857
823,774,49,536,238,1987,1110,220600,650,173,78.98,21.02,142,26,93,23,238,30,81,26,13,0,0,99,94,61,87,4858
1099,967,132,111,856,2002,1122,161900,104,995,9.46,90.54,360,269,56,23,0,33,131,204,0,42,0,172,0,57,0,4859
519,460,59,362,98,1994,1406,317200,458,61,88.25,11.75,304,59,69,48,21,0,0,21,0,25,0,15,157,194,89,4860
784,691,93,458,233,1998,976,175700,622,162,79.34,20.66,370,135,99,38,67,0,38,14,34,0,47,347,64,39,0,4861
491,464,27,264,200,1962,1511,241300,406,85,82.69,17.31,86,17,59,40,282,25,90,115,45,0,15,70,73,13,0,4862
614,614,0,523,91,1974,1106,231700,564,50,91.86,8.14,162,56,127,65,195,0,69,11,0,0,48,174,230,30,29,4863
291,269,22,244,25,1998,0,486000,247,44,84.88,15.12,280,32,57,10,10,0,9,50,10,0,11,71,10,43,175,4864
682,682,0,271,411,1976,1003,292200,336,346,49.27,50.73,76,150,316,186,14,0,187,62,0,0,0,25,172,111,52,4865
713,626,87,307,319,1952,1318,699000,349,364,48.95,51.05,69,64,14,54,316,0,47,105,38,16,0,11,0,16,284,4866
594,594,0,513,81,2000,2312,609800,594,0,100.00,0.00,493,121,25,0,0,0,0,0,0,13,0,0,39,179,408,4867
571,562,9,265,297,1960,537,115600,368,203,64.45,35.55,41,32,152,11,287,23,106,18,7,0,147,143,10,0,0,4868
1101,1051,50,203,848,1991,1005,368000,245,856,22.25,77.75,188,73,283,57,182,250,196,118,48,0,0,36,60,23,9,4869
514,415,99,398,17,1989,0,379000,514,0,100.00,0.00,187,91,121,10,39,0,0,0,9,0,0,145,126,38,130,4870
669,551,118,525,26,1985,0,304700,475,194,71.00,29.00,112,163,129,34,44,0,16,99,0,0,15,130,110,15,46,4871
543,352,191,239,113,1990,0,226000,269,274,49.54,50.46,347,195,118,30,82,0,41,0,0,0,83,217,120,37,22,4872
321,295,26,185,110,1939,633,148400,207,114,64.49,35.51,0,0,34,74,270,61,68,17,22,0,0,83,34,36,7,4873
455,455,0,332,123,1991,1131,235200,339,116,74.51,25.49,288,135,37,6,41,6,101,18,0,0,15,195,79,33,30,4874
871,871,0,653,218,1979,988,254300,569,302,65.33,34.67,266,88,181,13,106,34,115,32,0,0,64,227,119,0,19,4875
694,658,36,164,494,1975,1094,0,117,577,16.86,83.14,113,94,246,130,39,53,172,106,29,0,18,137,78,0,0,4876
416,385,31,243,142,1958,1318,370400,384,32,92.31,7.69,71,57,13,59,188,0,43,15,43,0,14,0,67,118,88,4877
699,650,49,514,136,1990,1250,150600,479,220,68.53,31.47,309,245,152,7,9,34,45,35,28,0,212,167,152,10,13,4878
1196,902,294,782,120,1988,884,250700,950,246,79.43,20.57,383,223,319,46,157,15,77,53,0,0,117,240,286,63,83,4879
623,572,51,34,538,1976,850,122400,95,528,15.25,84.75,52,138,219,66,140,34,382,27,0,0,0,42,31,0,22,4880
516,458,58,343,115,1983,1104,258900,406,110,78.68,21.32,114,43,20,28,124,0,10,22,17,0,10,41,141,65,23,4881
286,261,25,107,154,1958,864,137500,204,82,71.33,28.67,27,0,72,25,225,15,56,14,0,0,65,140,0,0,0,4882
528,454,74,379,75,1985,1321,347800,467,61,88.45,11.55,269,101,82,0,203,16,93,12,16,0,0,45,108,57,171,4883
312,279,33,178,101,1975,0,282800,269,43,86.22,13.78,111,33,56,21,61,0,52,19,7,0,28,7,53,32,56,4884
915,838,77,508,330,1984,1066,268500,823,92,89.95,10.05,417,99,63,85,244,62,119,122,0,0,0,213,151,32,125,4885
869,799,70,623,176,1990,1350,264700,614,255,70.66,29.34,409,195,35,112,56,33,69,58,0,0,169,162,58,75,103,4886
774,718,56,619,99,1995,1059,357100,640,134,82.69,17.31,239,82,103,19,152,0,31,0,0,0,77,59,141,60,118,4887
398,377,21,28,349,2006,284,187500,187,211,46.98,53.02,96,0,6,21,95,141,33,8,8,0,3,0,0,0,0,4888
440,440,0,306,134,1963,1279,385500,343,97,77.95,22.05,18,52,63,46,259,8,44,45,15,33,13,14,47,135,75,4889
265,265,0,113,152,1978,1302,197600,265,0,100.00,0.00,50,0,94,46,34,19,20,26,0,0,0,59,47,22,10,4890
827,773,54,647,126,1977,1041,30700,369,458,44.62,55.38,217,152,136,22,286,0,111,76,0,0,206,270,63,27,0,4891
801,712,89,425,287,1987,880,198200,450,351,56.18,43.82,343,37,60,110,275,0,195,77,0,0,119,185,169,61,8,4892
431,431,0,349,82,1987,1358,271300,345,86,80.05,19.95,100,96,12,87,97,10,11,35,0,0,23,57,109,53,59,4893
883,846,37,339,507,1980,860,215400,447,436,50.62,49.38,158,204,448,44,103,78,388,100,21,0,0,218,139,13,0,4894
410,410,0,307,103,1956,1073,322500,335,75,81.71,18.29,40,45,59,81,217,0,0,9,70,5,0,26,177,118,37,4895
838,838,0,637,201,1993,1750,474300,686,152,81.86,18.14,754,68,0,11,14,0,0,40,89,90,47,15,77,306,183,4896
602,554,48,437,117,1958,882,162300,471,131,78.24,21.76,13,56,70,26,405,0,111,0,0,0,34,425,0,0,0,4897
799,799,0,355,444,1976,1187,249600,381,418,47.68,52.32,58,301,92,114,242,0,134,132,9,0,0,235,213,84,0,4898
896,820,76,592,228,1982,757,172200,653,243,72.88,27.12,197,134,148,70,277,50,103,8,0,10,124,253,106,36,27,4899
528,528,0,434,94,1977,1094,428400,488,40,92.42,7.58,85,61,143,10,100,0,12,0,0,0,15,17,113,52,176,4900
530,452,78,219,233,1978,913,165000,295,235,55.66,44.34,197,48,97,28,159,0,105,9,0,0,88,161,116,0,33,4901
499,459,40,436,23,1997,0,376700,446,53,89.38,10.62,312,121,39,11,37,0,0,11,0,0,0,70,143,117,169,4902
340,340,0,340,0,1973,0,234000,327,13,96.18,3.82,182,0,149,65,134,13,68,0,0,0,75,252,65,17,0,4903
418,387,31,299,88,1993,1286,199000,418,0,100.00,0.00,286,38,21,65,23,0,15,17,9,0,0,271,102,0,0,4904
439,439,0,344,95,1987,892,261600,360,79,82.00,18.00,204,70,66,16,72,0,20,13,0,0,97,113,79,61,0,4905
271,271,0,108,163,1988,915,189600,61,210,22.51,77.49,143,96,43,0,14,26,169,38,0,0,0,22,4,0,0,4906
526,504,22,379,125,1986,515,106800,245,281,46.58,53.42,226,50,131,19,137,29,114,0,0,0,190,125,31,0,0,4907
1650,1467,183,1308,159,2002,1603,209600,1382,268,83.76,16.24,1479,74,26,0,0,0,12,43,200,11,36,422,705,0,0,4908
235,212,23,152,60,1979,361,197200,125,110,53.19,46.81,15,69,237,0,9,122,81,23,0,0,24,59,12,0,0,4909
353,347,6,259,88,1946,698,119800,344,9,97.45,2.55,0,0,10,8,237,22,72,0,0,0,66,81,0,0,0,4910
765,705,60,243,462,1980,1172,329100,326,439,42.61,57.39,89,176,230,447,12,31,484,235,0,0,0,8,53,26,35,4911
1997,1809,188,1403,406,1999,1360,244300,1712,285,85.73,14.27,1421,118,77,110,32,0,61,161,87,0,41,608,422,201,91,4912
353,327,26,73,254,1954,722,139100,209,144,59.21,40.79,75,7,0,50,277,42,129,29,0,0,25,162,15,0,7,4913
399,399,0,325,74,1978,1690,277300,350,49,87.72,12.28,103,105,94,56,46,0,0,20,65,0,0,23,235,30,23,4914
456,430,26,145,285,1969,887,228100,204,252,44.74,55.26,15,8,111,153,85,0,156,31,0,0,0,27,77,6,0,4915
1239,1202,37,47,1155,1997,1297,158000,180,1059,14.53,85.47,564,60,124,58,273,115,334,210,111,63,12,16,53,12,0,4916
483,483,0,210,273,1980,1227,174200,278,205,57.56,42.44,57,120,73,171,39,0,79,170,0,11,29,55,45,0,0,4917
650,564,86,454,110,1978,832,243600,498,152,76.62,23.38,206,121,150,41,128,6,37,2,0,0,36,233,121,44,74,4918
809,741,68,601,140,2004,1602,238300,809,0,100.00,0.00,517,37,0,0,88,0,0,0,35,0,10,247,277,7,0,4919
534,439,95,42,397,1995,1068,236400,50,484,9.36,90.64,136,0,38,71,265,101,86,104,31,18,22,6,20,0,0,4920
867,849,18,735,114,1977,1022,186400,703,164,81.08,18.92,512,93,145,52,187,23,23,0,0,0,102,482,215,13,37,4921
554,554,0,260,294,1991,950,171800,186,368,33.57,66.43,360,218,0,13,11,22,124,118,16,0,0,216,18,0,13,4922
511,463,48,391,72,1974,1438,199700,390,121,76.32,23.68,135,65,99,47,105,0,84,37,0,0,3,148,103,8,46,4923
620,515,105,231,284,1949,872,120400,589,31,95.00,5.00,0,18,37,61,377,14,66,9,15,0,37,323,0,0,10,4924
1597,1330,267,884,446,1979,946,133500,1012,585,63.37,36.63,487,138,408,216,68,31,350,49,0,0,207,264,76,59,58,4925
400,328,72,216,112,1979,467,89200,286,114,71.50,28.50,92,36,115,70,78,52,38,0,8,0,135,43,11,10,1,4926
774,638,136,486,152,1983,915,282800,524,250,67.70,32.30,442,130,110,55,65,0,19,85,29,0,0,279,143,137,110,4927
847,779,68,264,515,1991,1025,146900,262,585,30.93,69.07,584,162,44,71,31,41,328,121,0,0,0,196,42,15,0,4928
563,548,15,355,193,1971,1410,328800,513,50,91.12,8.88,97,36,32,7,350,0,21,42,0,0,0,60,253,54,18,4929
414,372,42,263,109,1991,0,615900,371,43,89.61,10.39,67,0,46,57,116,0,0,0,0,0,0,13,0,17,256,4930
335,284,51,251,33,1978,0,237000,300,35,89.55,10.45,105,81,108,9,30,3,0,8,0,0,18,167,92,10,26,4931
382,326,56,79,247,1939,1014,149400,242,140,63.35,36.65,27,11,85,32,212,52,150,0,0,0,0,122,13,0,0,4932
512,416,96,313,103,1952,788,142500,424,88,82.81,17.19,92,52,43,23,303,10,31,8,0,0,141,134,46,3,8,4933
1199,1069,130,551,518,1993,667,157900,616,583,51.38,48.62,344,106,198,125,157,37,200,43,0,0,67,462,13,0,29,4934
487,392,95,304,88,1948,686,96000,431,56,88.50,11.50,15,10,95,32,424,23,74,0,0,0,216,142,12,0,0,4935
834,820,14,703,117,1986,701,370700,663,171,79.50,20.50,311,203,100,48,98,0,0,70,0,0,0,44,139,200,273,4936
472,427,45,320,107,1987,1048,355200,411,61,87.08,12.92,249,31,71,13,18,0,37,0,0,0,10,35,118,112,70,4937
660,594,66,446,148,1943,1526,442000,614,46,93.03,6.97,50,33,0,0,553,0,19,17,38,7,7,0,75,65,343,4938
864,864,0,686,178,1998,1758,311900,864,0,100.00,0.00,560,183,88,0,19,0,0,27,20,0,9,102,410,186,45,4939
701,679,22,420,259,1970,747,119200,457,244,65.19,34.81,169,102,146,68,284,0,147,0,0,0,259,277,45,0,0,4940
345,345,0,206,139,1993,673,183600,315,30,91.30,8.70,236,75,58,0,0,0,0,12,57,0,0,259,30,11,0,4941
754,684,70,317,367,1994,1452,341700,544,210,72.15,27.85,296,78,169,24,22,0,43,33,18,0,0,38,237,80,130,4942
717,561,156,429,132,1986,1231,448300,685,32,95.54,4.46,230,159,198,26,69,3,37,36,7,0,12,52,143,41,232,4943
674,650,24,426,224,1991,926,177800,493,181,73.15,26.85,465,51,47,87,90,35,15,139,11,0,119,208,158,30,0,4944
356,293,63,222,71,1964,0,131800,264,92,74.16,25.84,48,27,36,62,170,0,44,32,0,19,12,192,25,0,0,4945
1112,993,119,232,761,1977,1330,478700,314,798,28.24,71.76,355,145,392,165,55,36,175,518,0,26,0,19,107,62,64,4946
568,521,47,400,121,1986,1259,344700,504,64,88.73,11.27,198,122,69,15,68,0,74,0,0,0,14,0,168,99,55,4947
433,386,47,169,217,1943,763,138800,376,57,86.84,13.16,47,18,47,14,199,54,13,25,0,7,73,123,0,0,8,4948
667,552,115,174,378,1989,862,122900,62,605,9.30,90.70,91,262,181,51,0,23,271,91,0,0,0,120,0,0,0,4949
577,577,0,141,436,1939,669,186500,186,391,32.24,67.76,48,10,202,28,498,227,269,37,0,0,29,107,40,10,0,4950
334,267,67,172,95,1962,1026,163400,211,123,63.17,36.83,9,54,48,50,195,32,86,74,0,0,9,133,0,0,0,4951
457,258,199,166,92,1956,444,169500,235,222,51.42,48.58,70,39,52,41,128,0,88,0,0,0,0,92,22,19,0,4952
762,640,122,344,296,1956,620,114800,562,200,73.75,26.25,106,11,99,143,409,17,346,0,0,0,135,158,0,0,0,4953
926,890,36,561,329,1987,1328,173100,790,136,85.31,14.69,619,44,57,11,106,10,81,39,5,0,163,183,208,9,113,4954
1226,996,230,70,926,1970,689,137500,184,1042,15.01,84.99,80,167,343,369,88,162,652,8,0,0,31,42,4,0,0,4955
562,322,240,289,33,1991,0,119200,347,215,61.74,38.26,219,40,107,58,55,0,0,35,0,0,72,82,114,16,0,4956
621,577,44,263,314,1962,1147,483800,334,287,53.78,46.22,128,25,25,55,350,0,158,62,36,0,0,15,89,135,88,4957
539,309,230,259,50,1980,777,188800,445,94,82.56,17.44,103,112,38,51,138,35,66,6,0,0,26,122,110,12,9,4958
604,504,100,297,207,1973,471,200800,392,212,64.90,35.10,98,127,117,140,207,84,58,25,0,0,106,139,111,0,24,4959
561,561,0,232,329,1958,958,222800,359,202,63.99,36.01,51,115,102,41,281,28,175,205,0,0,0,80,0,0,0,4960
1024,924,100,675,249,1992,1822,313700,1009,15,98.54,1.46,502,125,277,0,25,0,0,0,27,14,0,43,569,159,98,4961
389,362,27,254,108,1987,1438,190200,389,0,100.00,0.00,102,0,67,43,99,25,36,26,11,0,0,162,18,0,0,4962
313,268,45,170,98,1939,0,237200,190,123,60.70,39.30,6,0,12,0,211,16,19,12,17,0,0,15,97,50,3,4963
580,580,0,336,244,1958,1380,233000,494,86,85.17,14.83,30,9,38,118,402,0,25,26,6,0,68,192,245,0,0,4964
501,456,45,398,58,1975,679,143200,420,81,83.83,16.17,98,60,90,17,208,2,49,0,0,0,102,236,42,17,20,4965
577,569,8,505,64,1993,838,253400,465,112,80.59,19.41,142,109,53,18,202,0,0,23,0,0,40,222,152,30,10,4966
432,372,60,337,35,1987,0,143100,201,231,46.53,53.47,56,80,52,23,188,66,70,0,0,0,17,149,59,20,9,4967
248,207,41,118,89,1941,877,125000,215,33,86.69,13.31,23,10,24,35,223,25,22,9,0,0,80,129,12,0,5,4968
435,414,21,287,127,1982,1146,267300,413,22,94.94,5.06,138,63,81,69,243,0,15,113,0,0,14,173,151,29,8,4969
496,483,13,483,0,1999,0,377500,483,13,97.38,2.62,364,12,0,0,0,0,0,0,11,0,0,10,157,121,77,4970
616,616,0,407,209,1957,1232,595900,495,121,80.36,19.64,172,145,0,33,325,11,24,69,90,36,0,13,83,58,242,4971
74,74,0,28,46,1973,0,0,74,0,100.00,0.00,42,11,11,31,66,0,52,11,11,0,0,23,0,0,0,4972
366,366,0,277,89,1978,1102,199300,92,274,25.14,74.86,84,133,170,0,56,10,78,0,0,0,112,157,39,0,0,4973
485,458,27,437,21,1987,0,356000,479,6,98.76,1.24,149,40,163,55,28,0,0,10,0,0,22,64,85,151,103,4974
374,374,0,353,21,1974,0,300300,374,0,100.00,0.00,0,25,164,135,0,0,0,0,0,0,0,16,259,35,0,4975
631,572,59,309,263,1944,894,121400,566,65,89.70,10.30,0,6,39,59,531,0,171,61,0,0,55,252,26,0,0,4976
318,318,0,101,217,1967,590,110400,186,132,58.49,41.51,21,0,54,14,344,104,133,26,0,0,19,69,22,0,0,4977
1123,856,267,245,611,1989,668,670600,15,1108,1.34,98.66,272,258,63,0,443,417,165,175,12,66,0,16,66,27,65,4978
797,622,175,63,559,1991,940,167100,203,594,25.47,74.53,168,15,101,33,160,61,288,28,0,0,0,61,39,0,0,4979
581,581,0,446,135,1965,761,50200,220,361,37.87,62.13,132,15,86,289,192,16,89,0,50,0,272,144,70,0,30,4980
921,748,173,466,282,1951,1049,184100,781,140,84.80,15.20,76,38,190,104,534,89,236,72,0,0,33,191,152,26,0,4981
564,564,0,498,66,1984,983,338300,488,76,86.52,13.48,193,148,178,37,145,0,0,19,0,0,28,160,145,86,202,4982
541,533,8,449,84,1943,1080,327300,541,0,100.00,0.00,0,0,72,33,518,0,14,34,45,0,0,0,414,104,12,4983
665,561,104,386,175,1990,1072,331600,579,86,87.07,12.93,222,214,185,13,177,0,55,51,34,0,0,122,195,105,116,4984
452,403,49,403,0,1985,0,236300,452,0,100.00,0.00,86,172,75,0,21,0,0,11,0,0,0,92,213,10,0,4985
548,500,48,349,151,1977,1239,265800,459,89,83.76,16.24,221,33,47,47,130,0,77,0,40,0,23,114,148,6,57,4986
577,569,8,514,55,1971,979,285200,562,15,97.40,2.60,174,71,192,106,92,0,106,23,15,5,13,123,211,50,58,4987
809,676,133,475,201,1977,1634,181800,430,379,53.15,46.85,192,115,197,122,185,14,43,44,82,45,69,252,198,0,39,4988
668,644,24,424,220,1996,1666,428700,619,49,92.66,7.34,375,197,13,10,17,0,36,37,0,0,24,55,139,161,147,4989
749,749,0,120,629,1978,611,120200,147,602,19.63,80.37,290,161,205,131,14,104,428,11,0,0,34,98,10,0,0,4990
787,739,48,709,30,1991,0,302200,617,170,78.40,21.60,388,158,115,29,30,0,14,0,13,0,41,130,154,97,141,4991
881,789,92,254,535,1966,1315,496400,341,540,38.71,61.29,110,137,229,90,311,11,305,176,0,10,0,20,119,26,210,4992
729,627,102,547,80,1981,1670,339800,673,56,92.32,7.68,189,238,173,27,70,0,0,11,37,26,0,253,281,35,54,4993
701,540,161,259,281,1939,530,111800,537,164,76.60,23.40,18,31,31,14,401,22,115,15,46,0,43,210,13,0,0,4994
831,831,0,698,133,1993,0,167400,799,32,96.15,3.85,532,0,143,61,57,0,0,104,0,0,0,377,223,73,0,4995
561,523,38,390,133,1975,726,158900,443,118,78.97,21.03,68,66,59,29,162,0,70,57,0,0,17,208,14,0,18,4996
553,536,17,208,328,1970,765,182100,233,320,42.13,57.87,80,78,242,39,114,76,173,54,0,0,0,148,39,0,11,4997
581,514,67,383,131,1956,869,200700,555,26,95.52,4.48,140,18,92,156,325,46,112,0,0,13,63,360,105,0,0,4998
1272,1162,110,332,830,2000,678,254100,428,844,33.65,66.35,561,25,223,141,193,72,494,44,0,0,21,82,151,110,52,4999
417,387,30,338,49,1994,1094,241800,363,54,87.05,12.95,224,42,22,42,18,37,0,12,33,0,9,75,110,14,20,5000
551,510,41,286,224,1968,1431,158100,551,0,100.00,0.00,98,28,80,0,330,33,64,52,0,0,0,295,39,0,0,5001
429,429,0,314,115,1976,1038,181300,275,154,64.10,35.90,90,122,127,47,40,0,80,39,0,0,64,151,92,0,0,5002
549,524,25,428,96,1992,1694,169900,549,0,100.00,0.00,357,35,41,87,0,0,9,28,22,0,0,358,103,0,0,5003
440,440,0,364,76,1985,1409,359300,324,116,73.64,26.36,163,139,61,10,84,26,0,0,0,10,10,41,139,92,65,5004
741,682,59,501,181,1975,1115,229000,635,106,85.70,14.30,166,80,206,10,143,36,61,12,0,0,23,173,96,29,112,5005
812,812,0,357,455,1979,869,321000,431,381,53.08,46.92,138,224,281,26,332,130,232,142,47,0,0,96,187,40,39,5006
467,467,0,308,159,1980,447,0,92,375,19.70,80.30,94,63,306,38,9,174,31,23,16,0,88,78,39,0,9,5007
567,567,0,223,344,1995,1573,680000,267,300,47.09,52.91,407,71,30,9,14,0,9,211,111,0,29,0,0,46,98,5008
692,610,82,273,337,1942,1497,688800,471,221,68.06,31.94,31,82,42,50,289,0,34,39,20,0,0,0,33,42,312,5009
476,467,9,451,16,1959,0,350000,467,9,98.11,1.89,23,18,0,160,239,0,0,0,0,0,0,33,224,78,19,5010
745,730,15,611,119,1983,1152,443400,555,190,74.50,25.50,113,317,87,0,27,0,70,27,0,0,0,90,129,106,122,5011
616,590,26,329,261,1944,1908,510000,500,116,81.17,18.83,57,54,16,54,404,0,127,37,14,16,0,0,59,163,169,5012
433,378,55,279,99,1977,1341,424100,325,108,75.06,24.94,90,79,231,44,61,0,45,77,12,0,0,0,100,46,145,5013
418,347,71,253,94,1982,782,123500,228,190,54.55,45.45,45,12,90,36,99,0,0,0,0,0,102,141,0,0,0,5014
418,418,0,374,44,1970,1162,163900,418,0,100.00,0.00,12,81,295,102,18,0,0,50,0,0,26,415,8,0,0,5015
899,774,125,425,349,1939,1075,221000,761,138,84.65,15.35,28,24,0,29,616,26,69,34,0,0,76,291,103,5,49,5016
891,817,74,78,739,1987,963,181700,116,775,13.02,86.98,707,136,51,57,123,69,557,239,0,0,18,119,0,0,0,5017
684,592,92,535,57,1967,0,346600,662,22,96.78,3.22,243,67,47,27,190,0,21,15,0,0,0,61,123,94,150,5018
522,436,86,383,53,1987,0,247500,510,12,97.70,2.30,233,140,48,42,0,0,0,0,32,0,0,54,300,54,0,5019
451,423,28,335,88,1991,1182,154700,348,103,77.16,22.84,208,40,49,20,32,2,16,20,17,0,12,165,35,52,0,5020
590,590,0,360,230,1959,1127,181300,490,100,83.05,16.95,77,14,34,50,288,0,15,36,0,0,0,221,191,0,0,5021
601,315,286,216,99,1977,663,138600,389,212,64.73,35.27,51,129,57,80,180,0,28,0,0,0,65,134,43,15,9,5022
637,594,43,109,485,1965,819,256800,252,385,39.56,60.44,14,19,39,315,87,85,169,0,0,0,0,51,46,0,0,5023
1410,1328,82,514,814,2000,1316,283100,691,719,49.01,50.99,738,127,37,58,71,0,133,192,22,43,9,45,367,66,74,5024
457,457,0,353,104,1960,1400,233800,388,69,84.90,15.10,47,53,108,6,214,0,16,0,28,0,16,118,225,0,14,5025
438,286,152,245,41,1989,0,344600,377,61,86.07,13.93,138,37,56,28,87,6,10,22,0,0,37,81,54,25,33,5026
227,191,36,93,98,1958,900,207500,202,25,88.99,11.01,44,21,47,10,111,8,1,0,0,0,69,30,32,0,4,5027
1177,1133,44,186,947,2003,1488,311000,153,1024,13.00,87.00,902,0,0,0,0,17,68,405,270,15,0,0,17,57,0,5028
892,806,86,271,535,1980,633,143800,487,405,54.60,45.40,107,204,212,11,259,136,301,24,0,43,147,83,17,0,0,5029
738,692,46,614,78,1986,1568,425000,653,85,88.48,11.52,272,127,166,35,62,0,89,27,0,0,20,80,97,91,166,5030
552,552,0,466,86,1939,0,527400,516,36,93.48,6.52,84,8,42,30,485,0,43,30,32,0,0,18,172,128,226,5031
623,556,67,370,186,1966,1371,241300,488,135,78.33,21.67,235,47,87,83,177,0,23,85,20,0,20,119,287,27,17,5032
587,478,109,445,33,1977,0,263800,534,53,90.97,9.03,89,34,147,59,109,0,14,28,0,0,0,97,176,11,79,5033
961,833,128,352,481,1986,1053,220900,323,638,33.61,66.39,454,261,156,62,90,32,192,311,31,0,0,205,107,58,0,5034
479,440,39,370,70,1955,535,194700,361,118,75.37,24.63,82,0,78,168,235,0,0,43,42,0,14,166,271,0,0,5035
715,715,0,477,238,2002,1893,227500,631,84,88.25,11.75,665,26,7,0,0,0,0,13,55,0,7,101,351,44,7,5036
889,785,104,424,361,1975,899,173000,671,218,75.48,24.52,198,130,217,124,407,0,300,94,21,62,51,352,92,16,0,5037
627,578,49,312,266,1959,1063,272700,357,270,56.94,43.06,92,39,68,73,353,0,185,100,0,0,0,141,184,0,15,5038
525,525,0,262,263,1939,1449,780400,235,290,44.76,55.24,59,35,63,43,442,0,91,180,0,0,0,0,112,0,259,5039
388,357,31,243,114,1963,0,149700,273,115,70.36,29.64,63,58,88,34,146,14,0,0,0,0,39,90,137,54,9,5040
809,809,0,369,440,1994,1038,152800,462,347,57.11,42.89,340,36,36,167,15,124,116,56,0,0,21,178,77,0,0,5041
418,390,28,315,75,1968,1625,189000,418,0,100.00,0.00,7,65,94,205,50,0,0,78,43,0,0,234,66,0,0,5042
690,656,34,570,86,1985,1153,246500,651,39,94.35,5.65,275,143,383,69,11,0,11,0,0,0,59,266,231,136,109,5043
1205,1161,44,685,476,1991,1228,238800,940,265,78.01,21.99,435,181,313,0,36,0,186,145,0,0,11,263,267,0,0,5044
725,660,65,612,48,1965,0,216500,725,0,100.00,0.00,90,15,127,184,242,0,0,0,0,0,12,201,315,69,15,5045
235,207,28,132,75,1947,815,110400,206,29,87.66,12.34,64,18,60,6,155,0,7,0,0,0,65,175,8,0,0,5046
773,730,43,683,47,2001,1767,248000,773,0,100.00,0.00,788,45,0,0,0,0,0,44,9,0,10,200,372,115,83,5047
969,969,0,779,190,1990,938,287000,928,41,95.77,4.23,494,155,161,43,7,0,17,24,8,0,9,85,406,82,210,5048
2409,2233,176,1987,246,2003,1668,321700,2327,82,96.60,3.40,1330,102,190,54,107,51,83,0,51,0,28,418,674,213,180,5049
824,824,0,624,200,1991,1078,204000,625,199,75.85,24.15,564,23,142,110,43,0,122,100,20,0,11,169,373,34,0,5050
798,798,0,311,487,1982,1635,336300,142,656,17.79,82.21,22,417,257,0,31,0,38,195,75,9,0,76,117,56,113,5051
435,343,92,276,67,1972,755,143100,230,205,52.87,47.13,15,44,141,47,202,38,105,0,0,0,96,96,23,0,0,5052
728,695,33,695,0,1995,0,511700,721,7,99.04,0.96,543,56,80,18,80,0,0,6,0,0,0,12,80,89,534,5053
389,327,62,251,76,1951,736,110400,348,41,89.46,10.54,90,15,41,24,320,0,58,32,0,0,160,165,0,25,0,5054
228,228,0,167,61,1939,1523,184800,228,0,100.00,0.00,0,15,0,57,181,0,15,36,0,0,0,144,11,0,0,5055
315,315,0,292,23,1966,0,423900,315,0,100.00,0.00,10,11,101,272,17,0,0,0,0,0,16,16,73,246,60,5056
479,411,68,396,15,1967,2375,1585500,479,0,100.00,0.00,36,23,111,158,55,0,0,0,0,22,0,11,0,0,330,5057
922,784,138,250,534,1982,967,181300,92,830,9.98,90.02,102,242,179,305,72,0,431,50,0,0,15,217,83,0,18,5058
822,735,87,425,310,1946,800,179100,644,178,78.35,21.65,113,44,89,76,626,39,179,112,7,0,15,242,185,2,8,5059
331,290,41,180,110,1956,0,207100,331,0,100.00,0.00,0,0,35,30,236,0,15,10,35,0,5,63,88,21,0,5060
741,583,158,248,335,1990,2158,786700,211,530,28.48,71.52,386,166,144,92,29,0,26,97,115,190,0,23,8,42,206,5061
1408,1408,0,907,501,1998,1221,280600,1279,129,90.84,9.16,846,15,63,29,199,0,64,68,0,0,0,384,461,107,18,5062
649,619,30,512,107,1981,2016,501000,581,68,89.52,10.48,123,100,191,98,15,0,0,0,29,25,0,41,151,94,187,5063
1239,1176,63,415,761,1978,905,252900,477,762,38.50,61.50,482,163,395,124,174,30,748,19,0,41,16,100,76,72,73,5064
394,394,0,368,26,1977,2778,735900,394,0,100.00,0.00,43,150,202,32,0,0,0,0,0,13,0,0,0,19,395,5065
993,986,7,185,801,1986,1024,257100,242,751,24.37,75.63,232,440,81,9,40,0,252,242,28,0,59,48,90,10,0,5066
638,588,50,0,588,1985,1247,0,0,638,0.00,100.00,486,345,76,0,15,0,268,308,63,177,0,0,15,0,0,5067
193,142,51,66,76,1980,537,191700,94,99,48.70,51.30,124,10,18,24,16,0,21,0,0,0,22,76,8,4,37,5068
304,296,8,231,65,1984,1005,212700,272,32,89.47,10.53,103,14,131,85,0,40,41,14,0,0,0,75,96,17,23,5069
502,502,0,406,96,1989,878,258100,362,140,72.11,27.89,152,82,59,11,0,0,0,0,0,0,12,88,137,9,28,5070
667,630,37,598,32,1986,1375,364600,650,17,97.45,2.55,188,287,110,83,114,9,30,28,71,0,0,160,189,105,76,5071
486,432,54,261,171,1969,882,195800,307,179,63.17,36.83,84,33,96,141,24,27,42,13,0,0,18,110,104,23,0,5072
647,566,81,513,53,1976,1137,172200,394,253,60.90,39.10,202,60,195,86,105,19,0,0,0,0,134,257,78,0,11,5073
324,324,0,246,78,1993,0,821900,268,56,82.72,17.28,219,48,42,32,11,0,0,17,0,15,0,19,38,17,246,5074
576,540,36,4,536,1977,1555,0,339,237,58.85,41.15,198,7,114,42,53,0,24,176,121,0,0,0,0,0,0,5075
533,500,33,460,40,1995,0,242600,533,0,100.00,0.00,498,0,15,0,0,0,0,27,20,10,0,46,348,33,29,5076
513,492,21,243,249,1958,925,175400,377,136,73.49,26.51,52,108,92,0,340,21,168,135,0,0,0,206,34,0,0,5077
332,331,1,163,168,1982,1095,236300,312,20,93.98,6.02,55,23,31,0,15,0,0,0,0,0,13,44,39,6,18,5078
532,458,74,280,178,1978,693,191500,351,181,65.98,34.02,82,130,167,47,58,77,46,15,0,0,24,306,0,0,1,5079
799,752,47,135,617,1995,1142,219600,114,685,14.27,85.73,387,259,121,10,71,13,386,132,69,0,0,84,104,15,6,5080
810,768,42,177,591,1976,865,163300,314,496,38.77,61.23,152,164,171,127,166,95,212,55,35,0,7,210,6,0,22,5081
384,368,16,316,52,1958,1281,245200,384,0,100.00,0.00,28,0,51,11,201,0,0,14,70,0,17,48,52,44,0,5082
300,300,0,162,138,1977,1100,135900,257,43,85.67,14.33,101,8,85,106,15,0,80,66,0,0,9,93,67,0,0,5083
123,123,0,104,19,1995,0,198700,51,72,41.46,58.54,23,0,20,0,0,0,0,0,0,0,0,17,26,0,0,5084
577,577,0,441,136,2003,1565,263400,471,106,81.63,18.37,410,82,0,31,51,0,18,14,16,0,93,82,176,49,68,5085
656,656,0,625,31,2005,0,434700,656,0,100.00,0.00,395,26,0,0,0,0,0,0,0,10,0,0,125,76,166,5086
699,666,33,601,65,2000,1403,389900,699,0,100.00,0.00,364,42,42,43,37,0,11,0,13,0,16,83,196,123,71,5087
1272,1205,67,817,388,2001,1366,243000,848,424,66.67,33.33,789,0,23,12,22,0,12,33,0,14,13,181,506,14,12,5088
854,817,37,87,730,1990,905,117300,182,672,21.31,78.69,431,95,200,11,79,84,484,105,0,0,7,69,0,0,0,5089
697,625,72,502,123,1980,1104,241700,444,253,63.70,36.30,282,159,153,96,40,16,43,62,9,0,88,104,293,26,42,5090
681,598,83,478,120,1992,1154,312300,520,161,76.36,23.64,261,124,151,38,47,0,76,24,9,0,52,83,125,112,132,5091
544,502,42,310,192,1976,983,401400,167,377,30.70,69.30,205,126,154,86,54,0,144,11,38,16,0,104,151,34,112,5092
618,488,130,163,325,1996,1452,274600,424,194,68.61,31.39,194,0,155,123,16,13,25,100,13,0,12,19,251,28,27,5093
246,197,49,168,29,1979,1119,155600,165,81,67.07,32.93,59,0,12,69,75,0,58,0,0,0,18,63,0,0,17,5094
485,485,0,434,51,1973,726,234300,379,106,78.14,21.86,126,22,110,0,80,15,12,15,14,0,21,98,29,16,37,5095
1108,980,128,902,78,2001,1690,318200,1073,35,96.84,3.16,533,116,33,28,42,0,8,26,0,0,0,52,296,120,136,5096
385,296,89,206,90,1956,866,118400,318,67,82.60,17.40,22,0,41,0,240,6,73,0,0,0,26,101,22,0,0,5097
214,174,40,96,78,1972,499,116300,136,78,63.55,36.45,0,0,32,104,0,0,0,39,0,0,25,72,0,0,0,5098
792,752,40,36,716,1976,900,238900,164,628,20.71,79.29,63,161,141,159,59,115,328,10,0,0,0,19,10,0,0,5099
381,381,0,123,258,2000,1389,362300,139,242,36.48,63.52,453,27,59,12,10,29,138,186,12,25,0,9,66,35,61,5100
1665,1524,141,615,909,2001,834,197300,605,1060,36.34,63.66,577,137,233,30,195,53,423,13,7,0,107,291,112,20,80,5101
417,409,8,388,21,1985,0,572900,417,0,100.00,0.00,196,151,90,7,11,0,0,0,11,37,0,0,31,62,314,5102
657,657,0,555,102,1957,1009,171500,615,42,93.61,6.39,74,0,83,28,396,0,13,53,0,0,15,323,96,0,0,5103
402,402,0,371,31,1950,2225,569800,402,0,100.00,0.00,0,4,14,4,381,0,0,5,47,40,14,0,0,66,218,5104
729,729,0,55,674,1989,1085,0,144,585,19.75,80.25,296,190,73,0,14,13,264,163,0,0,0,76,0,0,0,5105
685,602,83,311,291,1960,796,144400,511,174,74.60,25.40,117,9,241,23,403,62,217,39,0,0,68,207,35,0,12,5106
228,228,0,202,26,1991,0,0,84,144,36.84,63.16,81,0,82,26,26,0,0,11,0,0,87,77,0,0,0,5107
541,504,37,298,206,1977,950,0,188,353,34.75,65.25,115,137,176,6,52,13,104,0,12,0,131,137,26,0,16,5108
502,477,25,393,84,1977,1133,342900,419,83,83.47,16.53,199,58,53,79,123,0,7,0,47,0,30,43,79,62,138,5109
1121,1083,38,634,449,1998,928,179800,427,694,38.09,61.91,846,440,112,0,0,38,257,192,42,24,297,181,205,25,22,5110
903,856,47,277,579,1984,942,252600,402,501,44.52,55.48,63,281,205,274,116,70,328,137,0,0,0,189,167,0,0,5111
369,321,48,255,66,1978,850,395500,261,108,70.73,29.27,88,49,32,14,100,13,0,20,0,0,10,45,86,49,60,5112
614,567,47,513,54,1985,1083,323300,569,45,92.67,7.33,184,278,65,49,0,0,0,33,0,14,0,83,350,59,37,5113
562,513,49,306,207,1976,1526,297200,462,100,82.21,17.79,16,206,177,52,11,0,121,17,9,33,16,10,218,38,0,5114
626,523,103,327,196,1939,646,103100,529,97,84.50,15.50,28,107,64,23,491,23,157,0,0,0,207,170,41,0,38,5115
965,777,188,412,365,1990,1084,525000,491,474,50.88,49.12,443,161,137,68,50,29,148,75,0,29,0,34,138,60,211,5116
614,493,121,284,209,1952,908,152400,480,134,78.18,21.82,208,27,65,41,229,29,171,0,8,0,50,183,30,19,0,5117
610,597,13,540,57,1988,1944,501800,601,9,98.52,1.48,250,286,89,0,0,0,0,9,0,31,0,0,75,107,346,5118
814,749,65,337,412,1980,1288,156300,520,294,63.88,36.12,262,25,394,78,46,35,104,271,0,0,43,285,32,0,0,5119
704,673,31,583,90,1993,1672,266500,627,77,89.06,10.94,411,166,92,31,110,33,90,8,16,10,43,171,330,39,70,5120
762,662,100,216,446,1993,1276,173000,149,613,19.55,80.45,245,293,116,8,20,0,272,134,28,0,74,72,49,33,20,5121
322,299,23,9,290,1966,988,0,174,148,54.04,45.96,0,0,57,72,218,0,135,65,6,0,0,113,17,11,0,5122
487,487,0,157,330,1939,794,347600,222,265,45.59,54.41,0,30,12,29,475,0,182,82,0,0,0,57,68,80,26,5123
331,279,52,226,53,1986,719,237500,241,90,72.81,27.19,118,36,93,16,85,14,33,21,10,0,57,89,44,23,0,5124
531,472,59,404,68,1971,0,123200,370,161,69.68,30.32,161,30,49,10,60,0,52,0,0,0,11,189,10,22,17,5125
409,409,0,339,70,1986,0,242000,409,0,100.00,0.00,142,126,60,136,10,0,6,0,22,0,0,216,179,10,0,5126
403,346,57,276,70,1953,1130,135200,403,0,100.00,0.00,38,10,104,0,290,0,64,10,0,0,60,288,0,0,0,5127
476,431,45,312,119,1964,625,153500,301,175,63.24,36.76,44,151,188,109,89,14,76,31,0,0,114,100,57,0,0,5128
779,695,84,52,643,1986,636,0,83,696,10.65,89.35,109,141,390,0,11,43,398,0,0,90,0,44,0,0,0,5129
356,356,0,318,38,1975,0,269800,356,0,100.00,0.00,67,90,81,146,37,0,0,11,0,0,0,78,265,22,45,5130
207,207,0,66,141,1944,779,104500,163,44,78.74,21.26,16,0,23,62,272,16,141,0,0,0,72,104,0,0,0,5131
981,601,380,474,127,1991,754,551900,923,58,94.09,5.91,314,160,182,34,165,17,67,4,0,0,0,62,65,50,157,5132
562,483,79,421,62,1990,968,378200,524,38,93.24,6.76,240,148,114,16,77,0,11,63,0,0,46,86,25,29,223,5133
403,239,164,191,48,1966,571,114900,333,70,82.63,17.37,37,45,97,39,158,6,30,3,0,0,86,97,16,4,12,5134
864,864,0,341,523,1998,1602,710800,457,407,52.89,47.11,788,14,35,42,0,0,10,235,137,16,0,45,86,46,143,5135
231,204,27,198,6,1978,0,383800,228,3,98.70,1.30,34,55,78,15,14,0,14,0,0,0,0,7,81,53,41,5136
789,706,83,157,549,1974,639,158800,169,620,21.42,78.58,180,112,174,33,256,156,304,19,16,25,16,112,15,0,0,5137
402,328,74,0,328,1939,566,0,8,394,1.99,98.01,42,0,135,12,297,116,270,19,0,0,0,0,0,0,0,5138
593,572,21,380,192,1939,1070,474800,462,131,77.91,22.09,30,13,20,37,455,0,20,0,22,36,9,47,85,204,102,5139
563,504,59,485,19,1973,0,526400,563,0,100.00,0.00,68,58,86,190,223,0,0,0,38,0,9,0,106,239,233,5140
404,404,0,229,175,1981,431,280900,268,136,66.34,33.66,86,81,139,49,98,105,18,0,14,0,0,44,162,24,59,5141
411,402,9,370,32,1994,0,286300,379,32,92.21,7.79,181,109,43,33,51,0,0,12,0,0,24,75,124,21,96,5142
335,300,35,180,120,1968,0,235900,295,40,88.06,11.94,12,57,164,127,48,24,44,17,0,0,0,179,55,0,43,5143
512,512,0,487,25,1975,0,472300,504,8,98.44,1.56,64,173,135,110,26,0,0,0,0,0,0,12,58,154,259,5144
737,684,53,450,234,1986,1391,196500,737,0,100.00,0.00,273,87,256,24,47,0,40,124,0,0,0,340,160,0,0,5145
704,595,109,393,202,1957,669,215100,615,89,87.36,12.64,86,60,59,0,342,0,106,0,0,0,88,153,112,0,12,5146
381,358,23,307,51,1976,960,328800,355,26,93.18,6.82,36,75,128,32,46,12,20,53,26,0,0,36,66,17,87,5147
508,508,0,366,142,1974,1233,230400,442,66,87.01,12.99,150,30,178,92,17,0,55,19,0,17,18,62,178,88,30,5148
522,497,25,258,239,1980,1248,227500,369,153,70.69,29.31,202,132,63,76,40,0,34,59,9,0,0,183,133,28,12,5149
241,201,40,131,70,1957,778,199600,139,102,57.68,42.32,40,0,101,83,178,0,150,107,0,0,0,60,27,0,0,5150
806,680,126,259,421,1967,1143,359200,349,457,43.30,56.70,164,95,41,71,209,15,153,29,29,0,0,48,209,55,42,5151
1290,1272,18,962,310,1995,690,270300,1038,252,80.47,19.53,1089,80,179,0,0,46,218,25,0,19,7,547,354,40,50,5152
735,593,142,558,35,1990,0,343300,687,48,93.47,6.53,435,146,60,122,34,0,15,0,68,32,16,38,313,147,168,5153
233,233,0,216,17,1975,0,169100,216,17,92.70,7.30,0,53,102,34,133,0,175,0,0,0,18,113,16,0,0,5154
447,398,49,267,131,1991,1608,596800,408,39,91.28,8.72,191,8,111,38,60,0,10,0,0,0,0,24,10,92,272,5155
509,430,79,104,326,1939,589,99400,218,291,42.83,57.17,92,0,16,15,412,73,104,20,0,0,57,25,9,0,44,5156
501,477,24,185,292,1957,885,225800,293,208,58.48,41.52,45,36,63,85,276,43,133,74,0,0,0,60,117,13,0,5157
937,892,45,678,214,1986,986,307600,773,164,82.50,17.50,442,22,85,64,112,0,30,11,22,0,12,146,126,185,106,5158
728,690,38,240,450,1982,893,157300,329,399,45.19,54.81,54,36,96,262,180,11,179,28,15,0,64,209,85,17,20,5159
1696,1515,181,980,535,1992,649,213100,1026,670,60.50,39.50,606,141,270,99,353,60,169,94,0,0,138,521,230,36,53,5160
409,399,10,149,250,1949,612,86500,186,223,45.48,54.52,0,58,73,34,343,179,136,18,0,0,65,63,0,0,0,5161
478,438,40,166,272,1939,994,372300,242,236,50.63,49.37,0,0,0,47,451,24,105,17,30,0,15,0,136,77,24,5162
639,388,251,314,74,1990,955,267400,502,137,78.56,21.44,107,39,54,107,65,0,0,0,0,0,50,120,53,0,32,5163
531,427,104,294,133,1971,758,218300,407,124,76.65,23.35,105,52,75,240,47,49,89,62,0,0,11,188,108,0,0,5164
301,301,0,228,73,1976,0,161400,243,58,80.73,19.27,86,21,209,32,53,65,68,12,0,0,25,217,14,0,0,5165
841,841,0,788,53,1997,1651,230100,841,0,100.00,0.00,535,36,68,95,91,0,64,19,0,0,27,266,298,122,0,5166
1189,1059,130,257,802,1994,660,100800,189,1000,15.90,84.10,664,255,354,70,65,398,405,0,0,0,197,159,17,0,0,5167
696,628,68,480,148,1990,1518,287500,532,164,76.44,23.56,188,139,75,63,47,0,10,14,35,0,0,115,178,114,46,5168
681,644,37,395,249,1993,1237,299600,613,68,90.01,9.99,309,22,72,146,101,0,52,84,28,0,7,85,251,44,70,5169
1354,1264,90,997,267,1998,910,294400,1097,257,81.02,18.98,763,236,150,26,130,10,103,88,0,0,96,282,193,114,235,5170
449,425,24,320,105,2002,1721,281000,449,0,100.00,0.00,323,15,27,30,12,0,12,15,56,0,13,50,228,10,23,5171
504,456,48,295,161,1972,666,119100,370,134,73.41,26.59,167,39,73,52,246,76,163,0,0,0,30,122,43,0,0,5172
349,251,98,148,103,1967,699,177500,206,143,59.03,40.97,23,11,36,48,275,0,99,16,0,0,70,135,34,0,0,5173
878,831,47,186,645,2002,971,0,227,651,25.85,74.15,418,77,85,88,83,27,344,134,0,0,66,44,62,0,64,5174
745,568,177,473,95,1981,1435,325000,738,7,99.06,0.94,310,65,212,68,115,0,102,16,0,0,31,70,161,31,156,5175
386,361,25,245,116,1980,907,134900,221,165,57.25,42.75,100,125,173,20,13,55,55,94,0,0,110,18,99,0,0,5176
454,413,41,30,383,1976,954,0,116,338,25.55,74.45,34,172,101,0,27,0,204,0,0,0,0,42,47,0,0,5177
502,490,12,310,180,1961,984,188100,437,65,87.05,12.95,157,70,63,18,185,0,103,18,0,0,104,198,27,0,0,5178
1160,1020,140,654,366,1996,1174,296800,925,235,79.74,20.26,553,183,74,140,92,0,42,55,15,0,42,251,389,57,91,5179
578,517,61,479,38,1976,786,301400,430,148,74.39,25.61,169,82,139,32,147,12,22,8,0,0,138,50,157,37,99,5180
770,718,52,461,257,1999,1135,216800,508,262,65.97,34.03,487,9,69,39,22,11,87,62,26,18,35,97,187,0,0,5181
924,815,109,604,211,1986,915,293900,756,168,81.82,18.18,267,147,169,135,228,10,89,10,0,0,35,205,338,44,132,5182
693,616,77,523,93,2003,1606,253700,693,0,100.00,0.00,667,42,15,0,0,0,0,12,41,9,0,128,361,60,75,5183
657,580,77,505,75,1992,1333,207900,615,42,93.61,6.39,297,74,116,112,35,0,53,72,18,0,0,241,237,13,0,5184
1132,1048,84,199,849,1992,1251,287900,291,841,25.71,74.29,750,136,132,118,19,59,139,667,48,0,23,16,69,0,0,5185
503,491,12,481,10,1991,0,300300,405,98,80.52,19.48,160,79,194,10,46,0,0,0,32,0,8,29,216,132,72,5186
366,366,0,366,0,1983,0,379900,366,0,100.00,0.00,44,110,94,10,37,0,10,0,0,0,0,57,94,79,55,5187
777,656,121,608,48,1992,763,235600,506,271,65.12,34.88,350,61,121,21,78,40,9,0,0,0,70,292,165,37,18,5188
307,272,35,189,83,1952,654,154700,228,79,74.27,25.73,28,34,17,23,175,22,38,0,0,0,60,71,24,6,0,5189
643,606,37,469,137,1954,2534,503000,629,14,97.82,2.18,26,0,0,90,563,0,0,39,25,16,0,0,169,194,195,5190
1539,1292,247,70,1222,1991,1382,0,0,1539,0.00,100.00,648,51,149,22,296,68,389,344,55,97,0,27,17,0,37,5191
420,346,74,335,11,1957,0,313900,391,29,93.10,6.90,177,0,89,23,291,0,67,11,40,19,36,74,77,89,102,5192
484,422,62,343,79,1978,0,266000,484,0,100.00,0.00,35,118,81,44,34,0,0,20,18,0,0,50,214,0,10,5193
656,576,80,530,46,1994,0,300900,589,67,89.79,10.21,282,62,56,0,0,0,0,14,15,0,0,27,206,38,53,5194
400,316,84,303,13,2000,0,221800,321,79,80.25,19.75,243,66,131,62,55,0,34,0,11,0,67,74,74,33,24,5195
615,528,87,497,31,1993,0,650700,545,70,88.62,11.38,261,175,48,0,11,13,14,0,11,0,9,0,23,30,278,5196
1096,1027,69,284,743,1986,1086,266100,324,772,29.56,70.44,695,273,60,166,62,0,400,522,42,0,0,19,102,39,32,5197
461,416,45,259,157,1942,1044,185600,365,96,79.18,20.82,9,44,37,31,263,0,64,33,26,37,0,121,74,0,0,5198
358,358,0,308,50,1991,0,328800,358,0,100.00,0.00,126,263,54,0,0,0,0,0,13,0,0,0,375,19,19,5199
1146,1049,97,859,190,0,1644,231900,1114,32,97.21,2.79,941,0,8,3,24,0,3,50,108,5,0,165,406,50,34,5200
713,713,0,128,585,1977,917,226300,169,544,23.70,76.30,437,259,120,52,10,64,590,34,24,0,14,10,30,20,0,5201
295,295,0,229,66,2003,1694,377800,273,22,92.54,7.46,242,17,40,8,0,0,21,20,8,0,0,10,40,58,141,5202
1089,888,201,674,214,2001,1680,242000,968,121,88.89,11.11,558,34,52,24,20,0,9,0,7,0,0,227,364,38,12,5203
1057,1008,49,894,114,1993,1356,253800,1057,0,100.00,0.00,446,275,77,37,0,0,77,0,26,0,0,66,530,100,36,5204
798,597,201,477,120,1990,1109,286100,585,213,73.31,26.69,286,132,76,148,79,0,89,46,0,0,8,191,42,21,59,5205
304,296,8,204,92,1987,946,106200,287,17,94.41,5.59,88,22,78,71,52,2,78,15,0,0,91,119,0,0,0,5206
517,517,0,346,171,1957,760,113900,415,102,80.27,19.73,0,87,64,145,305,150,203,14,0,0,65,128,0,0,0,5207
682,669,13,426,243,1956,716,103500,537,145,78.74,21.26,130,45,79,60,396,123,97,0,0,0,282,208,0,0,0,5208
2211,2101,110,1190,911,2006,1932,508800,1302,909,58.89,41.11,1215,0,13,10,0,0,0,160,167,49,9,45,240,82,344,5209
575,527,48,116,411,1973,970,225900,164,411,28.52,71.48,0,0,165,99,196,0,251,50,0,0,0,28,43,13,0,5210
776,741,35,623,118,1996,1142,194700,572,204,73.71,26.29,247,66,128,95,212,133,43,34,35,0,121,329,3,14,0,5211
532,505,27,402,103,1980,1046,230400,427,105,80.26,19.74,155,108,287,12,0,0,0,61,35,0,34,190,186,33,12,5212
446,396,50,173,223,1972,618,144500,196,250,43.95,56.05,63,53,89,50,156,13,97,8,15,0,79,157,7,0,0,5213
601,578,23,429,149,1949,1576,352300,590,11,98.17,1.83,18,0,22,57,444,0,0,12,0,0,0,52,211,92,124,5214
378,355,23,253,102,1954,792,214300,364,14,96.30,3.70,0,0,64,56,224,0,34,50,0,0,0,137,101,0,0,5215
991,957,34,706,251,1996,1164,195700,567,424,57.21,42.79,920,108,14,0,12,0,55,74,41,0,12,408,407,0,0,5216
917,785,132,523,262,1992,1426,187300,301,616,32.82,67.18,462,136,216,36,132,0,74,168,12,12,314,135,125,89,53,5217
350,350,0,216,134,1992,1624,188800,350,0,100.00,0.00,321,101,45,12,0,0,0,126,12,0,0,216,103,0,0,5218
913,809,104,263,546,1971,1307,159900,515,398,56.41,43.59,457,70,175,127,89,8,324,186,72,38,0,114,23,0,0,5219
229,215,14,115,100,1990,1227,249300,195,34,85.15,14.85,95,208,30,8,49,0,60,69,38,0,0,27,196,0,0,5220
1250,1134,116,197,937,1991,883,278400,306,944,24.48,75.52,386,356,162,57,173,68,382,234,40,0,0,51,104,10,40,5221
414,360,54,276,84,1991,1405,252600,244,170,58.94,41.06,175,87,82,10,15,0,0,36,7,0,29,136,126,12,23,5222
706,681,25,485,196,1989,1106,307700,563,143,79.75,20.25,327,84,156,51,230,0,58,124,0,0,11,180,207,121,55,5223
475,439,36,305,134,1988,1234,231400,352,123,74.11,25.89,215,114,158,17,80,0,49,29,0,0,68,163,201,26,0,5224
668,659,9,546,113,1952,1573,469800,636,32,95.21,4.79,53,18,24,40,484,0,15,7,40,0,0,43,138,181,143,5225
712,622,90,479,143,1998,2195,239900,659,53,92.56,7.44,484,25,135,64,21,0,16,39,12,12,0,76,411,36,118,5226
661,661,0,391,270,1955,1228,405300,504,157,76.25,23.75,92,26,28,21,395,9,57,84,19,9,0,20,160,100,54,5227
353,301,52,263,38,1960,0,96300,343,10,97.17,2.83,55,38,112,13,191,0,55,14,0,0,62,124,0,38,0,5228
705,655,50,357,298,1985,1628,229400,441,264,62.55,37.45,427,82,111,109,114,0,187,219,63,0,14,151,209,0,0,5229
559,526,33,16,510,1985,1110,0,55,504,9.84,90.16,131,244,35,0,0,31,145,168,29,0,0,0,37,0,0,5230
480,387,93,301,86,1960,912,176400,464,16,96.67,3.33,35,56,44,51,199,31,0,17,0,0,57,87,115,13,9,5231
780,751,29,666,85,1993,640,164700,538,242,68.97,31.03,344,74,171,50,81,24,39,30,0,0,85,411,89,0,5,5232
332,259,73,208,51,1962,573,154900,237,95,71.39,28.61,108,20,84,34,178,46,49,0,0,0,39,156,29,9,0,5233
562,488,74,211,277,1975,894,266800,247,315,43.95,56.05,142,72,30,21,297,34,98,133,23,0,0,43,96,22,25,5234
579,532,47,401,131,1992,1324,243400,579,0,100.00,0.00,248,68,36,0,0,0,0,62,28,0,7,65,179,11,0,5235
712,712,0,615,97,1990,1712,233000,632,80,88.76,11.24,379,168,70,10,45,0,10,34,34,0,0,170,247,66,59,5236
519,491,28,410,81,1995,1698,197200,519,0,100.00,0.00,163,25,85,59,37,0,0,8,0,0,0,166,145,10,40,5237
367,367,0,318,49,1981,1407,374800,367,0,100.00,0.00,110,148,16,100,29,0,0,0,0,0,0,32,131,70,147,5238
838,816,22,399,417,1995,1431,295700,655,183,78.16,21.84,458,64,90,17,94,33,0,130,47,0,0,120,195,53,109,5239
717,656,61,573,83,1992,1321,267800,601,116,83.82,16.18,335,72,182,27,62,0,38,55,10,0,19,180,117,121,87,5240
531,434,97,419,15,1961,0,224600,531,0,100.00,0.00,22,13,19,31,350,0,13,0,0,0,0,286,90,9,0,5241
506,470,36,66,404,1969,949,235200,112,394,22.13,77.87,21,66,156,235,94,10,247,137,19,0,10,53,73,23,0,5242
468,468,0,222,246,1988,1418,534900,241,227,51.50,48.50,245,229,15,0,0,0,36,110,63,0,0,0,37,98,92,5243
435,395,40,365,30,1989,0,704300,421,14,96.78,3.22,160,125,30,0,0,0,0,0,0,0,0,19,14,30,231,5244
926,871,55,24,847,2000,1325,0,9,917,0.97,99.03,500,298,70,33,0,30,358,208,216,40,0,0,0,0,0,5245
715,682,33,397,285,1990,1242,392200,469,246,65.59,34.41,358,77,95,160,71,0,77,54,116,84,6,24,79,187,52,5246
650,636,14,590,46,1972,0,769000,618,32,95.08,4.92,103,80,158,201,93,0,8,0,16,56,0,28,0,46,481,5247
513,513,0,477,36,1978,2250,673200,507,6,98.83,1.17,197,102,300,12,35,0,0,0,7,17,8,0,26,29,494,5248
464,464,0,391,73,1977,1668,356500,359,105,77.37,22.63,34,64,194,87,11,0,0,0,9,0,22,55,161,134,9,5249
880,813,67,734,79,2002,0,330700,880,0,100.00,0.00,542,111,89,17,0,0,0,0,13,0,0,17,189,331,175,5250
521,487,34,342,145,1964,929,268500,433,88,83.11,16.89,96,48,70,61,211,40,6,54,0,0,10,141,125,22,33,5251
854,827,27,129,698,1990,773,36000,33,821,3.86,96.14,315,244,100,20,16,78,343,107,0,0,121,0,20,0,0,5252
477,477,0,327,150,1999,705,263500,406,71,85.12,14.88,206,36,104,10,97,0,16,0,0,0,0,120,214,42,30,5253
946,908,38,509,399,1976,607,94400,427,519,45.14,54.86,68,30,378,169,36,142,91,13,0,0,122,195,26,0,26,5254
734,643,91,233,410,1988,992,361100,378,356,51.50,48.50,216,148,81,72,204,10,263,215,20,0,0,13,20,82,45,5255
589,581,8,514,67,1987,1509,318800,583,6,98.98,1.02,193,233,46,19,63,0,5,3,18,10,7,45,201,119,113,5256
495,444,51,392,52,1987,1347,276400,371,124,74.95,25.05,209,172,127,15,15,0,15,43,14,0,112,16,168,74,81,5257
777,708,69,630,78,1983,0,623300,706,71,90.86,9.14,452,120,142,79,57,0,15,8,14,0,0,21,60,28,633,5258
787,748,39,399,349,1945,955,133000,613,174,77.89,22.11,137,36,218,22,447,0,289,50,0,0,36,321,96,9,23,5259
496,496,0,401,95,1984,0,271500,378,118,76.21,23.79,156,42,136,19,118,15,0,0,0,0,46,80,159,55,98,5260
935,908,27,819,89,1987,1428,390400,822,113,87.91,12.09,346,230,125,105,101,0,40,8,8,0,12,85,242,168,302,5261
1442,1398,44,348,1050,1997,1240,177300,551,891,38.21,61.79,688,98,38,0,0,56,76,160,77,142,47,182,54,0,0,5262
590,534,56,297,237,1997,875,158400,238,352,40.34,59.66,121,164,62,52,36,84,90,0,0,0,94,141,15,11,0,5263
660,609,51,557,52,1983,0,757400,660,0,100.00,0.00,156,219,147,29,88,0,0,0,0,32,0,0,0,14,530,5264
305,305,0,272,33,1978,0,296700,305,0,100.00,0.00,18,9,110,103,0,0,0,0,0,0,0,10,157,32,10,5265
314,297,17,241,56,1979,1143,275500,224,90,71.34,28.66,128,142,48,10,57,0,0,7,0,0,90,42,91,8,129,5266
537,509,28,406,103,1991,1360,216900,348,189,64.80,35.20,280,113,95,8,34,2,49,10,17,0,27,189,165,16,14,5267
334,334,0,267,67,1978,0,204000,305,29,91.32,8.68,34,65,77,0,115,0,39,0,0,0,28,179,13,0,0,5268
394,302,92,156,146,1977,848,0,160,234,40.61,59.39,200,141,0,115,62,111,157,0,0,0,29,27,13,12,0,5269
743,734,9,474,260,1991,905,294200,494,249,66.49,33.51,200,118,119,90,142,36,130,8,20,9,22,120,106,92,107,5270
1303,1092,211,667,425,1997,911,240500,788,515,60.48,39.52,1179,39,98,0,0,0,145,125,0,0,0,225,445,55,30,5271
488,488,0,448,40,1994,0,435600,476,12,97.54,2.46,230,9,0,66,56,0,0,8,9,0,10,0,94,70,146,5272
763,763,0,556,207,1985,696,99600,408,355,53.47,46.53,426,62,177,0,205,77,79,18,0,0,263,306,81,0,0,5273
595,557,38,75,482,1986,1059,320200,88,507,14.79,85.21,239,91,111,257,12,161,201,147,28,0,0,0,76,14,0,5274
418,368,50,290,78,1996,1810,358600,418,0,100.00,0.00,155,50,148,49,0,0,0,23,0,0,0,34,179,77,89,5275
770,741,29,677,64,1997,1803,359500,770,0,100.00,0.00,410,302,116,6,0,0,0,0,0,47,30,39,188,333,174,5276
401,341,60,270,71,1959,754,138900,296,105,73.82,26.18,59,23,60,21,217,8,24,12,0,0,64,168,40,0,0,5277
366,321,45,116,205,1965,874,222700,134,232,36.61,63.39,29,26,34,106,228,44,55,59,0,0,0,79,86,0,0,5278
399,399,0,137,262,1970,892,268100,168,231,42.11,57.89,30,40,137,213,181,78,210,78,7,0,15,9,118,0,0,5279
428,406,22,333,73,1957,237,441700,341,87,79.67,20.33,17,44,58,28,302,33,11,0,53,0,0,0,129,53,123,5280
621,597,24,299,298,1986,698,442700,403,218,64.90,35.10,198,253,237,72,47,120,179,0,30,33,19,10,153,99,139,5281
1564,1041,523,865,176,1985,878,361000,1508,56,96.42,3.58,482,182,242,88,178,8,41,128,6,17,0,73,314,60,190,5282
595,595,0,472,123,1982,1601,277900,572,23,96.13,3.87,80,292,40,213,41,0,0,124,52,0,0,53,367,28,0,5283
734,681,53,289,392,1974,885,237700,395,339,53.81,46.19,130,136,108,152,47,0,262,41,0,0,0,33,0,53,137,5284
644,644,0,366,278,1981,881,308700,347,297,53.88,46.12,213,111,90,5,87,0,117,0,54,0,0,101,79,38,102,5285
626,587,39,388,199,1980,880,286000,306,320,48.88,51.12,175,225,92,90,192,0,157,39,13,0,0,138,205,71,53,5286
583,583,0,393,190,1972,1447,288100,432,151,74.10,25.90,61,17,162,53,132,0,85,36,0,0,0,13,113,76,54,5287
465,408,57,202,206,1978,216,222000,242,223,52.04,47.96,106,58,104,42,151,99,112,22,0,0,14,52,68,17,7,5288
423,400,23,271,129,1968,977,285200,324,99,76.60,23.40,87,65,9,120,101,19,105,0,0,0,0,50,82,70,33,5289
546,546,0,337,209,1977,917,202700,195,351,35.71,64.29,147,84,160,97,29,52,156,127,11,0,0,71,63,19,0,5290
848,733,115,613,120,1992,1058,209100,610,238,71.93,28.07,293,223,58,44,80,9,32,65,0,0,18,313,211,30,10,5291
449,404,45,221,183,1966,900,130400,330,119,73.50,26.50,61,25,121,41,227,0,178,19,0,0,58,132,53,0,7,5292
477,445,32,403,42,1963,1691,183200,450,27,94.34,5.66,32,0,92,228,91,0,0,9,0,0,30,325,79,0,0,5293
449,378,71,297,81,1987,1578,149800,318,131,70.82,29.18,181,26,58,22,53,38,10,11,0,7,55,130,55,0,0,5294
628,546,82,452,94,1990,1250,350500,578,50,92.04,7.96,167,51,110,49,33,0,49,11,0,0,0,51,99,73,66,5295
444,444,0,300,144,1954,1883,289600,411,33,92.57,7.43,255,54,51,83,188,0,87,18,17,43,0,81,210,110,16,5296
422,422,0,341,81,1960,1267,288500,422,0,100.00,0.00,132,10,0,52,320,0,36,0,0,13,11,113,212,69,0,5297
1479,1380,99,248,1132,2003,977,423500,287,1192,19.41,80.59,316,126,111,25,60,0,88,152,12,0,0,10,138,57,99,5298
439,411,28,400,11,1973,0,573400,439,0,100.00,0.00,88,63,110,86,63,0,0,10,0,32,0,28,9,35,272,5299
700,607,93,591,16,1985,0,549000,686,14,98.00,2.00,65,359,96,38,58,0,0,0,0,0,17,0,31,110,458,5300
429,379,50,325,54,1967,832,204400,352,77,82.05,17.95,71,29,161,77,72,15,30,22,0,0,58,113,48,20,0,5301
460,460,0,390,70,1990,945,198600,343,117,74.57,25.43,230,29,98,39,111,0,7,0,0,0,35,212,142,11,57,5302
692,676,16,562,114,1976,1666,269100,692,0,100.00,0.00,277,0,0,250,75,28,0,0,47,0,0,109,328,29,10,5303
520,520,0,400,120,1997,957,234600,387,133,74.42,25.58,391,97,60,15,0,0,198,25,39,8,0,83,182,20,8,5304
659,633,26,579,54,1995,3219,573400,659,0,100.00,0.00,529,93,0,0,20,0,0,11,0,0,0,0,16,62,542,5305
428,428,0,207,221,1970,868,199200,244,184,57.01,42.99,25,90,89,210,104,0,177,50,0,0,22,47,51,10,15,5306
756,661,95,565,96,1987,1413,272000,736,20,97.35,2.65,529,106,284,0,16,0,64,83,46,0,74,280,306,30,0,5307
735,735,0,179,556,1985,939,225200,187,548,25.44,74.56,185,333,264,54,0,0,410,153,37,31,0,27,113,0,0,5308
394,366,28,300,66,1970,1851,227600,394,0,100.00,0.00,117,0,73,136,79,0,0,14,13,0,0,128,183,24,10,5309
823,763,60,222,541,1977,954,288900,174,649,21.14,78.86,46,288,365,207,98,14,502,196,0,0,0,66,45,34,30,5310
523,523,0,452,71,1967,1652,360500,493,30,94.26,5.74,78,21,88,152,180,0,0,0,0,0,0,44,243,136,65,5311
751,706,45,263,443,1969,974,73400,69,682,9.19,90.81,128,140,505,98,25,0,147,214,0,0,117,230,57,0,0,5312
464,396,68,318,78,1947,566,151000,398,66,85.78,14.22,40,27,64,45,224,21,37,0,0,0,75,157,30,8,0,5313
394,386,8,215,171,1971,631,0,156,238,39.59,60.41,80,0,172,23,264,112,119,0,0,0,184,47,10,11,0,5314
332,332,0,127,205,1969,766,101200,94,238,28.31,71.69,22,27,164,46,23,0,133,0,0,0,69,21,0,0,0,5315
517,481,36,305,176,1967,649,147800,412,105,79.69,20.31,103,27,170,47,210,16,185,0,0,0,48,234,57,8,9,5316
237,200,37,112,88,1973,1377,164700,156,81,65.82,34.18,0,70,35,73,110,0,38,0,30,11,12,159,0,0,0,5317
686,655,31,558,97,1995,1354,200500,643,43,93.73,6.27,716,0,11,0,66,0,100,25,0,0,19,409,220,0,0,5318
815,718,97,443,275,1963,1174,246800,634,181,77.79,22.21,103,23,150,150,307,8,46,105,26,0,8,176,189,51,38,5319
429,429,0,277,152,1939,1296,217500,416,13,96.97,3.03,17,0,0,0,380,0,52,58,0,0,0,122,69,17,13,5320
956,864,92,542,322,1991,883,220200,122,834,12.76,87.24,579,49,292,70,25,13,195,39,43,13,81,281,39,15,140,5321
409,409,0,319,90,2000,1099,586800,390,19,95.35,4.65,291,43,61,6,0,0,0,0,0,0,9,14,97,0,281,5322
463,436,27,349,87,1988,1053,318300,370,93,79.91,20.09,188,85,45,22,37,0,12,12,0,0,0,72,105,48,128,5323
397,397,0,335,62,1959,2185,218200,388,9,97.73,2.27,58,57,65,110,134,0,50,14,0,0,9,131,165,9,8,5324
1029,942,87,349,593,1989,1106,285400,576,453,55.98,44.02,492,252,264,17,40,45,300,59,59,0,0,276,205,21,0,5325
960,809,151,697,112,1988,1065,328900,843,117,87.81,12.19,238,149,441,17,58,7,0,122,15,0,0,127,219,142,157,5326
798,719,79,335,384,1978,746,125800,409,389,51.25,48.75,332,104,149,110,98,15,277,49,0,0,0,268,44,0,0,5327
827,827,0,581,246,1998,1371,486400,681,146,82.35,17.65,564,73,95,137,33,116,39,27,38,49,0,12,89,65,381,5328
578,537,41,473,64,1988,861,354700,483,95,83.56,16.44,161,18,45,46,160,0,7,8,0,0,10,73,85,30,127,5329
480,417,63,292,125,1972,685,242900,366,114,76.25,23.75,39,39,88,99,207,0,58,0,0,0,16,150,161,26,20,5330
287,269,18,196,73,1939,633,194000,268,19,93.38,6.62,20,22,8,6,135,10,20,0,0,0,21,84,16,0,4,5331
593,561,32,0,561,1983,1253,0,243,350,40.98,59.02,139,179,119,109,37,14,65,340,27,13,10,0,0,0,0,5332
548,522,26,402,120,1993,1531,336400,544,4,99.27,0.73,369,178,131,0,37,0,17,51,10,0,0,166,202,165,0,5333
499,499,0,499,0,1984,0,297900,499,0,100.00,0.00,111,186,161,35,31,0,0,0,0,0,0,117,155,65,50,5334
812,737,75,94,643,1988,1392,235200,94,718,11.58,88.42,209,376,97,31,11,0,33,361,157,0,0,13,0,16,0,5335
517,517,0,498,19,1986,0,595700,504,13,97.49,2.51,37,323,0,0,0,0,0,0,0,14,10,0,0,108,228,5336
461,369,92,298,71,1993,0,179200,313,148,67.90,32.10,253,75,101,0,0,0,25,27,0,0,15,273,59,0,30,5337
447,411,36,311,100,1983,731,225000,307,140,68.68,31.32,86,87,64,29,78,20,66,12,0,0,4,152,60,15,0,5338
1013,936,77,705,231,1996,1227,217900,904,109,89.24,10.76,592,87,87,39,91,0,17,69,6,13,52,306,177,83,38,5339
490,401,89,353,48,1984,1393,538000,440,50,89.80,10.20,80,192,33,97,55,0,0,15,18,0,37,9,111,90,177,5340
692,557,135,478,79,1987,971,379300,618,74,89.31,10.69,149,200,60,71,51,0,12,0,0,9,0,26,136,69,249,5341
318,318,0,285,33,1984,0,577000,318,0,100.00,0.00,60,88,67,0,47,0,0,0,0,0,0,12,30,22,198,5342
384,350,34,305,45,1971,2050,496600,384,0,100.00,0.00,58,15,88,167,44,0,0,6,19,24,9,25,0,74,190,5343
776,729,47,330,399,1971,798,143100,318,458,40.98,59.02,52,109,145,120,269,0,180,35,17,0,122,197,83,0,0,5344
431,431,0,362,69,1992,1116,293900,426,5,98.84,1.16,172,26,73,35,73,0,5,0,0,20,0,56,186,25,53,5345
273,273,0,254,19,1968,0,364300,273,0,100.00,0.00,0,14,190,111,27,0,0,0,14,0,0,27,206,67,28,5346
707,622,85,191,431,1961,759,165500,325,382,45.97,54.03,85,0,58,56,489,120,159,14,0,53,14,168,60,23,0,5347
900,801,99,471,330,1964,1076,465300,625,275,69.44,30.56,250,55,9,36,511,16,31,60,13,0,0,36,230,71,203,5348
736,639,97,587,52,1960,2407,740000,736,0,100.00,0.00,131,61,11,94,307,16,0,0,13,15,0,0,0,6,531,5349
454,423,31,340,83,1973,1108,280600,397,57,87.44,12.56,14,0,165,183,53,0,10,34,19,0,11,39,302,0,0,5350
495,448,47,295,153,1961,621,123900,339,156,68.48,31.52,64,17,75,78,177,13,44,0,0,0,38,162,41,15,7,5351
703,659,44,463,196,1977,1058,0,237,466,33.71,66.29,51,120,482,108,71,0,141,72,10,0,269,179,88,0,0,5352
386,386,0,344,42,0,0,290200,376,10,97.41,2.59,413,20,13,0,0,0,0,25,0,0,0,31,320,49,13,5353
541,515,26,464,51,1975,927,435200,515,26,95.19,4.81,92,16,107,94,73,0,14,0,0,0,0,47,63,29,164,5354
579,579,0,519,60,1978,0,323800,579,0,100.00,0.00,18,57,443,49,0,0,0,0,0,45,0,102,249,97,45,5355
401,360,41,360,0,1971,0,574200,401,0,100.00,0.00,46,51,188,78,27,0,0,0,34,0,0,20,89,29,171,5356
797,702,95,423,279,1979,475,46600,183,614,22.96,77.04,271,137,225,103,138,97,116,111,21,20,266,86,30,0,0,5357
486,465,21,431,34,1979,0,518600,470,16,96.71,3.29,98,125,135,66,46,0,11,0,0,0,6,37,59,64,293,5358
275,203,72,203,0,1978,0,539000,275,0,100.00,0.00,0,122,86,0,12,0,0,0,0,0,0,0,12,24,131,5359
614,582,32,534,48,1984,3038,424000,594,20,96.74,3.26,265,114,42,47,90,0,16,0,0,10,0,9,89,91,327,5360
397,382,15,346,36,1992,0,748000,397,0,100.00,0.00,202,117,54,0,28,0,0,0,18,0,18,0,0,0,365,5361
789,773,16,593,180,2001,2197,284800,775,14,98.23,1.77,542,113,84,21,0,0,0,0,74,14,18,125,283,153,93,5362
590,543,47,506,37,1969,1656,220100,441,149,74.75,25.25,148,14,73,294,96,13,0,0,15,0,139,123,300,24,3,5363
555,502,53,493,9,1989,0,393900,506,49,91.17,8.83,214,175,49,20,6,0,13,38,10,5,0,6,26,127,207,5364
322,266,56,255,11,1990,0,180400,236,86,73.29,26.71,58,14,83,13,110,0,0,7,0,0,38,90,12,55,16,5365
258,217,41,163,54,1957,671,78700,209,49,81.01,18.99,35,8,44,6,172,11,40,0,0,0,89,30,9,0,0,5366
662,574,88,141,433,1959,769,165000,409,253,61.78,38.22,33,99,39,42,379,108,114,56,0,0,25,182,23,0,0,5367
538,408,130,151,257,1982,416,159400,308,230,57.25,42.75,140,89,105,27,43,30,55,37,0,0,14,22,90,56,0,5368
484,216,268,123,93,1985,0,247100,371,113,76.65,23.35,109,154,86,0,71,46,11,0,0,0,16,23,53,12,67,5369
521,491,30,446,45,1986,661,239400,397,124,76.20,23.80,258,97,152,9,21,0,51,18,0,0,21,199,114,73,33,5370
1006,960,46,764,196,1986,871,229300,819,187,81.41,18.59,490,143,174,30,98,0,96,69,0,0,30,311,260,8,105,5371
471,384,87,303,81,1972,950,162500,362,109,76.86,23.14,139,74,58,106,219,6,43,13,0,0,28,318,39,0,12,5372
695,563,132,418,145,1992,789,213900,398,297,57.27,42.73,196,101,228,43,194,111,89,12,0,0,71,249,71,25,7,5373
704,643,61,568,75,1985,1474,315400,704,0,100.00,0.00,407,104,67,100,16,0,0,47,13,0,0,23,270,172,169,5374
413,388,25,275,113,1979,893,94400,225,188,54.48,45.52,186,64,108,0,95,53,41,0,0,0,144,163,12,0,0,5375
742,742,0,627,115,1986,1346,195500,696,46,93.80,6.20,219,226,105,10,54,0,0,30,0,0,10,447,99,20,8,5376
1078,996,82,241,755,1994,760,134400,217,861,20.13,79.87,719,50,135,0,182,37,623,83,0,0,66,165,0,0,0,5377
958,900,58,675,225,1986,1058,199900,805,153,84.03,15.97,294,66,213,110,246,0,135,21,26,12,141,417,139,7,0,5378
406,396,10,344,52,1975,955,202500,345,61,84.98,15.02,156,64,178,21,15,16,33,10,0,0,10,191,111,21,19,5379
1050,918,132,773,145,1980,918,212800,737,313,70.19,29.81,381,222,266,35,108,0,26,0,0,0,67,522,142,40,93,5380
862,804,58,410,394,1963,841,167600,675,187,78.31,21.69,119,36,394,115,328,53,245,79,0,0,37,394,45,0,18,5381
322,270,52,61,209,1939,549,104300,124,198,38.51,61.49,0,22,5,0,232,57,43,21,0,0,96,42,0,0,0,5382
641,434,207,265,169,1976,1245,188600,452,189,70.51,29.49,259,60,119,77,136,40,71,53,0,0,56,174,83,26,32,5383
590,525,65,374,151,1959,1113,430000,501,89,84.92,15.08,84,69,80,25,345,9,41,65,41,4,9,38,116,62,183,5384
686,628,58,298,330,1955,882,98000,582,104,84.84,15.16,0,0,93,108,446,0,210,39,0,0,83,247,11,0,0,5385
378,378,0,339,39,1978,0,204200,358,20,94.71,5.29,100,7,159,23,52,0,69,0,0,0,26,174,66,6,0,5386
653,630,23,514,116,1986,1165,186900,592,61,90.66,9.34,113,301,77,17,18,0,23,16,27,0,44,232,160,0,0,5387
603,570,33,430,140,1995,1201,195700,467,136,77.45,22.55,348,194,159,0,0,0,68,44,23,0,34,339,125,20,9,5388
438,398,40,340,58,1966,1678,304200,299,139,68.26,31.74,27,34,77,114,173,0,37,0,0,0,11,65,125,108,33,5389
690,635,55,465,170,1996,1428,493400,497,193,72.03,27.97,297,107,93,37,57,0,18,102,48,0,0,16,62,139,206,5390
325,305,20,244,61,1978,1272,203500,315,10,96.92,3.08,21,62,169,0,23,0,56,0,0,0,0,158,51,0,10,5391
1201,1055,146,757,298,1939,640,122600,1005,196,83.68,16.32,56,87,55,130,741,84,80,21,13,0,279,376,65,19,10,5392
685,633,52,78,555,1963,873,326400,45,640,6.57,93.43,103,11,42,97,317,125,293,55,0,18,0,0,34,0,0,5393
484,484,0,399,85,1939,2173,722700,471,13,97.31,2.69,26,13,0,17,376,0,0,42,0,0,13,0,46,25,306,5394
1303,1137,166,129,1008,2003,824,656300,0,1303,0.00,100.00,619,0,52,48,185,209,388,11,11,40,0,0,42,0,6,5395
788,720,68,208,512,1963,1389,428600,148,640,18.78,81.22,84,101,146,112,350,12,145,129,77,0,0,75,84,126,91,5396
934,892,42,299,593,1939,1290,995000,231,703,24.73,75.27,74,46,30,58,553,0,215,91,62,48,14,14,25,19,167,5397
884,817,67,249,568,1962,1500,780400,243,641,27.49,72.51,68,73,37,193,657,18,92,370,125,68,0,0,53,30,196,5398
1161,955,206,39,916,1939,565,0,23,1138,1.98,98.02,43,55,92,136,866,323,456,90,0,0,0,32,29,16,0,5399
707,622,85,380,242,1959,918,166200,517,190,73.13,26.87,149,22,57,62,347,0,156,42,0,0,50,377,0,0,0,5400
1211,1150,61,1074,76,1992,0,208800,879,332,72.58,27.42,604,134,196,15,121,5,116,8,0,0,91,326,348,24,75,5401
793,769,24,0,769,1973,1439,0,343,450,43.25,56.75,316,111,105,71,315,0,0,670,93,64,0,22,0,0,0,5402
528,441,87,366,75,1979,892,182500,389,139,73.67,26.33,82,9,168,51,133,10,31,14,0,0,39,190,41,0,19,5403
666,666,0,334,332,1962,894,318900,420,246,63.06,36.94,286,49,0,83,171,0,106,121,66,0,0,66,61,25,36,5404
425,416,9,407,9,2003,0,721200,425,0,100.00,0.00,203,42,42,0,54,12,9,0,0,26,10,0,18,0,266,5405
379,301,78,49,252,1974,822,234100,157,222,41.42,58.58,98,0,104,53,52,73,72,37,0,0,0,52,11,0,0,5406
634,604,30,423,181,1982,1046,160600,478,156,75.39,24.61,199,131,76,66,142,12,72,41,0,35,49,275,59,12,25,5407
510,500,10,309,191,1981,978,333800,436,74,85.49,14.51,146,64,96,71,170,13,54,9,29,11,32,89,146,59,68,5408
605,605,0,511,94,1990,1119,348600,504,101,83.31,16.69,225,70,57,35,152,0,91,0,9,0,11,53,100,88,164,5409
510,422,88,256,166,1946,911,137500,400,110,78.43,21.57,68,0,78,29,334,0,112,6,0,0,25,235,37,0,0,5410
671,671,0,469,202,1984,856,243200,509,162,75.86,24.14,144,117,224,147,38,0,156,80,25,0,0,202,171,12,24,5411
319,319,0,53,266,1969,630,0,137,182,42.95,57.05,44,0,20,17,263,22,209,0,0,0,10,37,11,0,8,5412
544,500,44,484,16,1939,0,583300,544,0,100.00,0.00,14,18,0,25,603,0,0,10,0,17,0,0,0,0,591,5413
548,548,0,214,334,1939,1329,476100,169,379,30.84,69.16,47,43,37,63,273,0,144,83,66,0,0,12,64,16,78,5414
1022,878,144,181,697,1975,1183,536500,174,848,17.03,82.97,118,121,166,69,337,0,374,223,17,46,0,0,53,33,21,5415
371,287,84,240,47,1939,0,1558800,371,0,100.00,0.00,0,0,24,11,289,0,0,13,0,0,0,0,0,0,298,5416
1037,1005,32,359,646,1974,1240,427000,370,667,35.68,64.32,161,55,245,211,311,0,307,317,24,25,0,26,67,91,92,5417
501,488,13,317,171,1939,1308,592400,366,135,73.05,26.95,49,32,16,0,452,0,41,32,95,14,0,0,30,65,199,5418
682,638,44,501,137,1986,1828,311600,653,29,95.75,4.25,235,98,256,50,0,0,0,93,59,0,16,8,355,59,29,5419
340,303,37,231,72,1939,925,158200,282,58,82.94,17.06,81,19,52,8,253,10,51,12,0,0,66,168,26,0,6,5420
243,243,0,195,48,1969,630,203400,225,18,92.59,7.41,55,8,116,13,77,12,15,0,0,0,19,153,20,0,0,5421
469,391,78,283,108,1981,489,144800,269,200,57.36,42.64,35,91,111,58,228,165,27,0,0,0,48,147,70,0,9,5422
708,544,164,402,142,1968,2080,347300,646,62,91.24,8.76,181,82,71,73,275,3,36,37,0,0,11,31,98,69,250,5423
516,445,71,372,73,1984,0,352600,420,96,81.40,18.60,214,49,125,68,112,0,44,8,0,34,22,61,120,79,122,5424
516,516,0,206,310,1964,1006,393200,199,317,38.57,61.43,89,138,18,18,252,18,175,55,44,0,12,22,108,70,11,5425
448,431,17,323,108,1974,840,166200,435,13,97.10,2.90,24,4,141,49,256,19,11,48,22,0,0,272,68,0,0,5426
389,389,0,190,199,1944,813,140500,225,164,57.84,42.16,61,97,41,79,213,0,211,81,0,0,0,117,48,0,0,5427
635,516,119,429,87,1967,0,317200,531,104,83.62,16.38,134,92,78,36,176,0,60,12,0,0,15,131,136,55,60,5428
970,916,54,775,141,1980,1438,313300,949,21,97.84,2.16,275,193,246,114,331,0,13,73,0,0,0,319,293,150,92,5429
788,604,184,567,37,1985,948,332600,732,56,92.89,7.11,210,144,64,46,156,0,42,38,0,0,23,96,162,59,110,5430
490,388,102,298,90,1992,774,310800,379,111,77.35,22.65,185,24,91,0,132,18,16,12,0,0,0,141,92,12,23,5431
886,820,66,412,408,1977,1235,419800,527,359,59.48,40.52,172,100,87,23,434,0,130,28,35,90,3,33,124,198,82,5432
763,707,56,395,312,1981,1464,410600,504,259,66.06,33.94,86,145,49,29,366,0,102,141,15,36,0,0,122,124,104,5433
455,430,25,328,102,1954,879,388200,387,68,85.05,14.95,182,9,36,62,297,27,93,9,49,19,0,0,115,85,174,5434
716,674,42,305,369,1983,1236,327800,337,379,47.07,52.93,165,298,14,59,196,0,72,75,0,0,114,29,141,130,119,5435
595,548,47,72,476,1985,1055,0,72,523,12.10,87.90,90,260,452,15,0,33,539,128,0,0,0,18,0,53,18,5436
1202,675,527,459,216,1986,719,277200,720,482,59.90,40.10,448,237,75,91,231,35,104,5,0,0,29,127,135,53,33,5437
1158,704,454,511,193,2000,593,167600,542,616,46.80,53.20,592,110,143,34,31,15,47,0,0,0,148,190,60,11,11,5438
647,581,66,502,79,1981,584,385800,576,71,89.03,10.97,200,64,146,78,183,0,30,0,0,0,94,66,166,49,195,5439
14,14,0,4,10,0,0,0,10,4,71.43,28.57,10,0,0,0,0,0,0,0,0,0,0,0,0,0,10,5440
477,477,0,322,155,1982,921,313800,372,105,77.99,22.01,24,190,131,89,36,6,67,70,17,0,20,55,149,31,55,5441
558,536,22,338,198,1969,1271,313300,387,171,69.35,30.65,188,73,87,141,126,9,94,38,46,37,0,104,129,7,43,5442
730,638,92,341,297,1993,840,224700,334,396,45.75,54.25,166,68,259,19,142,19,300,21,0,0,35,132,86,10,0,5443
326,326,0,200,126,1983,1838,259200,326,0,100.00,0.00,31,159,83,41,13,0,0,13,56,0,0,64,194,0,0,5444
421,421,0,283,138,1985,0,339000,421,0,100.00,0.00,32,146,117,54,64,0,47,39,0,13,0,16,201,51,32,5445
249,249,0,222,27,1986,0,1537500,249,0,100.00,0.00,73,54,41,15,46,0,0,0,0,15,0,0,14,12,188,5446
689,592,97,569,23,1990,0,597900,680,9,98.69,1.31,325,193,133,0,8,0,0,0,20,31,0,15,22,117,382,5447
338,313,25,184,129,1981,1203,363600,318,20,94.08,5.92,117,84,34,10,45,0,13,0,10,10,20,28,67,12,116,5448
497,423,74,208,215,1939,706,160000,362,135,72.84,27.16,36,0,26,7,465,10,65,12,0,0,33,196,64,0,20,5449
354,354,0,284,70,1970,1718,352500,346,8,97.74,2.26,50,130,11,74,80,0,10,15,31,0,9,27,71,103,79,5450
703,585,118,541,44,1990,1354,245000,656,47,93.31,6.69,256,97,154,17,15,0,37,12,0,0,17,241,97,131,4,5451
930,864,66,473,391,1986,1192,187600,489,441,52.58,47.42,233,421,97,43,21,0,33,163,18,0,84,245,191,0,13,5452
349,349,0,247,102,1954,950,260500,285,64,81.66,18.34,67,27,25,59,149,0,12,73,0,0,0,120,75,10,0,5453
383,366,17,300,66,1965,2663,591100,383,0,100.00,0.00,55,0,114,166,70,0,0,8,21,0,0,0,10,33,287,5454
737,711,26,507,204,1974,979,260300,598,139,81.14,18.86,81,19,59,28,409,26,12,77,45,0,0,106,197,44,41,5455
667,515,152,338,177,1978,767,365100,451,216,67.62,32.38,138,123,133,155,243,0,29,21,0,0,122,193,160,43,49,5456
1223,1012,211,684,328,1989,849,279600,865,358,70.73,29.27,400,192,136,92,430,97,76,113,0,0,8,244,328,53,54,5457
438,410,28,141,269,1976,1087,183500,291,147,66.44,33.56,95,35,75,37,199,0,106,68,4,0,22,135,47,0,0,5458
398,294,104,163,131,1975,569,152100,257,141,64.57,35.43,92,44,95,20,245,62,8,0,0,0,18,144,40,0,0,5459
394,270,124,26,244,1939,494,144100,57,337,14.47,85.53,14,0,98,20,447,236,188,0,0,0,9,26,0,0,13,5460
310,69,241,69,0,1982,0,0,255,55,82.26,17.74,225,0,138,10,189,26,28,41,0,0,36,37,61,0,57,5461
1007,974,33,822,152,1994,1134,229000,934,73,92.75,7.25,611,110,132,18,14,0,29,12,21,0,23,408,334,12,19,5462
315,315,0,200,115,1939,854,132400,271,44,86.03,13.97,0,34,40,35,258,34,71,39,0,0,35,132,18,0,0,5463
1030,859,171,12,847,1939,544,0,12,1018,1.17,98.83,38,25,220,59,732,462,291,37,0,0,0,13,0,0,8,5464
330,284,46,226,58,1959,1008,164800,330,0,100.00,0.00,59,15,17,44,138,0,9,16,0,0,23,183,25,17,0,5465
1861,1813,48,1658,155,2000,1357,309200,1777,84,95.49,4.51,949,129,193,39,94,0,25,12,0,0,127,325,518,212,148,5466
1461,1352,109,1093,259,2001,1029,203200,1134,327,77.62,22.38,736,98,168,47,130,32,32,32,22,0,165,529,220,30,23,5467
647,453,194,313,140,1978,955,397400,506,141,78.21,21.79,301,94,130,25,308,0,122,15,0,0,23,95,124,34,133,5468
377,377,0,335,42,1972,767,243300,319,58,84.62,15.38,149,57,88,29,47,0,14,0,0,15,0,95,112,19,37,5469
535,483,52,429,54,1979,1575,344200,535,0,100.00,0.00,146,66,81,117,0,0,12,6,0,0,0,29,233,84,46,5470
581,488,93,449,39,1994,1639,201600,506,75,87.09,12.91,219,144,102,71,46,20,38,19,0,0,33,155,165,102,21,5471
288,288,0,280,8,1985,0,383500,288,0,100.00,0.00,41,168,7,0,12,0,0,7,0,0,0,11,15,108,87,5472
840,820,20,673,147,1992,1507,333500,775,65,92.26,7.74,266,221,148,42,154,0,64,12,56,0,0,16,329,203,151,5473
321,321,0,254,67,1953,720,138000,277,44,86.29,13.71,103,19,134,0,245,36,80,0,0,0,28,269,15,19,12,5474
506,469,37,434,35,1969,2163,674300,491,15,97.04,2.96,132,64,109,160,58,0,0,0,10,27,0,0,8,54,424,5475
359,359,0,235,124,1960,900,343900,314,45,87.47,12.53,36,92,116,13,128,0,16,66,36,0,11,0,222,34,0,5476
391,391,0,221,170,1939,949,397300,325,66,83.12,16.88,51,0,19,25,241,0,125,0,15,0,0,0,95,28,40,5477
488,488,0,477,11,1939,0,602500,488,0,100.00,0.00,24,0,10,21,465,0,0,0,0,10,40,12,32,102,295,5478
901,847,54,800,47,1997,1047,278800,899,2,99.78,0.22,475,205,108,21,15,0,22,0,0,13,22,220,401,80,63,5479
836,836,0,468,368,1954,833,141000,714,122,85.41,14.59,8,17,52,73,620,13,142,36,0,0,11,522,46,0,0,5480
748,601,147,318,283,1955,673,101500,651,97,87.03,12.97,113,14,107,15,402,35,177,43,0,0,41,254,0,0,7,5481
568,531,37,177,354,1977,407,122300,241,327,42.43,57.57,76,33,174,0,164,171,49,0,0,0,37,65,40,0,0,5482
341,302,39,137,165,1986,652,179300,168,173,49.27,50.73,144,138,54,6,90,0,80,0,14,0,109,130,99,0,0,5483
674,662,12,598,64,1987,0,181500,438,236,64.99,35.01,198,142,203,47,263,32,116,0,0,0,146,333,63,17,0,5484
615,561,54,334,227,1939,1281,790300,390,225,63.41,36.59,70,14,21,31,541,0,35,89,17,53,0,30,0,57,364,5485
535,535,0,369,166,1939,1171,1117000,347,188,64.86,35.14,28,0,27,100,411,0,27,114,118,14,0,0,14,13,237,5486
637,611,26,241,370,1971,1088,257400,308,329,48.35,51.65,0,140,99,59,230,12,253,65,0,0,0,107,91,0,0,5487
305,305,0,211,94,1979,1191,506400,223,82,73.11,26.89,22,52,204,27,26,0,53,21,0,0,0,11,50,87,109,5488
660,660,0,605,55,1988,1863,685100,623,37,94.39,5.61,358,106,218,54,0,0,0,0,13,30,19,0,93,138,425,5489
881,317,564,302,15,1992,0,396700,751,130,85.24,14.76,233,177,113,78,16,0,0,0,0,0,69,130,40,0,88,5490
333,333,0,184,149,1981,1138,367700,280,53,84.08,15.92,58,97,90,25,71,0,82,17,0,0,14,24,49,61,32,5491
557,557,0,495,62,1978,0,188800,468,89,84.02,15.98,115,143,117,95,7,74,75,54,0,0,0,121,114,0,15,5492
655,555,100,81,474,1961,745,170300,344,311,52.52,47.48,27,62,197,89,240,76,251,52,41,0,0,122,11,10,0,5493
799,776,23,725,51,1976,0,299800,799,0,100.00,0.00,202,30,46,85,159,0,0,5,0,0,3,71,235,76,63,5494
588,588,0,311,277,1949,1646,723400,460,128,78.23,21.77,73,45,30,62,418,0,39,141,127,42,0,28,28,56,167,5495
502,473,29,334,139,1953,970,215200,440,62,87.65,12.35,19,21,10,88,345,0,47,51,24,0,0,122,163,29,20,5496
1504,703,801,568,135,1996,884,311500,1170,334,77.79,22.21,405,58,35,24,639,26,27,38,10,17,23,202,126,22,54,5497
518,518,0,411,107,1982,1375,309100,483,35,93.24,6.76,35,183,21,59,37,0,33,64,0,0,7,14,147,47,0,5498
400,311,89,216,95,1984,1505,197000,377,23,94.25,5.75,141,0,193,97,0,0,55,0,0,0,0,109,211,0,13,5499
422,395,27,254,141,1951,1238,277700,312,110,73.93,26.07,27,40,10,30,229,0,57,20,10,0,20,20,161,20,0,5500
555,507,48,417,90,1944,1679,412700,547,8,98.56,1.44,112,0,25,25,348,0,0,17,55,10,0,37,127,68,154,5501
543,543,0,350,193,1950,1578,426700,543,0,100.00,0.00,11,0,29,19,414,0,0,0,0,41,0,27,110,110,185,5502
631,601,30,223,378,1981,846,229500,342,289,54.20,45.80,251,143,214,53,20,12,130,97,36,0,0,148,168,37,0,5503
606,568,38,458,110,1979,833,334900,516,90,85.15,14.85,241,32,106,63,168,13,55,25,0,0,16,101,205,50,73,5504
719,591,128,489,102,1978,825,340100,565,154,78.58,21.42,174,98,113,52,174,35,26,0,0,0,61,60,116,147,126,5505
505,505,0,311,194,1982,1117,213100,237,268,46.93,53.07,22,311,176,14,16,0,176,48,0,0,0,61,168,17,0,5506
330,330,0,266,64,1978,981,298900,266,64,80.61,19.39,36,57,26,37,49,0,33,0,0,0,0,39,100,4,29,5507
454,340,114,10,330,1984,971,0,146,308,32.16,67.84,128,130,59,0,61,46,78,20,9,4,0,26,78,0,0,5508
622,558,64,532,26,1995,0,535600,558,64,89.71,10.29,589,75,11,0,11,0,0,0,20,33,9,0,105,96,380,5509
1233,1071,162,487,584,1993,1418,445300,228,1005,18.49,81.51,607,359,131,18,166,33,38,171,267,66,0,28,217,122,288,5510
617,551,66,262,289,1994,1261,278900,265,352,42.95,57.05,458,126,46,56,32,0,150,118,35,0,0,111,146,0,25,5511
344,344,0,175,169,1939,1353,469100,255,89,74.13,25.87,58,0,0,11,335,9,0,26,130,0,0,0,63,55,121,5512
364,364,0,230,134,1939,1750,506900,329,35,90.38,9.62,28,0,0,0,312,0,0,13,3,0,0,0,26,72,162,5513
751,628,123,520,108,1977,1042,210100,634,117,84.42,15.58,133,79,55,70,193,6,60,6,0,0,37,353,38,20,10,5514
329,329,0,269,60,1965,925,207300,329,0,100.00,0.00,97,20,105,106,96,0,14,9,13,0,31,275,73,0,9,5515
394,373,21,212,161,1976,1158,243300,237,157,60.15,39.85,111,83,118,40,65,10,72,74,34,16,21,45,73,8,36,5516
916,896,20,496,400,1976,1146,381100,376,540,41.05,58.95,32,209,265,325,108,12,31,98,37,12,0,107,114,140,195,5517
275,228,47,228,0,1992,0,346300,196,79,71.27,28.73,140,48,0,0,0,0,0,0,0,0,0,74,62,28,24,5518
1012,945,67,480,465,1973,1082,366700,291,721,28.75,71.25,110,61,450,40,236,40,104,128,16,18,12,113,167,21,202,5519
338,295,43,262,33,1985,1467,298500,297,41,87.87,12.13,191,108,119,18,73,0,0,12,72,0,0,42,145,115,77,5520
555,555,0,370,185,1974,794,284400,411,144,74.05,25.95,165,59,88,77,88,14,55,40,0,0,30,84,120,89,45,5521
324,317,7,230,87,1952,745,172600,251,73,77.47,22.53,87,0,53,80,257,11,38,27,0,0,31,135,139,10,35,5522
543,494,49,431,63,1990,1645,321600,468,75,86.19,13.81,190,175,20,13,89,0,15,51,0,13,15,71,105,17,106,5523
619,595,24,562,33,1993,0,253200,503,116,81.26,18.74,276,39,172,60,57,0,60,56,0,0,66,139,146,41,44,5524
978,887,91,189,698,1991,1459,434300,212,766,21.68,78.32,582,284,37,0,0,0,82,341,24,205,0,0,0,43,208,5525
652,652,0,273,379,1963,1322,499000,194,458,29.75,70.25,28,82,150,195,277,0,140,189,40,16,0,29,54,130,98,5526
587,540,47,520,20,1987,0,311600,587,0,100.00,0.00,162,121,37,18,8,0,0,10,0,0,0,30,155,54,83,5527
1343,1286,57,1049,237,2003,1623,338700,1289,54,95.98,4.02,431,67,57,56,112,0,31,10,9,0,7,107,178,140,193,5528
1096,994,102,866,128,1995,1137,172300,928,168,84.67,15.33,776,73,152,120,122,76,110,71,9,0,97,329,327,77,56,5529
555,453,102,316,137,1977,932,191500,388,167,69.91,30.09,44,73,126,6,50,16,50,8,0,0,18,132,58,0,17,5530
1093,1051,42,165,886,1993,1042,169400,266,827,24.34,75.66,740,350,65,0,14,0,493,341,0,0,0,47,68,29,22,5531
212,183,29,101,82,1969,1079,275000,131,81,61.79,38.21,35,9,12,95,90,9,55,36,0,0,9,25,54,13,0,5532
674,674,0,561,113,1973,0,377700,645,29,95.70,4.30,225,64,131,40,124,0,0,12,0,0,10,75,192,125,137,5533
676,621,55,409,212,1977,1245,448900,481,195,71.15,28.85,157,189,200,100,32,0,110,231,29,0,0,10,59,87,123,5534
581,581,0,344,237,1943,1481,471200,478,103,82.27,17.73,68,0,71,0,465,0,84,61,13,0,0,34,62,141,209,5535
701,634,67,453,181,1991,1118,252400,567,134,80.88,19.12,333,200,102,14,20,0,128,104,0,21,21,90,226,0,79,5536
1026,945,81,677,268,1992,1132,163000,852,174,83.04,16.96,684,124,172,55,91,0,119,86,12,0,178,546,58,0,0,5537
329,329,0,65,264,1977,906,172900,104,225,31.61,68.39,0,39,98,57,58,0,155,23,0,0,0,24,50,0,0,5538
658,644,14,551,93,1993,2148,456600,617,41,93.77,6.23,309,159,108,32,19,0,0,23,22,0,0,35,43,172,266,5539
982,954,28,747,207,1985,1760,278000,973,9,99.08,0.92,438,201,241,99,0,0,0,11,71,64,0,106,554,43,64,5540
693,647,46,618,29,1986,0,345900,633,60,91.34,8.66,276,24,108,87,77,0,62,39,0,0,7,66,68,80,199,5541
1411,1257,154,415,842,1995,1314,291400,299,1112,21.19,78.81,930,139,152,0,36,0,190,538,134,6,93,0,60,26,106,5542
1614,1066,548,821,245,1988,1719,257800,1436,178,88.97,11.03,595,239,533,49,18,0,86,84,64,10,0,290,420,33,115,5543
499,489,10,394,95,1939,1378,191800,482,17,96.59,3.41,11,63,22,8,543,39,72,44,6,0,0,224,160,0,0,5544
844,804,40,466,338,1970,741,152900,475,369,56.28,43.72,24,120,355,178,47,11,237,8,0,0,11,342,26,0,17,5545
572,555,17,384,171,1974,2056,512400,495,77,86.54,13.46,0,151,160,125,0,0,21,51,26,0,0,0,137,114,87,5546
847,735,112,443,292,1987,731,240800,574,273,67.77,32.23,166,183,197,70,63,26,75,34,4,0,51,155,214,38,38,5547
629,629,0,491,138,1975,1145,178700,370,259,58.82,41.18,131,108,188,120,27,0,25,36,40,0,186,75,112,8,12,5548
305,265,40,254,11,1973,0,375000,256,49,83.93,16.07,67,115,96,16,52,0,66,0,0,0,77,20,56,33,66,5549
625,524,101,0,524,1983,1172,0,0,625,0.00,100.00,67,236,91,159,5,24,282,116,24,0,0,0,0,0,0,5550
548,429,119,357,72,1987,1265,408100,481,67,87.77,12.23,257,52,112,37,81,14,55,0,5,0,0,19,113,71,162,5551
313,259,54,121,138,1951,936,121400,239,74,76.36,23.64,108,10,109,20,176,24,82,4,3,12,23,143,54,4,0,5552
494,449,45,319,130,1995,1213,225000,414,80,83.81,16.19,475,27,38,22,35,0,17,72,76,0,12,207,95,0,0,5553
293,293,0,231,62,1979,1454,384400,293,0,100.00,0.00,95,26,138,17,16,0,0,0,0,33,8,9,74,108,48,5554
803,709,94,564,145,1988,1114,322000,570,233,70.98,29.02,344,252,30,32,171,0,25,81,0,0,21,157,216,143,97,5555
438,312,126,255,57,1942,537,142700,367,71,83.79,16.21,38,30,28,39,289,32,47,0,0,0,111,154,11,0,0,5556
111,111,0,75,36,1997,0,242500,93,18,83.78,16.22,33,0,39,16,40,0,0,0,0,0,41,74,0,0,0,5557
343,343,0,244,99,1988,1284,319600,269,74,78.43,21.57,135,107,73,14,6,0,11,20,0,0,39,38,79,68,70,5558
773,707,66,402,305,1975,1183,352000,269,504,34.80,65.20,135,92,153,179,83,0,71,83,26,39,39,84,66,9,122,5559
560,530,30,417,113,1986,1233,224800,506,54,90.36,9.64,192,109,121,71,79,3,35,45,44,0,0,133,205,40,12,5560
455,455,0,354,101,1992,2125,336800,356,99,78.24,21.76,306,10,18,0,136,0,22,29,0,0,0,10,123,71,184,5561
547,490,57,279,211,1978,646,118600,310,237,56.67,43.33,68,65,64,71,280,53,109,0,0,0,71,127,20,3,8,5562
762,311,451,167,144,1994,632,248800,526,236,69.03,30.97,425,101,93,46,62,37,11,14,0,0,12,83,34,34,17,5563
653,624,29,559,65,1982,1309,288400,477,176,73.05,26.95,193,71,171,42,91,0,40,14,42,0,22,60,215,74,52,5564
1160,1046,114,674,372,2000,1081,241300,886,274,76.38,23.62,327,141,217,190,121,46,74,78,8,0,44,272,213,75,50,5565
512,445,67,350,95,1949,733,185900,426,86,83.20,16.80,58,18,55,68,317,59,80,24,0,0,87,209,10,5,0,5566
553,508,45,263,245,1959,1180,190900,353,200,63.83,36.17,168,49,19,29,123,0,18,0,0,0,19,223,99,29,0,5567
401,401,0,308,93,1991,0,233300,179,222,44.64,55.36,281,62,39,10,30,0,0,52,36,0,11,150,79,32,41,5568
208,208,0,180,28,1993,0,335700,187,21,89.90,10.10,114,58,48,11,47,11,4,0,0,0,8,29,37,46,107,5569
883,779,104,384,395,1966,1158,602400,408,475,46.21,53.79,120,69,152,75,317,0,215,50,44,21,0,0,114,37,213,5570
1425,1328,97,1092,236,1982,1000,400800,1142,283,80.14,19.86,687,61,289,91,275,50,81,37,0,0,107,146,412,148,345,5571
555,555,0,220,335,1973,1362,332500,361,194,65.05,34.95,102,132,60,24,305,52,240,89,24,0,0,68,86,37,27,5572
729,687,42,641,46,2001,933,335400,604,125,82.85,17.15,471,122,21,0,12,0,23,0,0,0,39,121,215,35,0,5573
329,282,47,208,74,1955,0,182100,289,40,87.84,12.16,101,38,54,16,83,0,14,49,0,0,23,129,32,11,0,5574
491,491,0,303,188,1973,918,199000,374,117,76.17,23.83,44,35,225,108,35,10,267,0,0,0,10,107,53,0,0,5575
1247,1175,72,908,267,1974,1156,173200,1064,183,85.32,14.68,229,187,483,183,121,0,171,55,43,0,55,785,0,0,0,5576
720,610,110,64,546,1970,779,203100,117,603,16.25,83.75,204,39,162,52,142,20,392,72,0,0,0,50,39,0,0,5577
350,350,0,339,11,1989,0,333400,316,34,90.29,9.71,59,22,44,126,0,0,0,0,0,0,4,39,56,109,43,5578
500,500,0,442,58,1974,2108,381100,443,57,88.60,11.40,240,53,105,54,143,0,15,27,0,0,19,20,193,181,140,5579
517,495,22,470,25,1984,1425,483700,472,45,91.30,8.70,131,153,121,55,39,0,0,0,17,0,0,10,54,110,308,5580
1033,971,62,325,646,1991,1064,0,183,850,17.72,82.28,387,163,199,162,88,44,305,121,0,0,227,61,134,69,0,5581
7,7,0,7,0,0,0,0,7,0,100.00,0.00,25,0,23,23,0,18,0,0,12,0,0,0,25,0,0,5582
1467,1127,340,997,130,1989,1289,290300,1358,109,92.57,7.43,624,119,154,31,97,0,11,54,32,0,17,432,149,27,137,5583
568,568,0,329,239,1974,681,238100,453,115,79.75,20.25,175,61,195,63,53,0,179,25,0,0,14,189,85,28,13,5584
947,807,140,705,102,1982,728,220900,713,234,75.29,24.71,178,125,295,31,123,7,107,13,0,0,106,273,79,6,15,5585
1176,634,542,320,314,1987,591,160200,686,490,58.33,41.67,250,110,307,75,256,164,145,0,0,0,38,157,79,0,21,5586
734,465,269,337,128,1991,507,390300,641,93,87.33,12.67,268,114,84,55,51,73,6,6,0,0,26,51,58,10,230,5587
695,695,0,209,486,1957,842,128000,504,191,72.52,27.48,7,9,127,0,359,16,98,64,0,0,36,217,7,0,0,5588
568,522,46,378,144,1970,1003,161700,537,31,94.54,5.46,98,36,134,18,179,11,56,62,8,0,10,292,12,7,0,5589
419,338,81,293,45,1980,0,170900,205,214,48.93,51.07,102,162,96,0,141,10,57,0,0,0,73,119,157,21,12,5590
666,564,102,242,322,2001,1203,283200,322,344,48.35,51.65,38,0,113,67,298,21,97,11,29,0,41,111,182,13,0,5591
1164,1078,86,200,878,1991,1173,319400,183,981,15.72,84.28,189,227,110,87,295,75,186,203,91,0,0,31,55,29,58,5592
471,471,0,155,316,1979,741,356600,250,221,53.08,46.92,61,12,11,115,263,11,68,54,33,0,0,0,171,13,0,5593
465,465,0,351,114,1953,1435,613100,465,0,100.00,0.00,82,51,59,14,300,0,102,14,12,15,0,17,64,63,162,5594
563,526,37,258,268,1939,776,490100,387,176,68.74,31.26,122,34,0,27,446,54,90,52,46,0,0,0,56,94,237,5595
771,705,66,577,128,1939,1161,633700,714,57,92.61,7.39,58,15,15,10,595,0,28,0,44,0,12,0,64,63,362,5596
391,306,85,182,124,1978,610,159200,212,179,54.22,45.78,22,53,94,55,28,70,14,0,0,0,10,10,10,0,13,5597
581,355,226,240,115,1995,418,369700,424,157,72.98,27.02,203,14,50,16,107,0,0,16,0,0,103,45,77,26,0,5598
446,145,301,134,11,1983,0,173500,340,106,76.23,23.77,135,34,112,32,46,0,16,4,0,0,20,27,24,33,40,5599
764,682,82,277,405,1939,635,126200,447,317,58.51,41.49,83,129,111,27,384,55,361,11,0,0,51,194,18,0,0,5600
434,339,95,39,300,1939,596,126600,176,258,40.55,59.45,0,24,35,10,347,116,136,17,0,0,33,82,0,0,0,5601
601,601,0,487,114,1978,1575,199400,586,15,97.50,2.50,119,163,208,0,0,0,0,55,30,0,0,84,272,0,0,5602
1531,798,733,494,304,1984,860,583300,1323,208,86.41,13.59,438,211,252,87,309,0,126,100,0,12,47,72,83,48,210,5603
631,452,179,379,73,1979,0,296800,519,112,82.25,17.75,228,52,150,22,43,0,10,21,0,0,10,33,101,14,128,5604
1248,1189,59,743,446,1991,1262,237800,1053,195,84.38,15.63,555,172,183,85,71,0,60,55,26,0,14,299,405,20,55,5605
894,792,102,527,265,1988,598,137600,509,385,56.94,43.06,229,112,267,12,168,58,86,12,0,0,105,352,56,14,28,5606
992,926,66,857,69,1993,1088,330400,927,65,93.45,6.55,269,164,155,60,156,0,47,61,0,0,37,139,274,142,90,5607
300,276,24,197,79,1982,1024,117000,201,99,67.00,33.00,98,66,126,5,10,75,24,3,0,0,49,98,21,5,12,5608
368,360,8,303,57,1969,1276,469300,368,0,100.00,0.00,172,22,84,46,88,0,25,63,0,0,9,29,64,71,151,5609
213,213,0,131,82,1964,1380,197100,158,55,74.18,25.82,15,14,80,95,134,0,43,43,0,0,0,236,16,0,0,5610
569,569,0,322,247,1960,830,191100,438,131,76.98,23.02,31,48,62,87,314,6,89,27,0,0,26,249,134,0,11,5611
453,303,150,140,163,1959,642,75200,294,159,64.90,35.10,10,7,65,87,216,13,27,34,0,0,125,44,0,0,8,5612
764,671,93,224,447,1985,957,241500,272,492,35.60,64.40,280,298,152,52,53,81,326,100,5,9,0,57,110,16,54,5613
612,596,16,571,25,1975,0,643300,598,14,97.71,2.29,202,101,114,67,177,41,33,14,0,14,14,29,45,64,393,5614
354,296,58,144,152,1958,868,280500,262,92,74.01,25.99,52,23,63,46,185,25,29,0,0,0,12,57,40,78,0,5615
1545,920,625,791,129,1977,1478,146300,1109,436,71.78,28.22,344,355,250,174,490,0,45,0,0,0,61,231,13,14,31,5616
940,721,219,661,60,1991,840,207600,929,11,98.83,1.17,488,220,148,137,7,0,114,42,0,0,11,254,238,25,29,5617
826,600,226,497,103,1990,1013,267700,725,101,87.77,12.23,340,62,78,0,8,0,13,28,0,0,0,175,66,0,69,5618
348,348,0,323,25,1992,1396,258100,339,9,97.41,2.59,160,0,183,0,0,0,0,0,0,0,0,54,163,82,44,5619
276,276,0,263,13,1965,0,224000,276,0,100.00,0.00,20,12,28,157,92,8,13,0,0,0,14,211,39,13,11,5620
277,277,0,237,40,1939,1132,332200,217,60,78.34,21.66,8,55,10,0,232,0,77,28,11,0,0,16,54,44,75,5621
880,356,524,314,42,1983,1023,422000,799,81,90.80,9.20,227,108,105,107,161,0,29,25,0,0,12,26,79,28,147,5622
424,276,148,161,115,1986,1059,228300,313,111,73.82,26.18,215,63,69,0,210,0,32,27,0,0,13,151,71,21,15,5623
642,606,36,234,372,1977,756,224500,238,404,37.07,62.93,126,64,95,79,225,25,322,17,0,0,11,97,33,10,11,5624
457,374,83,261,113,1963,922,281900,334,123,73.09,26.91,152,201,63,28,160,0,99,0,0,0,2,81,82,68,156,5625
429,401,28,255,146,1979,1520,149800,399,30,93.01,6.99,175,69,150,14,109,0,40,26,15,0,14,144,45,0,39,5626
300,286,14,159,127,1970,680,110100,263,37,87.67,12.33,65,54,22,46,111,2,47,2,5,0,89,113,17,0,0,5627
265,265,0,189,76,1953,774,213100,233,32,87.92,12.08,93,8,0,20,153,0,55,74,0,0,31,78,26,0,0,5628
172,145,27,35,110,1939,657,163300,45,127,26.16,73.84,0,10,29,11,165,48,80,30,10,0,0,30,0,0,0,5629
1190,1190,0,711,479,1990,1054,209300,780,410,65.55,34.45,934,140,189,12,43,0,269,82,0,0,132,381,342,24,49,5630
416,416,0,322,94,1976,794,148300,258,158,62.02,37.98,60,65,158,59,128,45,83,0,0,0,69,188,39,9,15,5631
657,494,163,369,125,1968,658,147000,495,162,75.34,24.66,153,78,83,5,280,24,16,10,0,0,56,131,89,8,38,5632
225,225,0,69,156,1984,910,95800,42,183,18.67,81.33,0,36,83,23,39,0,73,0,0,0,36,42,0,0,0,5633
524,422,102,369,53,1979,588,218500,361,163,68.89,31.11,263,48,112,5,83,16,0,11,0,0,118,121,116,43,37,5634
966,966,0,900,66,1992,1335,249000,950,16,98.34,1.66,634,62,227,0,0,0,9,36,0,0,60,217,470,98,33,5635
1066,974,92,883,91,1991,950,314800,1002,64,94.00,6.00,433,194,187,166,125,0,173,32,0,0,0,305,138,55,319,5636
900,499,401,389,110,1987,1135,422300,837,63,93.00,7.00,255,167,108,20,50,0,12,43,17,0,3,31,110,52,205,5637
790,777,13,717,60,1984,724,329800,728,62,92.15,7.85,322,190,270,72,132,34,48,0,0,0,31,198,374,99,157,5638
942,866,76,777,89,1977,0,200200,872,70,92.57,7.43,107,74,393,40,44,0,0,0,0,0,30,403,88,74,16,5639
485,462,23,156,306,1977,702,199000,257,228,52.99,47.01,123,60,108,107,71,138,136,0,0,0,0,81,59,0,0,5640
471,471,0,183,288,1984,832,0,96,375,20.38,79.62,113,88,249,23,30,66,142,0,0,23,71,81,16,0,9,5641
381,358,23,317,41,1988,0,274600,374,7,98.16,1.84,143,130,64,9,16,0,12,0,0,0,0,36,179,135,0,5642
935,935,0,0,935,1980,777,0,49,886,5.24,94.76,541,218,345,114,11,154,827,53,0,0,46,0,0,0,0,5643
389,389,0,210,179,1967,2145,224500,155,234,39.85,60.15,67,157,6,70,20,20,8,0,0,0,3,14,211,20,10,5644
292,279,13,173,106,1959,1269,228000,243,49,83.22,16.78,32,0,16,99,233,0,13,30,0,0,0,102,235,0,0,5645
462,462,0,445,17,1985,0,239300,383,79,82.90,17.10,236,111,316,41,40,0,0,0,0,15,137,96,139,40,51,5646
553,472,81,389,83,1975,0,197600,470,83,84.99,15.01,272,15,90,59,109,0,89,0,0,0,0,323,72,15,0,5647
1312,965,347,7,958,2000,671,0,62,1250,4.73,95.27,758,207,365,24,28,124,897,79,7,0,0,0,0,0,0,5648
503,493,10,408,85,1992,1234,353700,440,63,87.48,12.52,192,82,97,18,64,0,0,0,0,0,9,55,102,10,195,5649
523,478,45,404,74,2002,0,320000,489,34,93.50,6.50,250,65,68,24,0,0,0,28,0,0,0,32,114,93,140,5650
590,590,0,529,61,1981,1359,168800,590,0,100.00,0.00,65,167,294,42,21,0,16,80,0,0,17,421,49,0,6,5651
498,461,37,415,46,1989,2205,377600,491,7,98.59,1.41,133,181,68,10,19,0,10,17,0,0,15,52,143,83,91,5652
1185,1185,0,1026,159,2004,1604,448800,1171,14,98.82,1.18,637,14,15,131,113,0,0,24,0,51,0,37,178,294,291,5653
477,477,0,434,43,1978,2489,613400,470,7,98.53,1.47,73,151,277,108,0,0,0,0,7,0,30,0,37,39,433,5654
336,336,0,279,57,1982,0,259800,336,0,100.00,0.00,81,149,121,39,5,0,20,0,10,0,11,106,210,6,0,5655
459,402,57,368,34,1975,1853,239000,459,0,100.00,0.00,0,33,256,92,0,0,0,20,55,23,0,116,159,8,0,5656
453,453,0,281,172,1954,608,233200,353,100,77.92,22.08,0,32,90,38,347,57,116,15,0,0,84,159,45,14,17,5657
224,224,0,61,163,1984,969,152700,74,150,33.04,66.96,57,14,126,0,10,0,148,0,0,0,0,22,0,0,13,5658
567,449,118,406,43,1998,0,277100,567,0,100.00,0.00,373,10,59,10,0,0,0,0,0,0,0,206,228,0,18,5659
369,326,43,290,36,1979,1014,195300,240,129,65.04,34.96,134,95,73,55,32,34,65,9,0,0,22,68,86,33,0,5660
458,395,63,282,113,1978,823,195000,253,205,55.24,44.76,76,90,128,123,92,26,38,0,0,0,142,124,34,10,55,5661
693,665,28,429,236,1965,1125,170600,611,82,88.17,11.83,184,27,184,23,250,24,59,71,0,0,0,340,115,0,10,5662
446,376,70,257,119,1939,730,125800,402,44,90.13,9.87,69,0,23,34,257,12,28,0,0,0,114,100,18,2,18,5663
468,468,0,380,88,1974,711,160900,380,88,81.20,18.80,13,30,297,135,140,55,19,19,0,0,111,383,28,0,0,5664
1147,1086,61,951,135,1998,1699,185800,1134,13,98.87,1.13,717,110,71,0,10,0,20,49,0,0,0,790,49,0,0,5665
825,825,0,714,111,1980,1082,558200,725,100,87.88,12.12,298,308,155,260,46,0,9,111,0,19,0,21,159,210,538,5666
470,470,0,459,11,1981,0,397900,462,8,98.30,1.70,141,67,64,49,99,0,0,44,0,0,0,23,43,54,237,5667
821,673,148,187,486,1957,642,118100,308,513,37.52,62.48,75,79,198,0,261,73,237,68,0,0,10,95,16,0,0,5668
420,378,42,271,107,1957,1027,235800,369,51,87.86,12.14,95,23,37,30,171,0,36,49,0,0,9,57,145,16,14,5669
464,464,0,452,12,1988,0,269100,411,53,88.58,11.42,246,83,115,55,15,0,0,15,0,0,0,47,129,146,153,5670
560,480,80,332,148,1948,693,130600,393,167,70.18,29.82,74,24,134,83,231,94,50,2,0,0,107,166,36,0,0,5671
303,282,21,206,76,1994,1000,425600,262,41,86.47,13.53,159,30,88,0,0,0,55,0,0,0,0,68,13,40,73,5672
958,874,84,668,206,1976,1036,143500,795,163,82.99,17.01,219,52,181,139,165,0,190,24,0,0,143,335,0,8,0,5673
885,697,188,517,180,1987,565,123100,560,325,63.28,36.72,370,235,413,81,94,18,131,0,0,0,110,331,56,25,9,5674
800,712,88,564,148,1978,766,184600,515,285,64.38,35.63,193,70,185,73,92,11,82,0,0,0,43,222,145,27,12,5675
241,197,44,137,60,1978,465,76200,175,66,72.61,27.39,52,64,115,32,47,17,5,0,0,0,70,58,15,0,11,5676
513,457,56,377,80,1982,721,346500,383,130,74.66,25.34,241,57,122,10,94,0,14,0,19,0,0,221,108,96,36,5677
397,352,45,247,105,1964,822,144500,334,63,84.13,15.87,95,11,67,8,290,0,124,60,0,0,0,164,49,35,39,5678
955,903,52,709,194,1978,1088,298500,774,181,81.05,18.95,341,139,248,50,150,0,88,34,11,0,192,218,180,104,101,5679
1756,1676,80,1264,412,1994,957,280900,1356,400,77.22,22.78,1074,180,145,38,89,35,285,124,28,0,10,372,510,64,35,5680
549,526,23,433,93,1979,796,162400,384,165,69.95,30.05,28,128,76,18,276,21,85,40,0,0,103,213,52,12,0,5681
759,686,73,431,255,1974,1093,240700,726,33,95.65,4.35,281,118,122,72,243,0,88,92,40,0,30,254,253,46,0,5682
805,751,54,534,217,1991,783,232000,660,145,81.99,18.01,296,260,90,7,177,21,86,19,14,0,27,267,194,103,65,5683
363,363,0,363,0,1996,0,327300,363,0,100.00,0.00,288,0,12,0,0,0,0,0,0,0,10,78,138,67,7,5684
506,506,0,457,49,1975,0,159400,289,217,57.11,42.89,112,39,63,106,145,43,60,53,0,0,80,177,20,0,0,5685
315,315,0,220,95,1978,886,156700,223,92,70.79,29.21,58,134,163,0,0,0,15,44,0,0,0,169,29,0,0,5686
1481,1342,139,1182,160,1991,1370,293400,1366,115,92.23,7.77,742,223,393,0,188,71,30,178,39,0,0,197,746,213,48,5687
1173,1075,98,638,437,2000,884,298500,840,333,71.61,28.39,648,37,186,83,63,0,292,0,34,6,0,45,393,92,98,5688
349,349,0,289,60,1993,1150,271300,324,25,92.84,7.16,225,27,14,11,43,0,0,35,18,0,10,21,161,9,21,5689
382,382,0,275,107,1978,751,182000,259,123,67.80,32.20,147,80,52,15,105,0,67,14,0,5,10,87,83,24,10,5690
624,516,108,350,166,1987,992,291400,449,175,71.96,28.04,350,208,178,76,61,94,263,47,0,14,27,63,117,98,84,5691
453,394,59,251,143,1968,826,155500,368,85,81.24,18.76,62,69,85,37,212,48,120,41,7,0,13,133,10,0,0,5692
788,754,34,718,36,1976,0,404600,751,37,95.30,4.70,197,108,146,115,91,0,10,0,10,0,35,87,202,105,172,5693
678,461,217,415,46,1993,1112,335500,570,108,84.07,15.93,393,71,88,58,46,0,0,19,0,0,14,166,150,52,143,5694
439,439,0,390,49,1967,2181,490600,439,0,100.00,0.00,63,65,16,87,236,0,0,0,0,19,15,13,48,128,232,5695
511,433,78,209,224,1963,813,431700,293,218,57.34,42.66,101,10,38,0,348,21,257,9,0,0,0,15,49,65,19,5696
327,318,9,275,43,1974,0,282600,292,35,89.30,10.70,164,41,187,13,69,0,28,0,0,0,0,192,178,12,64,5697
308,308,0,185,123,1939,1291,166100,278,30,90.26,9.74,16,0,55,15,218,0,0,61,49,0,4,154,0,13,0,5698
589,551,38,205,346,1962,977,238500,254,335,43.12,56.88,106,57,73,152,276,65,293,0,34,0,30,57,144,10,0,5699
683,560,123,234,326,1977,508,134600,425,258,62.23,37.77,105,106,78,52,281,93,48,3,0,0,145,152,31,3,22,5700
442,442,0,349,93,1986,1125,172000,325,117,73.53,26.47,249,60,77,115,0,12,26,59,6,0,60,151,116,0,0,5701
618,588,30,434,154,1984,1216,806500,420,198,67.96,32.04,55,246,73,85,76,0,0,81,47,22,0,0,41,34,310,5702
286,286,0,263,23,1976,0,234100,286,0,100.00,0.00,66,75,101,11,19,0,10,0,11,0,0,57,96,10,11,5703
596,571,25,266,305,1959,769,124700,462,134,77.52,22.48,27,0,82,126,259,106,132,0,21,0,114,102,10,0,0,5704
765,635,130,520,115,1978,1211,359600,696,69,90.98,9.02,240,126,151,41,167,0,38,74,12,0,42,17,189,114,159,5705
1118,1086,32,564,522,1976,960,193100,625,493,55.90,44.10,153,116,565,12,0,44,108,51,14,0,136,368,60,0,23,5706
502,428,74,373,55,1994,1075,406500,366,136,72.91,27.09,316,145,96,0,0,0,84,23,10,0,43,27,175,135,60,5707
1088,1063,25,669,394,1973,684,106300,770,318,70.77,29.23,215,47,458,92,264,113,227,0,0,0,296,253,56,0,0,5708
675,569,106,295,274,1978,1298,260600,385,290,57.04,42.96,185,72,127,108,150,33,143,60,13,0,92,68,178,0,11,5709
1313,1250,63,930,320,1994,1535,346900,700,613,53.31,46.69,1097,62,0,0,45,15,120,202,130,108,16,83,203,233,81,5710
447,447,0,392,55,2002,1656,414500,447,0,100.00,0.00,459,49,0,0,0,0,0,0,65,0,0,40,160,16,227,5711
335,335,0,84,251,1990,690,211800,22,313,6.57,93.43,164,11,0,0,91,16,71,47,0,11,0,20,23,22,13,5712
393,393,0,281,112,1959,1549,564500,323,70,82.19,17.81,23,18,75,57,241,0,28,68,0,0,8,12,8,64,226,5713
349,317,32,237,80,1981,1265,225000,349,0,100.00,0.00,68,128,41,79,121,10,17,42,26,0,0,62,180,17,46,5714
606,606,0,331,275,1959,1133,217900,445,161,73.43,26.57,17,9,107,51,298,0,67,46,0,48,0,162,153,0,6,5715
372,332,40,322,10,1990,0,263600,248,124,66.67,33.33,87,73,58,18,69,24,0,17,0,0,48,50,37,5,55,5716
679,625,54,567,58,2005,1760,291900,543,136,79.97,20.03,508,0,0,0,0,0,12,17,29,0,7,21,312,110,0,5717
566,510,56,390,120,1988,1247,401100,550,16,97.17,2.83,249,81,124,34,47,0,32,46,0,0,0,101,137,34,185,5718
451,428,23,273,155,1990,1281,248000,358,93,79.38,20.62,187,95,59,51,83,8,65,43,3,8,53,64,172,10,25,5719
798,729,69,479,250,1953,836,158500,711,87,89.10,10.90,27,26,121,76,546,37,94,31,0,0,51,468,24,3,12,5720
876,774,102,551,223,1995,1420,212000,780,96,89.04,10.96,469,79,64,35,117,0,11,85,0,0,57,278,146,37,37,5721
483,483,0,369,114,1956,844,232300,474,9,98.14,1.86,19,0,16,83,305,0,31,85,8,0,0,127,161,0,11,5722
336,336,0,256,80,1963,850,169600,315,21,93.75,6.25,0,14,158,76,92,128,56,11,0,0,0,131,0,0,0,5723
675,597,78,545,52,1971,0,311800,675,0,100.00,0.00,135,24,142,111,160,0,42,0,16,0,0,29,185,110,129,5724
825,789,36,687,102,1991,1149,198900,610,215,73.94,26.06,380,135,141,43,79,0,0,28,0,0,171,270,223,38,17,5725
651,567,84,139,428,1971,686,0,246,405,37.79,62.21,21,70,120,62,111,41,204,0,0,0,52,18,0,0,18,5726
1012,980,32,359,621,1978,1083,215200,394,618,38.93,61.07,305,134,243,154,64,63,230,0,177,30,0,249,116,0,0,5727
301,301,0,100,201,1976,590,138900,140,161,46.51,53.49,120,0,76,31,143,33,199,37,0,0,20,47,0,0,0,5728
526,486,40,243,243,1952,945,250500,511,15,97.15,2.85,20,11,78,18,342,36,76,96,0,0,17,66,130,48,0,5729
535,535,0,427,108,1977,1161,302600,535,0,100.00,0.00,99,154,103,169,23,0,39,38,0,0,21,112,282,10,23,5730
477,456,21,349,107,1987,792,224400,365,112,76.52,23.48,103,23,93,9,99,6,14,24,0,0,26,89,84,49,0,5731
513,412,101,261,151,1965,1094,201800,457,56,89.08,10.92,63,16,129,88,122,0,51,52,0,15,0,195,60,0,29,5732
469,469,0,251,218,1972,880,195500,333,136,71.00,29.00,0,0,65,33,77,0,67,0,0,0,12,74,22,0,0,5733
537,517,20,197,320,1951,1048,308900,272,265,50.65,49.35,22,11,21,11,564,0,333,63,0,0,0,61,143,0,0,5734
474,458,16,329,129,1975,1130,244700,462,12,97.47,2.53,167,52,115,0,6,0,0,98,32,0,0,47,149,14,0,5735
642,604,38,187,417,1972,873,194300,277,365,43.15,56.85,136,25,253,99,146,0,345,43,0,0,0,102,62,0,0,5736
446,359,87,359,0,1980,0,273400,446,0,100.00,0.00,0,204,171,0,5,0,0,15,25,0,0,116,206,18,0,5737
838,706,132,205,501,1993,1006,194100,507,331,60.50,39.50,370,80,59,41,74,31,257,17,0,0,0,220,57,12,0,5738
558,502,56,274,228,1959,674,184600,362,196,64.87,35.13,134,134,114,57,261,52,77,16,0,0,74,144,41,72,12,5739
564,530,34,289,241,1959,562,110900,371,193,65.78,34.22,43,50,31,0,340,11,60,9,0,0,185,110,0,0,0,5740
769,723,46,531,192,1992,1500,221700,710,59,92.33,7.67,214,0,239,150,33,37,0,0,0,11,0,224,353,0,0,5741
325,325,0,199,126,1968,824,214900,267,58,82.15,17.85,10,77,54,43,210,0,116,0,0,0,15,170,31,11,0,5742
740,740,0,470,270,1966,753,193400,587,153,79.32,20.68,196,127,131,203,201,217,11,99,133,0,0,344,41,0,13,5743
617,531,86,256,275,1968,691,230400,322,295,52.19,47.81,9,44,88,336,109,0,209,47,0,0,33,124,173,0,0,5744
322,236,86,137,99,1979,1354,228600,229,93,71.12,28.88,65,24,129,6,31,0,0,39,0,0,0,68,93,17,0,5745
313,285,28,148,137,1967,981,193500,237,76,75.72,24.28,31,61,59,11,105,0,47,16,0,0,14,98,16,25,0,5746
537,537,0,79,458,1994,908,19100,17,520,3.17,96.83,393,65,99,0,0,0,407,51,0,0,71,0,0,0,0,5747
333,296,37,153,143,1962,787,222600,193,140,57.96,42.04,4,8,8,34,303,10,69,17,0,0,17,172,55,0,0,5748
306,306,0,131,175,1956,616,156600,164,142,53.59,46.41,40,8,83,14,187,89,128,0,0,0,0,75,0,0,0,5749
409,393,16,118,275,1979,578,0,165,244,40.34,59.66,162,0,168,73,108,23,183,0,0,0,60,69,89,13,0,5750
1123,1079,44,210,869,2003,819,200700,397,726,35.35,64.65,916,6,78,86,204,216,562,110,38,0,0,157,69,0,0,5751
673,592,81,306,286,1986,1237,139500,379,294,56.32,43.68,311,113,211,0,21,8,55,94,75,0,112,283,13,0,0,5752
504,428,76,202,226,1970,1545,270800,311,193,61.71,38.29,121,55,63,258,70,0,151,52,69,28,0,88,168,11,0,5753
611,570,41,313,257,1959,897,144900,488,123,79.87,20.13,180,32,33,92,431,36,129,87,0,0,90,295,21,0,0,5754
2947,2298,649,798,1500,2004,1345,444700,88,2859,2.99,97.01,2451,12,0,16,111,153,601,378,142,89,21,57,269,62,255,5755
1513,1355,158,210,1145,1991,1419,342000,82,1431,5.42,94.58,363,239,101,574,35,0,154,465,99,17,0,51,31,10,45,5756
270,236,34,219,17,1970,0,220600,238,32,88.15,11.85,154,84,85,72,81,0,32,0,23,0,0,69,78,46,10,5757
420,409,11,286,123,1948,1338,229300,389,31,92.62,7.38,21,66,43,51,319,0,106,62,0,0,14,238,42,0,0,5758
552,552,0,486,66,1998,1136,221600,552,0,100.00,0.00,325,21,149,43,11,0,45,0,5,0,0,253,236,0,0,5759
397,301,96,290,11,1986,719,316400,359,38,90.43,9.57,132,13,126,22,54,2,36,0,0,0,9,97,76,35,15,5760
354,318,36,194,124,1939,787,457100,264,90,74.58,25.42,0,0,0,0,344,23,14,56,0,0,0,38,91,57,39,5761
413,374,39,278,96,1960,0,331800,399,14,96.61,3.39,53,13,54,71,74,0,0,0,0,0,0,79,74,30,41,5762
191,191,0,83,108,1964,441,99500,138,53,72.25,27.75,9,25,95,49,170,100,54,0,10,0,65,110,0,9,0,5763
397,366,31,242,124,1975,985,152300,321,76,80.86,19.14,38,109,163,47,33,47,17,0,0,0,27,201,0,0,0,5764
385,367,18,161,206,1962,714,160200,241,144,62.60,37.40,14,5,81,117,254,6,248,0,0,0,0,185,14,0,0,5765
476,476,0,467,9,1959,0,361500,476,0,100.00,0.00,82,36,68,31,211,0,12,17,0,0,0,99,119,106,66,5766
1070,234,836,194,40,1990,592,328600,819,251,76.54,23.46,519,204,216,28,94,0,15,23,0,0,6,42,91,13,36,5767
391,391,0,363,28,1939,0,533300,391,0,100.00,0.00,20,28,0,0,361,0,0,0,0,0,0,12,27,81,243,5768
1088,907,181,764,143,1979,891,164200,722,366,66.36,33.64,334,124,294,138,195,80,95,23,0,0,115,383,105,42,51,5769
527,527,0,409,118,1939,1667,412100,436,91,82.73,17.27,31,0,11,10,488,0,77,52,64,0,0,9,135,157,46,5770
436,349,87,183,166,1976,856,101300,110,326,25.23,74.77,0,96,268,21,0,0,211,0,0,0,17,80,8,0,0,5771
680,582,98,308,274,1975,682,148600,441,239,64.85,35.15,226,13,171,86,127,37,284,70,0,0,12,197,23,0,0,5772
382,373,9,280,93,1949,1068,221200,365,17,95.55,4.45,18,0,0,46,298,0,53,10,0,0,11,244,25,0,0,5773
290,290,0,180,110,1955,940,351600,256,34,88.28,11.72,23,0,41,37,196,18,16,100,0,0,0,11,82,34,21,5774
712,712,0,432,280,1977,990,270300,540,172,75.84,24.16,83,170,494,63,0,0,226,14,25,0,0,119,303,16,0,5775
710,640,70,558,82,1978,888,186900,462,248,65.07,34.93,118,106,188,72,209,25,15,17,0,0,91,310,45,0,11,5776
518,518,0,444,74,1976,0,213000,491,27,94.79,5.21,10,45,281,88,0,0,0,33,0,0,0,165,211,0,0,5777
618,618,0,374,244,1968,962,314300,455,163,73.62,26.38,10,25,304,135,245,17,253,13,70,0,41,72,217,36,0,5778
541,498,43,245,253,1979,797,109800,412,129,76.16,23.84,110,13,157,48,96,0,135,0,0,0,34,186,27,0,0,5779
502,502,0,253,249,1986,658,0,151,351,30.08,69.92,170,22,141,42,43,0,61,0,0,0,82,26,109,0,0,5780
421,410,11,156,254,1965,1136,135900,338,83,80.29,19.71,11,0,50,69,148,33,12,34,0,0,0,157,0,0,0,5781
444,378,66,340,38,1991,1477,263800,444,0,100.00,0.00,221,37,10,9,24,0,0,0,12,20,0,0,254,15,0,5782
668,603,65,79,524,1979,1009,187900,230,438,34.43,65.57,284,85,279,0,0,0,495,15,0,32,0,67,39,0,0,5783
493,493,0,241,252,1957,700,109900,362,131,73.43,26.57,118,13,4,23,370,40,137,44,0,0,29,116,15,0,0,5784
1208,1113,95,458,655,1980,709,169100,482,726,39.90,60.10,351,129,321,108,166,86,329,24,78,0,113,297,72,0,0,5785
681,652,29,373,279,1990,1070,0,218,463,32.01,67.99,295,174,202,11,0,0,217,101,0,0,178,61,83,14,0,5786
1039,987,52,549,438,1991,842,352800,632,407,60.83,39.17,507,333,83,57,31,0,343,25,41,0,94,87,215,128,56,5787
319,319,0,302,17,1968,0,213000,319,0,100.00,0.00,50,0,104,45,35,0,11,37,0,0,0,154,32,0,0,5788
684,647,37,566,81,1976,525,226700,496,188,72.51,27.49,195,94,161,95,128,13,63,11,0,0,43,211,122,29,31,5789
531,423,108,168,255,1967,761,152400,269,262,50.66,49.34,34,99,229,206,223,0,491,43,0,0,8,142,13,0,19,5790
915,881,34,484,397,1974,883,201600,678,237,74.10,25.90,226,7,106,72,448,104,194,70,6,0,33,357,57,0,0,5791
539,539,0,213,326,1939,797,376800,285,254,52.88,47.12,302,0,0,39,231,87,242,40,12,0,0,88,37,50,0,5792
537,514,23,218,296,1962,1000,220100,379,158,70.58,29.42,44,38,78,0,382,0,55,76,12,0,0,309,20,0,11,5793
522,451,71,145,306,1947,772,134900,411,111,78.74,21.26,100,10,51,43,304,111,178,22,0,0,23,124,17,0,0,5794
349,293,56,150,143,1944,756,150000,304,45,87.11,12.89,20,28,0,21,225,21,49,78,0,0,0,114,0,0,0,5795
856,856,0,536,320,1974,818,165700,539,317,62.97,37.03,53,119,206,139,255,53,186,30,0,0,55,401,31,0,16,5796
1402,1295,107,468,827,1984,755,208300,618,784,44.08,55.92,404,63,492,55,276,98,597,98,0,0,24,236,57,0,0,5797
323,323,0,196,127,1953,1142,324300,256,67,79.26,20.74,135,0,67,40,128,0,71,75,16,0,0,26,137,31,0,5798
542,542,0,156,386,1976,866,442000,182,360,33.58,66.42,70,95,256,101,85,0,440,0,0,0,0,12,77,27,0,5799
579,512,67,252,260,1983,2293,395700,325,254,56.13,43.87,154,103,54,52,302,0,54,99,149,16,0,43,184,69,51,5800
503,472,31,145,327,1979,548,115300,186,317,36.98,63.02,158,154,109,57,171,81,200,59,0,0,56,103,20,0,0,5801
607,519,88,298,221,1982,1072,415500,441,166,72.65,27.35,62,80,82,91,133,0,23,26,0,0,0,29,69,147,139,5802
240,185,55,93,92,1965,676,186300,185,55,77.08,22.92,24,0,126,22,126,0,122,0,0,0,14,130,32,0,0,5803
316,273,43,100,173,1939,1355,372200,180,136,56.96,43.04,0,0,20,57,101,12,51,12,0,0,19,6,60,9,0,5804
694,650,44,227,423,1939,1013,341300,478,216,68.88,31.12,107,0,88,32,400,46,127,185,0,0,0,0,81,31,60,5805
483,483,0,255,228,1953,852,119900,422,61,87.37,12.63,38,0,31,101,269,13,202,28,7,0,29,129,7,7,0,5806
597,557,40,462,95,1976,1333,230300,584,13,97.82,2.18,52,18,29,74,310,0,21,60,0,0,46,266,53,0,0,5807
1476,1375,101,510,865,1976,716,23900,377,1099,25.54,74.46,628,30,305,39,255,153,599,40,0,0,233,87,28,0,0,5808
240,187,53,11,176,1974,545,0,51,189,21.25,78.75,80,57,16,20,83,84,84,0,0,0,42,26,0,0,20,5809
557,530,27,308,222,1964,673,144200,322,235,57.81,42.19,33,55,188,58,346,34,131,38,21,0,162,195,30,0,6,5810
609,559,50,519,40,1983,0,501900,572,37,93.92,6.08,195,116,162,79,53,0,46,0,0,0,10,72,68,1,339,5811
273,250,23,75,175,1978,850,228100,112,161,41.03,58.97,11,25,104,36,97,13,149,0,0,0,27,45,39,0,0,5812
1283,1251,32,870,381,1998,991,246400,930,353,72.49,27.51,780,96,161,70,47,0,302,23,29,0,59,196,393,96,21,5813
615,437,178,340,97,1977,980,210300,505,110,82.11,17.89,184,115,164,86,95,17,37,0,0,0,74,159,96,22,18,5814
340,267,73,256,11,1976,0,195300,311,29,91.47,8.53,16,57,223,82,0,0,0,0,0,0,17,257,90,0,0,5815
605,545,60,337,208,1972,907,216800,521,84,86.12,13.88,50,48,289,143,176,24,205,63,22,0,12,208,129,0,0,5816
491,413,78,321,92,1981,725,129000,345,146,70.26,29.74,74,51,204,23,104,10,32,0,0,0,144,118,64,0,12,5817
278,278,0,64,214,1939,697,82300,235,43,84.53,15.47,0,0,18,59,186,32,92,15,0,0,3,61,0,0,0,5818
404,404,0,339,65,1955,1508,357400,384,20,95.05,4.95,16,0,66,37,239,0,0,0,0,0,0,129,177,0,0,5819
398,218,180,137,81,1992,0,0,338,60,84.92,15.08,154,69,85,15,157,0,35,0,0,0,21,78,67,14,20,5820
428,406,22,138,268,1977,828,196100,200,228,46.73,53.27,78,9,63,36,115,0,109,9,9,0,16,79,37,9,0,5821
993,921,72,125,796,1939,832,420700,172,821,17.32,82.68,99,0,0,23,811,112,424,155,29,27,10,11,60,20,49,5822
1244,703,541,554,149,1978,1362,270800,1097,147,88.18,11.82,280,129,233,177,289,0,50,0,0,0,0,185,234,104,142,5823
642,573,69,288,285,1975,548,145800,347,295,54.05,45.95,72,72,87,30,233,55,48,0,0,0,99,136,27,0,8,5824
1043,1007,36,931,76,1990,1370,259300,1006,37,96.45,3.55,434,21,130,97,170,0,80,43,0,0,16,271,327,65,50,5825
1184,1067,117,532,535,1992,646,149000,776,408,65.54,34.46,686,47,231,54,126,35,318,59,0,0,94,518,87,10,0,5826
310,310,0,136,174,1939,907,412500,171,139,55.16,44.84,39,12,10,11,400,0,102,71,0,0,11,44,146,47,20,5827
965,893,72,627,266,1961,783,159000,666,299,69.02,30.98,283,63,124,209,301,39,188,42,11,0,170,350,131,0,0,5828
1102,1089,13,895,194,1987,1408,349400,1031,71,93.56,6.44,458,145,473,35,25,0,76,117,15,22,12,266,337,131,133,5829
323,323,0,244,79,1939,1236,557200,288,35,89.16,10.84,65,0,0,0,268,0,0,0,0,0,0,20,45,13,255,5830
418,191,227,121,70,1973,286,185800,304,114,72.73,27.27,26,89,111,14,147,29,18,0,0,0,66,86,26,4,16,5831
705,684,21,479,205,1960,995,164500,590,115,83.69,16.31,192,22,143,8,313,0,142,135,0,0,30,307,26,0,7,5832
609,609,0,425,184,1945,1284,257300,549,60,90.15,9.85,149,0,10,50,520,14,73,116,0,68,68,211,75,12,0,5833
569,569,0,465,104,1983,1388,33000,256,313,44.99,55.01,323,148,254,29,23,0,82,34,0,0,483,68,6,0,16,5834
353,294,59,213,81,1982,0,0,197,156,55.81,44.19,47,15,0,14,65,0,15,0,0,0,16,51,30,0,14,5835
946,902,44,669,233,1973,842,177200,591,355,62.47,37.53,351,128,141,80,530,0,263,49,0,0,139,333,174,80,84,5836
658,578,80,399,179,1972,863,184400,490,168,74.47,25.53,197,58,107,65,213,27,62,11,4,0,44,139,70,55,97,5837
366,302,64,302,0,1992,0,0,349,17,95.36,4.64,21,10,84,24,41,11,29,0,0,0,0,70,30,10,7,5838
1224,1134,90,783,351,1992,868,132800,847,377,69.20,30.80,413,88,319,44,111,0,113,98,0,0,130,567,23,13,0,5839
225,225,0,108,117,1956,612,123400,155,70,68.89,31.11,43,15,10,35,136,81,33,0,0,0,100,13,12,0,0,5840
496,449,47,377,72,1980,1673,293200,496,0,100.00,0.00,63,222,144,40,20,0,0,42,0,0,19,32,363,33,0,5841
353,353,0,228,125,1939,1368,276800,326,27,92.35,7.65,45,10,21,47,265,33,16,52,0,0,0,123,125,2,0,5842
771,689,82,194,495,1980,752,175800,310,461,40.21,59.79,206,95,79,160,171,300,145,39,0,0,10,169,48,0,0,5843
222,222,0,32,190,1965,597,177800,134,88,60.36,39.64,0,88,98,0,136,0,65,0,0,0,107,47,0,0,0,5844
971,924,47,237,687,1984,1062,246100,229,742,23.58,76.42,407,148,149,64,14,0,418,120,0,0,0,102,10,49,54,5845
371,297,74,227,70,1939,1007,239300,310,61,83.56,16.44,38,0,74,12,189,33,47,0,0,0,0,187,46,0,0,5846
552,510,42,190,320,1991,825,182100,335,217,60.69,39.31,328,147,284,24,95,0,445,31,0,0,0,268,48,10,11,5847
535,514,21,228,286,1969,1021,197000,433,102,80.93,19.07,110,30,29,78,223,11,109,37,0,0,18,223,55,17,0,5848
845,845,0,499,346,1959,1039,283600,663,182,78.46,21.54,190,73,88,119,458,9,150,45,10,42,25,305,207,0,0,5849
475,451,24,327,124,1939,1125,397700,416,59,87.58,12.42,19,12,27,36,440,18,139,19,12,10,0,33,159,112,32,5850
472,419,53,14,405,1956,602,0,90,382,19.07,80.93,0,0,84,24,241,106,160,27,0,0,0,23,0,0,0,5851
478,434,44,151,283,1955,954,111100,447,31,93.51,6.49,12,0,46,53,530,9,185,94,10,0,13,197,107,0,0,5852
495,447,48,399,48,1968,1053,300400,386,109,77.98,22.02,129,31,78,134,93,0,21,13,23,0,29,59,143,49,114,5853
425,320,105,289,31,1990,0,295000,311,114,73.18,26.82,149,121,203,53,58,0,51,0,0,0,44,123,119,31,51,5854
380,351,29,20,331,1955,661,0,70,310,18.42,81.58,17,36,163,63,241,150,267,16,0,0,0,27,8,0,0,5855
420,420,0,249,171,1945,1105,274300,321,99,76.43,23.57,46,25,61,16,253,0,40,0,0,0,0,190,161,0,10,5856
767,555,212,0,555,1984,778,0,23,744,3.00,97.00,84,43,14,21,310,208,246,0,0,18,0,0,0,0,0,5857
1090,980,110,640,340,1983,1063,194300,791,299,72.57,27.43,395,36,239,221,117,0,93,99,11,0,5,425,213,14,7,5858
295,295,0,0,295,1957,1034,0,48,247,16.27,83.73,11,18,10,60,289,68,241,23,0,0,0,0,0,0,0,5859
811,728,83,400,328,1976,679,193500,448,363,55.24,44.76,270,34,140,88,132,89,84,0,0,0,58,319,64,8,0,5860
521,521,0,139,382,1977,1066,194800,159,362,30.52,69.48,72,69,238,71,48,0,259,43,0,0,0,101,15,0,0,5861
559,559,0,296,263,1975,1039,358700,68,491,12.16,87.84,68,175,264,0,137,0,62,124,15,0,8,17,111,54,108,5862
835,681,154,493,188,1983,842,216600,567,268,67.90,32.10,194,174,159,44,57,0,60,24,0,0,10,90,171,99,99,5863
624,624,0,486,138,1991,945,137200,453,171,72.60,27.40,222,36,37,56,115,0,0,0,0,0,58,356,34,0,18,5864
1121,1121,0,546,575,1947,588,447400,615,506,54.86,45.14,14,23,83,218,541,108,224,27,38,0,0,26,238,82,61,5865
467,369,98,311,58,1978,798,239200,315,152,67.45,32.55,91,70,130,53,171,18,62,5,0,0,29,131,84,8,33,5866
338,338,0,216,122,1976,836,168800,268,70,79.29,20.71,22,89,44,48,126,0,23,28,0,0,0,157,56,0,3,5867
417,377,40,0,377,1965,701,0,14,403,3.36,96.64,48,78,110,0,70,0,164,27,53,0,0,0,0,0,0,5868
425,350,75,233,117,1974,935,265200,362,63,85.18,14.82,71,34,115,53,166,0,52,0,0,0,60,70,45,63,36,5869
383,361,22,300,61,1983,1030,237800,273,110,71.28,28.72,173,88,154,15,60,22,59,25,0,0,30,124,114,38,37,5870
762,722,40,500,222,1978,1123,174700,727,35,95.41,4.59,156,76,306,51,10,0,125,136,7,0,0,267,50,0,0,5871
1077,995,82,752,243,1977,589,209500,758,319,70.38,29.62,185,92,350,72,406,13,153,6,10,0,125,319,133,92,107,5872
739,739,0,295,444,1976,722,158300,230,509,31.12,68.88,240,69,266,182,60,14,327,18,0,0,94,309,0,0,0,5873
613,571,42,283,288,1971,801,151000,356,257,58.08,41.92,236,59,93,90,215,0,210,22,59,0,19,175,125,29,0,5874
359,359,0,300,59,1939,1275,295100,359,0,100.00,0.00,52,0,10,32,268,0,56,25,0,0,19,31,133,59,39,5875
483,374,109,296,78,1975,617,171100,321,162,66.46,33.54,179,49,97,23,155,0,31,11,0,0,44,134,96,39,37,5876
356,182,174,131,51,1970,448,160500,294,62,82.58,17.42,35,31,29,29,137,9,26,0,0,0,100,69,5,4,0,5877
446,446,0,140,306,1939,547,177400,216,230,48.43,51.57,50,41,11,0,485,144,197,27,0,0,0,134,27,0,0,5878
728,671,57,488,183,1963,900,177200,631,97,86.68,13.32,117,0,113,115,350,0,106,15,0,0,0,427,79,0,18,5879
462,462,0,293,169,1959,1082,220300,400,62,86.58,13.42,85,25,24,39,312,7,119,9,18,0,4,166,111,0,9,5880
1055,997,58,724,273,1992,1212,251300,1014,41,96.11,3.89,715,123,162,13,35,0,35,110,0,0,0,194,430,119,114,5881
533,474,59,116,358,1969,1060,229300,154,379,28.89,71.11,0,0,63,23,233,0,128,17,12,0,0,62,70,30,0,5882
578,578,0,238,340,1952,926,358100,312,266,53.98,46.02,38,17,43,62,397,6,179,58,10,0,0,39,136,63,66,5883
515,270,245,198,72,1978,543,412200,463,52,89.90,10.10,62,35,119,31,186,0,30,12,0,0,3,16,23,10,59,5884
610,583,27,426,157,1978,898,216500,482,128,79.02,20.98,126,177,63,17,117,8,22,121,0,0,0,190,71,12,0,5885
739,691,48,117,574,1971,714,158600,333,406,45.06,54.94,82,40,269,113,64,0,266,15,0,0,30,238,0,0,0,5886
666,613,53,445,168,1984,1114,153100,411,255,61.71,38.29,210,97,129,84,181,0,121,115,0,0,128,187,124,0,0,5887
251,251,0,220,31,1974,1273,269700,251,0,100.00,0.00,0,0,167,184,0,0,14,0,8,0,0,97,232,0,0,5888
703,606,97,52,554,1939,784,293300,0,703,0.00,100.00,105,13,0,12,590,200,422,49,0,0,0,0,0,0,0,5889
400,369,31,166,203,1946,739,115000,338,62,84.50,15.50,16,81,46,16,372,16,237,14,0,0,0,161,51,0,0,5890
347,347,0,164,183,1984,1053,255100,264,83,76.08,23.92,145,100,59,51,45,0,69,47,9,0,13,134,33,0,10,5891
1190,1059,131,612,447,1971,729,160900,597,593,50.17,49.83,52,167,244,148,374,14,236,29,0,0,111,327,176,64,0,5892
571,532,39,172,360,1992,961,170000,383,188,67.08,32.92,235,36,137,30,59,0,226,78,0,0,42,66,29,0,0,5893
282,274,8,214,60,1954,1438,273900,244,38,86.52,13.48,18,0,49,0,248,0,58,0,0,0,9,100,148,0,0,5894
836,780,56,283,497,1965,1005,194000,375,461,44.86,55.14,42,30,236,160,326,0,262,104,57,65,0,209,31,14,0,5895
442,390,52,320,70,1974,896,177700,422,20,95.48,4.52,33,0,347,37,5,0,8,37,26,0,0,318,33,0,0,5896
469,469,0,261,208,1947,533,311900,296,173,63.11,36.89,86,0,26,25,250,24,50,22,0,0,0,100,131,10,13,5897
360,345,15,80,265,1971,856,196300,82,278,22.78,77.22,105,61,330,106,24,0,450,22,0,0,23,119,12,0,0,5898
843,758,85,358,400,1969,1042,518900,296,547,35.11,64.89,36,87,118,366,377,63,480,56,85,33,26,63,13,10,102,5899
427,285,142,138,147,1959,992,373900,294,133,68.85,31.15,13,9,70,74,129,11,88,0,0,0,0,35,42,10,100,5900
503,503,0,439,64,1974,1063,230500,493,10,98.01,1.99,84,15,231,97,112,0,23,93,0,0,0,219,192,12,0,5901
369,339,30,262,77,1974,1116,220000,360,9,97.56,2.44,22,39,153,199,15,10,46,0,0,0,0,182,183,7,0,5902
408,408,0,13,395,1978,953,0,13,395,3.19,96.81,268,29,159,162,0,0,265,60,177,82,0,0,0,0,0,5903
429,429,0,279,150,1975,1204,241400,429,0,100.00,0.00,16,23,216,80,15,0,23,0,0,0,0,163,83,0,81,5904
694,655,39,566,89,1978,1420,252700,682,12,98.27,1.73,243,80,424,29,27,0,0,50,14,0,0,86,551,45,29,5905
472,472,0,283,189,1955,1051,225900,439,33,93.01,6.99,0,0,29,118,326,0,77,31,27,0,0,199,73,0,0,5906
743,743,0,570,173,1999,1588,359600,694,49,93.41,6.59,546,40,0,35,0,0,0,53,11,0,0,108,254,92,103,5907
305,295,10,171,124,1987,881,256300,233,72,76.39,23.61,43,42,75,7,100,0,37,24,0,0,21,35,39,15,29,5908
1208,1127,81,462,665,1955,964,613800,560,648,46.36,53.64,136,149,110,19,680,101,319,105,0,0,0,23,57,86,335,5909
785,658,127,175,483,1939,870,377800,177,608,22.55,77.45,62,42,63,34,591,86,387,24,0,0,0,12,121,34,38,5910
688,688,0,315,373,1979,876,232600,385,303,55.96,44.04,281,87,178,32,36,0,226,51,10,0,0,140,127,0,10,5911
299,260,39,189,71,1979,0,228100,299,0,100.00,0.00,125,36,145,0,0,0,0,0,0,0,13,140,127,0,0,5912
587,546,41,220,326,1949,863,268300,306,281,52.13,47.87,84,11,26,73,316,49,138,0,0,0,0,101,123,30,0,5913
440,405,35,247,158,1971,863,224100,308,132,70.00,30.00,81,40,113,36,159,20,57,3,0,0,75,54,64,13,19,5914
546,546,0,409,137,1987,1146,392700,424,122,77.66,22.34,215,407,19,11,0,0,74,68,0,0,27,94,94,69,213,5915
515,454,61,384,70,1986,704,265700,461,54,89.51,10.49,138,38,180,22,156,0,12,10,0,0,44,128,64,88,82,5916
351,305,46,205,100,1939,750,89400,326,25,92.88,7.12,66,30,26,14,262,60,75,0,0,0,134,97,10,0,0,5917
1206,1157,49,436,721,1975,817,249600,614,592,50.91,49.09,425,76,337,292,65,92,354,92,33,120,20,152,254,8,0,5918
299,299,0,286,13,1955,0,314600,299,0,100.00,0.00,62,0,0,0,373,0,16,60,0,0,0,85,245,29,0,5919
731,697,34,376,321,1951,847,300000,498,233,68.13,31.87,93,106,156,37,247,29,146,57,0,0,0,42,144,101,76,5920
538,231,307,108,123,1971,1012,244700,467,71,86.80,13.20,140,53,0,118,92,0,12,24,0,0,0,73,6,8,14,5921
360,360,0,209,151,1952,1039,164400,295,65,81.94,18.06,49,0,73,14,299,0,30,89,0,0,19,132,63,6,7,5922
420,420,0,257,163,1948,1345,271500,367,53,87.38,12.62,21,0,8,32,294,0,33,0,0,0,8,188,116,0,10,5923
424,424,0,291,133,1995,866,389300,319,105,75.24,24.76,509,0,0,0,0,0,130,0,0,14,17,0,114,207,27,5924
581,533,48,241,292,1973,1426,426800,494,87,85.03,14.97,56,16,66,87,290,0,82,30,22,13,0,14,145,30,129,5925
1276,1276,0,782,494,1997,1265,302400,922,354,72.26,27.74,1188,129,41,0,26,0,205,151,44,46,0,334,285,136,51,5926
700,627,73,90,537,1951,828,342200,71,629,10.14,89.86,0,39,55,49,489,107,321,58,0,0,0,0,53,46,16,5927
590,551,39,267,284,1977,1058,195500,344,246,58.31,41.69,13,63,297,14,57,34,131,69,0,42,0,154,14,0,0,5928
283,236,47,124,112,1947,532,84100,195,88,68.90,31.10,22,14,45,29,142,15,51,0,0,0,84,23,11,0,0,5929
752,752,0,208,544,1997,911,130800,147,605,19.55,80.45,637,14,64,55,38,0,357,55,0,0,55,263,0,0,0,5930
1034,1024,10,347,677,1978,1000,372900,410,624,39.65,60.35,121,332,456,212,24,0,630,35,0,0,9,66,141,189,21,5931
1329,1279,50,733,546,1995,1262,329700,942,387,70.88,29.12,1034,330,77,29,11,0,548,136,37,0,0,114,478,87,19,5932
370,316,54,205,111,1939,543,96800,307,63,82.97,17.03,63,28,38,14,216,2,26,0,0,0,129,68,6,5,6,5933
373,373,0,300,73,1978,0,355800,328,45,87.94,12.06,130,27,157,9,47,0,48,0,0,0,26,27,174,14,68,5934
1213,1213,0,850,363,1995,918,424600,885,328,72.96,27.04,853,224,60,64,12,0,198,0,0,12,0,10,280,285,401,5935
565,355,210,267,88,1970,550,127100,417,148,73.81,26.19,121,66,85,21,245,10,27,0,0,0,119,88,35,12,23,5936
928,854,74,730,124,1994,681,206400,619,309,66.70,33.30,519,119,99,67,0,0,7,16,0,0,63,352,247,61,0,5937
762,720,42,695,25,1997,0,493700,762,0,100.00,0.00,646,0,0,0,14,0,0,0,0,0,0,23,87,228,279,5938
475,435,40,312,123,1947,976,172600,397,78,83.58,16.42,168,34,129,23,110,22,64,79,0,0,42,104,71,8,21,5939
616,616,0,433,183,1939,1609,372800,571,45,92.69,7.31,106,13,16,0,606,26,141,24,34,0,0,13,172,224,41,5940
1038,271,767,151,120,1990,885,207400,825,213,79.48,20.52,310,67,271,0,180,0,28,31,0,0,69,66,58,0,48,5941
671,671,0,671,0,1998,0,273000,639,32,95.23,4.77,335,0,160,56,56,0,0,18,12,0,11,154,315,77,20,5942
547,462,85,359,103,1977,640,227600,408,139,74.59,25.41,120,41,90,42,125,0,52,0,13,0,31,94,36,82,51,5943
485,485,0,468,17,1939,0,566400,485,0,100.00,0.00,0,10,0,0,369,0,0,12,15,11,0,27,44,72,198,5944
519,519,0,449,70,1979,1346,276100,512,7,98.65,1.35,118,23,187,62,32,0,0,0,0,0,0,60,272,54,22,5945
561,552,9,396,156,1977,1127,131400,434,127,77.36,22.64,212,6,262,54,54,0,24,56,0,0,99,351,23,20,15,5946
683,683,0,400,283,2001,1200,164800,622,61,91.07,8.93,862,11,16,18,28,0,119,112,33,0,11,301,187,53,9,5947
471,471,0,463,8,1968,0,270200,457,14,97.03,2.97,0,0,76,295,118,0,11,37,38,0,12,111,223,15,0,5948
944,918,26,327,591,1978,847,180900,431,513,45.66,54.34,394,42,194,281,210,11,520,60,0,0,11,298,65,9,0,5949
309,277,32,206,71,1976,947,213200,202,107,65.37,34.63,59,13,237,58,24,0,152,59,0,0,0,61,85,11,23,5950
551,517,34,247,270,1960,0,348800,317,234,57.53,42.47,51,18,277,96,277,204,179,54,0,0,0,29,204,0,13,5951
350,350,0,189,161,1939,1176,428500,232,118,66.29,33.71,48,0,69,6,390,48,161,58,0,0,0,61,131,9,4,5952
894,864,30,155,709,1975,932,369800,285,609,31.88,68.12,96,85,126,92,255,44,298,42,52,0,24,11,70,74,25,5953
692,692,0,326,366,1976,847,312700,323,369,46.68,53.32,248,161,70,16,157,0,183,67,8,79,12,48,175,20,27,5954
502,225,277,120,105,1971,0,137500,314,188,62.55,37.45,135,72,135,38,118,18,19,32,0,0,124,70,55,0,0,5955
399,301,98,96,205,1977,649,178200,154,245,38.60,61.40,26,0,71,36,170,20,116,42,0,0,10,44,0,30,0,5956
815,749,66,371,378,1971,865,212200,581,234,71.29,28.71,193,35,0,136,339,30,237,28,58,0,12,277,61,0,0,5957
381,381,0,107,274,1942,725,292200,161,220,42.26,57.74,9,19,99,12,338,151,163,40,0,0,0,0,66,6,0,5958
707,543,164,386,157,1975,770,210000,473,234,66.90,33.10,137,78,208,83,161,13,124,15,0,0,61,112,123,26,55,5959
1358,1292,66,389,903,1993,1115,323700,579,779,42.64,57.36,795,340,158,0,37,0,590,150,20,0,0,112,242,156,32,5960
537,502,35,392,110,1950,1351,287000,529,8,98.51,1.49,31,20,0,11,315,0,34,22,0,0,0,126,132,32,0,5961
547,506,41,215,291,1939,1040,670500,231,316,42.23,57.77,12,13,16,84,436,14,254,70,15,0,0,15,14,0,105,5962
445,351,94,44,307,1959,684,0,145,300,32.58,67.42,74,29,38,49,188,27,190,36,0,0,11,38,0,0,0,5963
449,449,0,429,20,1955,0,372800,439,10,97.77,2.23,28,25,11,70,348,0,23,16,7,0,19,47,107,158,105,5964
518,482,36,330,152,1975,993,213200,282,236,54.44,45.56,92,68,143,115,77,0,133,72,0,0,147,98,36,0,9,5965
616,593,23,274,319,1968,867,248300,453,163,73.54,26.46,28,17,94,188,242,53,40,107,25,0,0,155,126,11,0,5966
372,364,8,80,284,1966,716,230800,144,228,38.71,61.29,22,12,48,22,128,31,122,9,0,0,18,18,5,0,0,5967
491,436,55,222,214,1958,1257,231000,343,148,69.86,30.14,65,13,28,47,246,23,127,71,14,0,0,110,54,0,0,5968
453,399,54,0,399,1968,763,0,55,398,12.14,87.86,110,8,53,205,251,172,373,0,0,11,0,13,18,0,0,5969
665,665,0,447,218,1974,1054,203900,586,79,88.12,11.88,41,31,220,67,134,0,42,94,41,0,0,299,17,0,0,5970
883,828,55,446,382,1978,908,286600,519,364,58.78,41.22,149,103,287,118,150,0,231,71,0,0,37,74,232,128,17,5971
691,599,92,243,356,1979,1530,158800,418,273,60.49,39.51,351,53,184,37,24,0,74,51,101,31,21,258,55,0,0,5972
859,825,34,344,481,1978,872,227200,583,276,67.87,32.13,238,98,184,136,74,41,174,63,42,0,10,226,79,0,0,5973
763,677,86,182,495,1972,813,221000,155,608,20.31,79.69,36,63,185,112,176,0,248,25,0,0,54,156,45,0,0,5974
353,335,18,187,148,1972,1148,181000,241,112,68.27,31.73,20,0,89,133,56,0,20,0,0,0,0,264,14,0,0,5975
331,297,34,116,181,1963,769,170800,151,180,45.62,54.38,8,46,51,79,165,47,150,56,0,0,0,51,45,0,0,5976
688,688,0,87,601,1977,999,287500,108,580,15.70,84.30,312,37,113,119,40,0,259,149,0,0,0,42,104,0,30,5977
1147,1080,67,735,345,1992,1135,218100,646,501,56.32,43.68,487,295,252,0,19,0,165,95,18,0,217,219,153,34,20,5978
251,251,0,234,17,1978,0,282400,251,0,100.00,0.00,11,75,113,0,9,0,0,0,7,0,0,0,150,51,0,5979
283,215,68,116,99,1956,852,217000,228,55,80.57,19.43,0,9,27,34,141,9,42,8,0,0,0,109,43,0,0,5980
282,258,24,160,98,1975,524,436200,199,83,70.57,29.43,127,33,16,21,86,3,63,12,0,0,26,44,68,0,24,5981
331,278,53,163,115,1949,790,150500,317,14,95.77,4.23,74,12,32,11,215,0,206,11,0,0,22,68,37,0,0,5982
951,951,0,485,466,1975,921,146600,769,182,80.86,19.14,240,26,329,230,251,37,160,129,12,0,14,484,96,0,0,5983
398,352,46,317,35,1967,0,514200,398,0,100.00,0.00,30,104,24,45,166,0,0,17,0,0,0,0,58,37,201,5984
556,556,0,327,229,1958,874,129900,498,58,89.57,10.43,153,34,72,47,257,0,138,82,0,0,59,253,31,0,0,5985
373,344,29,77,267,1968,891,160600,252,121,67.56,32.44,18,0,74,60,106,0,96,10,0,0,0,131,21,0,0,5986
890,767,123,491,276,1959,931,191200,747,143,83.93,16.07,85,0,204,82,475,29,40,170,0,22,0,296,140,56,39,5987
390,363,27,19,344,1945,561,0,56,334,14.36,85.64,25,24,31,56,267,69,201,20,0,0,0,17,0,0,0,5988
1361,1216,145,813,403,1982,1363,255300,1173,188,86.19,13.81,580,291,147,70,239,20,109,169,23,24,28,302,400,93,111,5989
648,592,56,65,527,1975,817,265500,270,378,41.67,58.33,278,56,197,32,313,99,525,103,7,0,0,17,69,0,0,5990
504,504,0,338,166,1970,657,193300,303,201,60.12,39.88,198,69,158,66,82,0,15,20,0,0,0,161,115,60,31,5991
718,718,0,689,29,1997,0,247600,718,0,100.00,0.00,260,24,207,143,69,0,36,0,0,0,0,265,281,121,0,5992
1306,1205,101,773,432,1991,1080,282300,1137,169,87.06,12.94,380,25,278,57,38,0,0,47,6,0,0,162,260,45,213,5993
398,384,14,84,300,1939,648,604200,270,128,67.84,32.16,61,0,0,10,344,13,151,0,0,0,0,17,25,13,119,5994
322,322,0,224,98,1969,1194,172000,309,13,95.96,4.04,76,0,177,187,0,19,11,51,0,0,0,254,80,0,25,5995
369,282,87,183,99,1992,1025,281300,209,160,56.64,43.36,86,25,59,27,104,0,40,29,0,0,0,13,69,34,83,5996
519,519,0,161,358,1965,1057,229000,345,174,66.47,33.53,142,13,90,55,246,36,197,62,0,11,0,16,67,55,65,5997
344,291,53,188,103,1975,686,124200,184,160,53.49,46.51,22,14,86,17,155,18,76,0,0,0,46,90,0,14,0,5998
793,758,35,268,490,1998,850,156300,422,371,53.22,46.78,436,110,207,28,54,25,546,48,0,0,24,82,110,0,0,5999
978,668,310,470,198,1996,1161,307700,875,103,89.47,10.53,389,106,132,23,93,0,50,14,0,0,0,35,110,105,235,6000
426,398,28,275,123,1953,852,155000,317,109,74.41,25.59,33,13,104,52,128,9,48,4,0,0,41,171,6,0,0,6001
294,270,24,138,132,1950,876,125000,243,51,82.65,17.35,51,0,36,7,192,0,22,14,0,0,53,197,0,0,0,6002
316,316,0,254,62,1972,935,0,157,159,49.68,50.32,79,16,107,0,99,35,62,0,0,0,145,49,0,0,0,6003
361,336,25,187,149,1964,580,169900,308,53,85.32,14.68,39,37,38,36,142,0,33,11,0,0,32,125,41,0,0,6004
517,517,0,460,57,1978,1169,174100,504,13,97.49,2.51,151,51,80,46,255,35,22,70,0,0,11,320,77,0,9,6005
474,436,38,298,138,1978,971,171800,402,72,84.81,15.19,224,0,75,63,53,13,36,41,0,0,12,287,14,0,0,6006
534,419,115,223,196,1939,717,110400,359,175,67.23,32.77,38,13,116,24,294,127,139,6,0,0,89,87,0,7,0,6007
649,617,32,113,504,1976,839,141800,214,435,32.97,67.03,68,51,369,94,90,42,485,17,12,0,0,116,0,0,0,6008
412,378,34,250,128,1968,616,263900,236,176,57.28,42.72,104,36,58,20,167,0,23,26,0,0,32,87,134,0,22,6009
637,594,43,374,220,1960,628,120500,383,254,60.13,39.87,105,46,230,55,325,80,125,4,0,0,213,180,51,0,7,6010
593,540,53,255,285,1978,589,87600,366,227,61.72,38.28,286,159,76,83,25,69,141,69,0,0,41,175,53,26,27,6011
461,379,82,379,0,2001,0,364900,461,0,100.00,0.00,204,79,39,15,19,0,0,7,0,0,0,13,168,65,103,6012
845,788,57,317,471,1961,937,186700,631,214,74.67,25.33,67,102,168,127,428,81,268,29,16,0,10,190,215,46,8,6013
800,510,290,472,38,1979,0,235400,631,169,78.88,21.13,326,178,192,72,146,0,0,11,12,0,48,208,106,11,61,6014
842,451,391,255,196,1957,791,219000,567,275,67.34,32.66,274,82,143,63,403,44,83,22,14,0,12,198,156,13,33,6015
502,393,109,205,188,1976,1035,341500,327,175,65.14,34.86,72,98,100,65,144,36,34,29,0,12,0,84,75,0,74,6016
1773,959,814,631,328,1979,883,318600,1509,264,85.11,14.89,389,296,178,212,452,21,108,58,0,0,33,224,183,57,116,6017
642,446,196,201,245,1998,1713,567500,58,584,9.03,90.97,201,196,0,0,29,0,22,93,72,12,0,9,33,19,79,6018
386,386,0,0,386,1939,608,0,0,386,0.00,100.00,0,0,0,7,461,112,241,0,7,0,0,0,0,0,0,6019
739,641,98,284,357,1973,918,223000,378,361,51.15,48.85,267,63,129,238,63,30,413,13,0,13,0,183,108,0,0,6020
853,795,58,33,762,1939,833,0,24,829,2.81,97.19,35,36,19,92,783,159,494,51,0,0,0,48,12,16,73,6021
889,798,91,89,709,1945,957,871100,30,859,3.37,96.63,15,36,11,18,782,150,516,10,0,0,0,15,0,0,36,6022
709,695,14,581,114,1995,0,190000,490,219,69.11,30.89,648,111,40,47,23,0,60,25,0,17,198,284,225,6,29,6023
567,546,21,221,325,1984,976,214600,272,295,47.97,52.03,252,151,159,0,0,0,311,0,0,0,0,106,65,0,0,6024
895,823,72,74,749,1990,997,0,33,862,3.69,96.31,605,169,0,12,0,71,166,338,40,13,0,0,32,48,11,6025
767,679,88,0,679,1969,762,0,13,754,1.69,98.31,132,141,134,207,43,104,447,15,15,0,0,30,0,0,0,6026
553,553,0,297,256,1939,1378,365500,414,139,74.86,25.14,119,61,30,64,411,18,281,91,52,0,0,0,73,68,34,6027
462,426,36,398,28,1939,2227,548200,462,0,100.00,0.00,38,0,0,0,496,0,0,13,10,0,10,0,163,124,202,6028
536,483,53,230,253,1943,841,275000,295,241,55.04,44.96,9,0,55,11,537,72,147,77,12,0,11,68,150,49,0,6029
474,381,93,199,182,1948,1543,314400,445,29,93.88,6.12,21,0,86,17,407,8,93,16,24,23,0,116,157,0,0,6030
809,753,56,56,697,1990,871,212500,14,795,1.73,98.27,453,87,186,108,165,118,545,170,10,0,0,8,47,21,0,6031
451,423,28,345,78,1991,1090,199200,428,23,94.90,5.10,286,7,65,60,92,0,40,10,0,0,10,224,170,16,40,6032
1423,1304,119,1064,240,1991,1163,246000,1143,280,80.32,19.68,801,325,160,50,170,0,43,74,0,0,126,310,773,93,0,6033
885,885,0,552,333,1976,723,152300,631,254,71.30,28.70,428,71,142,40,142,86,127,24,0,0,62,389,48,0,0,6034
18,18,0,7,11,0,0,0,7,11,38.89,61.11,28,0,9,0,42,0,0,11,0,0,0,0,0,0,9,6035
1017,1017,0,508,509,1996,972,88500,312,705,30.68,69.32,662,221,0,28,13,0,396,27,0,0,209,56,77,33,9,6036
471,471,0,148,323,1966,771,121500,325,146,69.00,31.00,27,140,100,116,143,15,114,50,16,0,9,276,0,0,12,6037
665,528,137,26,502,2000,715,0,72,593,10.83,89.17,485,101,165,64,30,34,695,17,0,0,0,0,0,0,0,6038
297,282,15,153,129,1973,914,150400,261,36,87.88,12.12,14,47,66,0,137,0,14,0,0,0,0,157,35,11,0,6039
755,684,71,465,219,1985,951,206700,556,199,73.64,26.36,346,78,391,16,24,0,268,110,0,0,0,266,122,0,10,6040
1092,1092,0,607,485,1980,859,23500,378,714,34.62,65.38,388,118,350,128,31,48,223,31,17,0,458,198,0,0,0,6041
787,709,78,83,626,1977,754,117800,348,439,44.22,55.78,276,19,143,39,122,86,338,9,0,17,0,149,0,0,0,6042
771,771,0,248,523,1960,662,285300,322,449,41.76,58.24,0,53,164,79,359,94,290,38,0,0,0,104,62,23,11,6043
1039,828,211,663,165,1965,660,116000,963,76,92.69,7.31,127,41,29,496,39,0,147,0,0,0,166,347,58,0,14,6044
742,611,131,402,209,1968,725,210200,561,181,75.61,24.39,135,62,83,55,393,54,68,0,3,0,109,168,67,13,59,6045
557,557,0,136,421,1977,772,129200,224,333,40.22,59.78,111,60,60,67,24,12,134,4,0,0,0,92,0,0,0,6046
674,674,0,536,138,1980,1201,259600,582,92,86.35,13.65,318,93,319,46,0,18,33,106,68,0,17,188,219,39,18,6047
630,585,45,379,206,1973,971,263500,465,165,73.81,26.19,86,38,285,101,87,0,86,54,25,0,0,173,161,45,0,6048
831,675,156,213,462,1991,940,0,163,668,19.61,80.39,641,142,0,0,72,0,405,92,0,0,0,121,0,8,136,6049
1017,923,94,317,606,1985,1216,471900,323,694,31.76,68.24,184,327,332,14,53,0,275,240,24,14,0,12,45,51,152,6050
1248,1184,64,551,633,1982,1319,375000,506,742,40.54,59.46,342,471,333,54,67,0,47,67,63,84,75,259,113,99,305,6051
934,859,75,18,841,1988,870,0,16,918,1.71,98.29,727,356,76,0,0,35,766,88,0,0,0,26,0,0,0,6052
805,662,143,292,370,1993,1042,233600,277,528,34.41,65.59,454,105,63,0,51,17,214,105,16,39,9,76,99,0,0,6053
645,610,35,271,339,1972,1110,232600,380,265,58.91,41.09,251,192,28,69,402,0,199,47,71,31,14,225,170,55,13,6054
578,578,0,375,203,1976,946,262300,463,115,80.10,19.90,21,54,421,68,109,13,157,61,10,0,0,125,239,36,0,6055
533,495,38,488,7,1996,0,384400,533,0,100.00,0.00,306,58,0,12,41,0,0,0,15,0,0,60,62,127,104,6056
819,790,29,737,53,1977,1833,273900,736,83,89.87,10.13,234,27,271,152,115,11,10,9,0,0,25,143,387,27,141,6057
1059,1059,0,563,496,1973,974,0,360,699,33.99,66.01,237,127,245,238,166,22,213,98,0,0,246,160,121,59,29,6058
522,448,74,360,88,1960,886,202700,428,94,81.99,18.01,14,40,75,128,398,0,42,61,0,0,54,202,204,41,0,6059
984,915,69,410,505,1964,1164,207200,782,202,79.47,20.53,275,65,48,63,405,0,61,130,50,136,0,316,163,0,0,6060
1326,1246,80,337,909,1995,1170,276800,456,870,34.39,65.61,366,299,102,0,9,0,200,103,58,14,66,76,97,10,10,6061
788,788,0,352,436,1968,1064,325100,445,343,56.47,43.53,163,62,146,225,199,13,223,74,15,0,0,21,259,46,0,6062
906,827,79,238,589,1969,1137,212900,380,526,41.94,58.06,152,170,132,226,131,0,199,10,146,80,0,195,77,0,0,6063
570,514,56,61,453,1975,842,284100,53,517,9.30,90.70,23,33,287,132,149,46,448,22,0,0,93,15,0,0,0,6064
1056,1022,34,836,186,1997,1369,401400,732,324,69.32,30.68,1001,17,30,0,0,0,105,108,27,0,0,30,403,123,173,6065
895,895,0,480,415,1996,1109,263600,772,123,86.26,13.74,781,31,12,50,34,0,95,151,49,0,21,178,380,0,0,6066
525,500,25,399,101,1993,1750,323800,525,0,100.00,0.00,345,80,30,0,0,0,0,0,18,0,0,48,280,63,0,6067
674,667,7,469,198,1992,1436,249200,668,6,99.11,0.89,427,40,163,18,0,0,55,9,12,0,14,201,267,74,0,6068
756,720,36,416,304,1965,940,222500,486,270,64.29,35.71,43,54,156,530,177,29,266,58,28,55,97,272,107,0,0,6069
298,298,0,211,87,1976,1349,225400,298,0,100.00,0.00,66,0,198,0,0,0,0,0,33,0,0,82,132,17,0,6070
939,886,53,667,219,2001,1123,286800,800,139,85.20,14.80,653,69,0,0,55,0,185,77,12,0,0,179,273,21,16,6071
400,400,0,400,0,1998,0,574600,400,0,100.00,0.00,344,35,0,0,82,0,0,0,0,0,10,37,49,62,303,6072
1753,1560,193,287,1273,1996,1168,177900,302,1451,17.23,82.77,1285,350,86,38,46,0,804,337,26,0,0,372,75,0,0,6073
609,609,0,180,429,1959,947,221400,296,313,48.60,51.40,15,0,165,55,311,0,219,22,0,0,0,173,132,0,0,6074
472,472,0,240,232,1979,1578,165500,137,335,29.03,70.97,100,118,317,0,0,0,72,53,101,75,0,146,26,49,0,6075
557,518,39,0,518,1997,1133,0,152,405,27.29,72.71,380,44,0,0,0,29,128,173,0,0,0,0,0,0,0,6076
591,529,62,377,152,1982,1270,261000,556,35,94.08,5.92,40,236,212,16,90,0,104,26,61,17,0,12,311,25,17,6077
782,767,15,709,58,1981,1737,282600,753,29,96.29,3.71,130,314,277,54,41,0,13,54,28,0,0,172,381,87,15,6078
961,917,44,885,32,1993,1647,372100,961,0,100.00,0.00,611,285,95,0,0,0,17,12,0,0,14,64,475,170,239,6079
988,933,55,69,864,1998,894,172100,134,854,13.56,86.44,759,0,0,0,10,23,409,165,0,0,0,77,88,0,0,6080
702,702,0,503,199,2001,776,238200,597,105,85.04,14.96,308,44,39,75,79,0,48,32,0,0,24,141,266,0,34,6081
1068,924,144,743,181,1988,1171,319000,860,208,80.52,19.48,486,239,206,82,98,0,51,96,0,0,14,228,370,44,174,6082
468,410,58,252,158,1962,647,119400,285,183,60.90,39.10,118,37,125,64,230,25,87,4,4,0,131,142,20,9,4,6083
1018,929,89,535,394,1999,940,193200,816,202,80.16,19.84,641,149,84,0,85,48,246,58,0,0,129,268,148,18,19,6084
252,192,60,59,133,1951,706,169400,110,142,43.65,56.35,0,54,20,0,224,54,142,31,0,0,0,20,22,20,0,6085
522,502,20,61,441,1946,610,240200,190,332,36.40,63.60,0,91,122,144,288,24,378,0,0,0,12,83,13,0,0,6086
1061,1028,33,704,324,1995,1157,192900,980,81,92.37,7.63,586,43,149,126,130,60,77,57,0,0,30,275,367,12,45,6087
832,787,45,484,303,1991,893,129000,369,463,44.35,55.65,452,143,81,0,6,0,214,32,0,0,110,300,11,0,0,6088
168,168,0,38,130,1962,736,0,114,54,67.86,32.14,66,0,28,24,40,0,68,37,14,0,0,12,14,0,0,6089
878,857,21,715,142,1993,1575,276800,870,8,99.09,0.91,680,238,42,19,0,0,0,19,0,0,0,104,543,149,164,6090
367,367,0,356,11,1980,1542,420600,364,3,99.18,0.82,98,31,192,4,38,0,15,3,16,0,6,22,138,79,84,6091
395,334,61,282,52,1984,795,150000,395,0,100.00,0.00,248,33,146,36,56,0,53,0,0,0,32,287,94,0,0,6092
661,591,70,157,434,1975,616,73100,200,461,30.26,69.74,97,68,97,63,269,76,148,0,0,0,206,66,0,0,0,6093
269,234,35,130,104,1942,664,99600,168,101,62.45,37.55,0,59,19,0,180,34,40,10,0,0,38,102,9,0,0,6094
232,232,0,128,104,1963,608,95000,213,19,91.81,8.19,9,2,19,27,148,32,12,0,0,0,91,59,2,0,9,6095
1014,601,413,444,157,1986,762,160200,611,403,60.26,39.74,335,155,273,76,264,50,108,0,0,0,66,195,84,6,55,6096
271,271,0,214,57,1939,989,168200,256,15,94.46,5.54,8,28,56,8,124,0,68,0,0,0,8,89,41,0,0,6097
396,370,26,234,136,1949,735,162100,333,63,84.09,15.91,8,33,79,38,336,37,154,0,0,0,37,259,0,0,0,6098
417,349,68,267,82,1980,1167,234900,328,89,78.66,21.34,139,27,60,4,222,0,41,34,0,0,51,144,90,14,27,6099
566,552,14,266,286,1941,781,148000,459,107,81.10,18.90,41,41,0,92,400,53,41,78,0,0,0,286,84,0,0,6100
387,387,0,235,152,1975,738,223900,242,145,62.53,37.47,131,43,234,102,35,50,113,35,0,0,88,154,95,0,0,6101
836,774,62,402,372,1970,1096,193300,625,211,74.76,25.24,221,36,134,284,88,59,132,68,0,31,0,253,117,0,0,6102
303,303,0,164,139,1974,727,184100,242,61,79.87,20.13,68,56,120,27,61,13,124,31,0,0,60,104,0,0,0,6103
555,545,10,405,140,1993,981,174900,511,44,92.07,7.93,305,0,72,46,67,0,19,55,0,0,0,349,59,0,0,6104
658,615,43,197,418,1974,807,165400,431,227,65.50,34.50,178,120,119,74,201,24,281,67,23,0,28,236,13,0,0,6105
522,522,0,274,248,1967,1097,232400,437,85,83.72,16.28,27,0,113,76,259,0,104,18,0,0,12,79,135,32,15,6106
435,435,0,102,333,1963,647,243800,148,287,34.02,65.98,16,0,117,60,139,59,180,41,0,0,0,0,22,7,8,6107
511,494,17,193,301,1952,610,164600,292,219,57.14,42.86,10,13,12,0,415,131,68,8,0,0,31,195,17,0,0,6108
632,632,0,242,390,1962,982,245100,480,152,75.95,24.05,38,9,138,101,159,52,73,13,0,23,8,73,170,20,0,6109
688,671,17,500,171,1984,1053,160400,523,165,76.02,23.98,244,47,155,68,31,0,32,0,0,0,92,316,38,12,9,6110
1319,1215,104,1127,88,1995,0,186100,1202,117,91.13,8.87,716,141,41,473,30,0,16,32,13,0,196,662,208,82,19,6111
395,349,46,321,28,1975,1075,146600,278,117,70.38,29.62,32,52,240,45,26,0,4,0,0,0,117,188,45,0,0,6112
826,731,95,151,580,1973,811,155400,269,557,32.57,67.43,122,231,187,75,247,101,395,58,17,124,15,93,42,0,17,6113
321,247,74,231,16,1992,0,199800,191,130,59.50,40.50,27,83,153,0,62,0,35,9,0,0,0,58,80,22,53,6114
514,514,0,415,99,1985,0,136700,293,221,57.00,43.00,154,160,138,63,72,49,72,64,0,0,42,147,52,14,13,6115
880,793,87,446,347,1966,875,182600,687,193,78.07,21.93,157,103,242,88,334,51,191,80,8,0,17,443,95,0,0,6116
775,736,39,3,733,1979,859,0,122,653,15.74,84.26,320,77,245,55,206,63,626,0,0,18,11,22,34,0,0,6117
569,560,9,288,272,1992,769,251900,352,217,61.86,38.14,228,71,194,81,18,0,188,9,0,0,8,137,166,19,0,6118
480,456,24,289,167,1947,1186,133100,442,38,92.08,7.92,18,0,81,26,284,0,114,44,0,0,31,185,12,0,0,6119
737,712,25,290,422,1975,963,140400,462,275,62.69,37.31,204,87,121,59,283,152,166,21,31,0,9,246,41,14,11,6120
557,515,42,395,120,1975,1103,121400,382,175,68.58,31.42,141,57,116,31,199,0,117,86,0,0,73,252,0,0,0,6121
457,431,26,291,140,1963,813,197300,373,84,81.62,18.38,89,0,77,165,240,38,117,12,0,0,34,272,67,0,12,6122
657,619,38,403,216,1986,789,169200,513,144,78.08,21.92,236,110,140,39,109,125,170,63,0,0,22,166,41,7,19,6123
441,441,0,192,249,1975,766,133700,363,78,82.31,17.69,0,31,339,58,12,0,181,56,0,0,0,203,0,0,0,6124
336,250,86,85,165,1939,679,167800,238,98,70.83,29.17,0,0,14,0,245,46,0,27,0,0,43,69,30,13,0,6125
1003,957,46,478,479,1955,629,184700,635,368,63.31,36.69,126,10,160,113,545,148,137,90,0,0,10,334,121,8,27,6126
259,214,45,142,72,1955,577,159900,216,43,83.40,16.60,19,24,0,0,333,29,83,0,0,0,12,147,15,9,0,6127
156,124,32,43,81,1964,722,145800,88,68,56.41,43.59,0,46,25,47,79,0,84,11,0,0,0,79,11,0,0,6128
428,403,25,245,158,1962,769,146800,347,81,81.07,18.93,68,35,78,94,112,34,81,17,0,0,0,185,14,17,0,6129
895,850,45,551,299,1976,751,190400,518,377,57.88,42.12,119,81,324,202,101,56,143,83,0,0,127,328,49,0,14,6130
752,752,0,79,673,1978,780,125700,149,603,19.81,80.19,399,200,235,28,209,48,788,0,0,0,0,130,0,0,0,6131
687,192,495,92,100,1977,735,172400,552,135,80.35,19.65,129,24,168,143,172,6,13,17,0,0,26,102,30,10,0,6132
385,362,23,276,86,1972,558,205000,274,111,71.17,28.83,111,83,30,24,156,39,45,28,0,0,0,150,84,0,0,6133
1117,1074,43,698,376,1975,941,221400,889,228,79.59,20.41,294,171,236,280,57,29,199,13,0,0,0,453,176,49,19,6134
327,287,40,73,214,1939,715,252500,148,179,45.26,54.74,27,0,45,68,269,13,258,17,0,0,0,54,15,0,12,6135
263,229,34,127,102,1946,841,109100,152,111,57.79,42.21,0,0,27,12,167,0,69,6,0,0,12,92,6,0,0,6136
449,397,52,309,88,1953,1188,148100,408,41,90.87,9.13,22,9,71,39,343,26,72,32,0,0,20,250,22,0,0,6137
678,678,0,238,440,1973,593,117700,283,395,41.74,58.26,226,86,75,36,174,167,71,72,0,0,76,67,41,0,0,6138
1146,1134,12,289,845,1997,961,184000,506,640,44.15,55.85,795,121,94,16,0,16,416,69,13,0,22,356,77,0,0,6139
1102,1073,29,769,304,1979,949,134200,637,465,57.80,42.20,233,227,305,167,82,10,234,70,9,0,287,198,169,11,18,6140
558,502,56,374,128,1973,797,242900,439,119,78.67,21.33,44,88,240,64,114,22,96,54,0,0,0,142,115,18,50,6141
643,628,15,460,168,1955,1138,156600,619,24,96.27,3.73,0,19,11,24,519,0,116,19,0,0,28,396,0,0,14,6142
913,790,123,15,775,1975,784,0,15,898,1.64,98.36,193,196,496,186,202,296,872,0,0,0,0,0,25,0,0,6143
619,619,0,195,424,1959,593,141400,323,296,52.18,47.82,59,58,172,12,225,120,119,67,14,0,30,132,0,0,0,6144
496,496,0,273,223,1975,666,149800,377,119,76.01,23.99,217,83,186,155,54,70,146,63,0,59,10,219,78,9,14,6145
500,439,61,164,275,1954,899,189400,356,144,71.20,28.80,26,30,80,74,206,37,162,0,0,0,0,138,35,0,0,6146
610,499,111,254,245,1977,555,165100,369,241,60.49,39.51,76,0,142,109,217,48,113,18,0,0,15,141,81,0,7,6147
685,623,62,155,468,1962,725,254700,146,539,21.31,78.69,52,12,52,140,257,74,224,46,0,0,0,81,41,7,0,6148
505,341,164,249,92,1965,693,200600,362,143,71.68,28.32,60,37,113,47,231,4,42,0,0,0,76,130,63,12,5,6149
1021,982,39,588,394,1998,1000,344800,616,405,60.33,39.67,656,15,120,68,63,0,211,24,0,47,135,117,104,128,142,6150
252,252,0,224,28,1991,0,52000,82,170,32.54,67.46,217,10,46,0,0,0,0,10,0,0,204,19,0,0,0,6151
760,760,0,0,760,1971,1030,0,234,526,30.79,69.21,47,63,174,47,226,123,307,15,0,0,0,0,0,0,0,6152
517,436,81,382,54,1974,674,84100,281,236,54.35,45.65,27,38,114,82,233,20,23,9,0,0,108,254,9,0,0,6153
445,420,25,279,141,1952,793,157700,407,38,91.46,8.54,10,0,32,34,312,0,101,11,0,0,27,208,0,0,0,6154
1282,1241,41,961,280,1986,1147,194000,1216,66,94.85,5.15,456,124,218,28,78,27,26,23,0,0,35,526,182,11,20,6155
813,772,41,424,348,1978,912,190700,596,217,73.31,26.69,204,43,73,98,173,0,151,38,0,0,0,144,173,0,11,6156
225,195,30,111,84,1951,527,95000,181,44,80.44,19.56,29,25,17,14,163,29,75,0,0,0,72,18,30,7,3,6157
392,342,50,186,156,1939,550,136800,258,134,65.82,34.18,20,0,27,20,449,125,151,0,0,0,64,93,14,0,9,6158
393,364,29,226,138,1979,647,197700,159,234,40.46,59.54,126,97,74,40,174,43,85,0,0,0,69,184,43,0,11,6159
449,404,45,278,126,1958,615,99700,323,126,71.94,28.06,77,14,98,51,143,32,46,10,0,0,62,142,13,0,0,6160
542,472,70,261,211,1974,704,111900,354,188,65.31,34.69,76,87,105,101,211,92,78,6,0,0,256,117,0,0,0,6161
836,630,206,438,192,1958,643,120500,681,155,81.46,18.54,87,67,133,58,456,24,54,0,0,0,168,277,42,7,24,6162
309,260,49,146,114,1942,515,132400,198,111,64.08,35.92,12,15,28,12,233,43,42,0,0,0,74,103,0,0,27,6163
297,252,45,170,82,1966,705,98200,222,75,74.75,25.25,45,5,49,36,113,0,110,0,0,0,85,40,13,0,0,6164
527,435,92,164,271,1944,772,96400,419,108,79.51,20.49,58,11,155,61,309,43,185,0,0,0,102,135,15,0,0,6165
361,361,0,128,233,1957,611,550000,232,129,64.27,35.73,121,12,0,28,87,47,64,14,0,0,43,21,0,7,0,6166
718,586,132,124,462,1981,604,117600,159,559,22.14,77.86,110,234,80,90,127,169,145,43,11,0,57,106,7,0,0,6167
517,445,72,185,260,1960,703,138100,362,155,70.02,29.98,62,46,122,18,316,35,237,50,0,0,70,118,0,22,0,6168
428,428,0,201,227,1939,919,178500,293,135,68.46,31.54,27,10,28,0,324,54,80,0,0,0,29,144,10,0,10,6169
348,320,28,271,49,1957,834,167300,348,0,100.00,0.00,0,16,53,135,242,0,64,71,0,0,49,219,24,10,0,6170
494,377,117,281,96,1975,477,119300,357,137,72.27,27.73,20,86,159,7,129,57,7,14,0,0,57,177,28,0,5,6171
278,278,0,227,51,1982,1113,319500,266,12,95.68,4.32,67,77,31,11,69,0,0,0,11,0,44,44,83,30,32,6172
409,357,52,318,39,1977,917,231600,339,70,82.89,17.11,100,55,77,13,98,0,20,17,0,0,37,72,126,14,40,6173
1063,798,265,226,572,1970,772,187900,686,377,64.53,35.47,257,80,264,135,252,315,322,109,12,0,14,82,54,39,41,6174
1113,995,118,726,269,1991,813,221500,858,255,77.09,22.91,521,108,156,51,112,39,71,24,22,13,31,274,315,127,21,6175
348,348,0,281,67,1975,0,274300,212,136,60.92,39.08,87,89,134,32,28,13,22,0,0,0,113,41,48,44,63,6176
408,408,0,235,173,1972,828,188900,316,92,77.45,22.55,133,67,107,35,31,50,27,16,0,0,0,126,90,33,14,6177
362,362,0,330,32,1943,0,280800,362,0,100.00,0.00,0,0,24,11,312,0,13,37,5,0,21,100,141,18,12,6178
616,590,26,285,305,1945,990,364000,402,214,65.26,34.74,102,0,0,0,386,0,70,48,44,13,27,86,82,42,7,6179
327,299,28,207,92,1939,1583,445000,299,28,91.44,8.56,0,0,0,0,274,0,0,17,11,0,0,38,102,56,50,6180
577,577,0,103,474,1947,778,325000,147,430,25.48,74.52,67,0,27,19,243,90,100,28,0,0,9,29,100,0,0,6181
326,317,9,181,136,1939,972,331500,278,48,85.28,14.72,44,0,24,59,311,0,86,75,40,0,7,53,88,18,0,6182
445,439,6,343,96,1939,1486,344600,373,72,83.82,16.18,25,0,41,27,381,0,147,23,0,0,18,43,194,26,0,6183
462,432,30,284,148,1939,1205,304000,373,89,80.74,19.26,44,14,34,0,375,13,96,14,0,0,0,82,142,37,0,6184
410,410,0,374,36,1942,0,361600,343,67,83.66,16.34,0,30,14,0,619,0,86,25,20,0,0,80,255,117,44,6185
402,348,54,208,140,1941,1023,295500,367,35,91.29,8.71,0,10,8,5,292,8,22,50,0,0,0,31,130,12,0,6186
505,505,0,219,286,1939,727,338200,301,204,59.60,40.40,38,8,49,24,406,76,111,11,10,0,10,22,172,61,24,6187
471,441,30,292,149,1939,894,230000,342,129,72.61,27.39,25,51,0,28,361,0,136,12,0,0,0,150,144,0,0,6188
539,539,0,420,119,1939,1472,321900,503,36,93.32,6.68,62,0,25,15,389,0,16,87,9,29,8,96,212,22,0,6189
320,275,45,195,80,1939,896,271900,253,67,79.06,20.94,28,0,0,0,296,0,9,0,0,0,0,131,125,7,0,6190
448,418,30,185,233,1949,1057,249000,295,153,65.85,34.15,0,23,58,86,311,11,91,46,11,0,0,273,11,0,0,6191
390,390,0,215,175,1941,970,343600,302,88,77.44,22.56,0,8,8,0,259,0,17,33,0,42,16,48,84,0,0,6192
716,716,0,480,236,1967,849,207400,460,256,64.25,35.75,140,8,10,110,206,0,153,27,8,0,0,140,115,0,0,6193
983,941,42,379,562,1939,1064,728500,262,721,26.65,73.35,183,62,102,43,543,14,468,127,19,16,16,0,69,35,137,6194
521,495,26,0,495,1939,623,0,0,521,0.00,100.00,27,8,0,20,564,299,190,0,0,0,0,8,0,9,9,6195
452,452,0,13,439,1972,994,0,13,439,2.88,97.12,147,9,60,21,194,0,368,42,0,0,0,0,0,0,11,6196
491,461,30,138,323,1961,1646,387300,284,207,57.84,42.16,223,108,118,0,143,0,108,151,23,0,0,70,81,27,55,6197
539,514,25,317,197,1956,1362,285400,474,65,87.94,12.06,58,31,158,11,254,0,35,31,0,0,0,93,307,29,17,6198
388,388,0,183,205,1974,944,223300,164,224,42.27,57.73,44,91,228,96,128,0,340,17,0,0,0,0,121,10,0,6199
711,633,78,346,287,1955,651,283900,504,207,70.89,29.11,124,0,95,58,500,54,85,98,0,0,0,223,187,0,25,6200
843,808,35,397,411,1969,783,194400,402,441,47.69,52.31,105,25,160,102,350,42,179,53,0,0,18,127,194,0,0,6201
637,616,21,119,497,1972,740,218400,212,425,33.28,66.72,56,17,221,206,239,60,355,86,48,0,33,85,50,0,11,6202
1212,1164,48,317,847,1969,826,198600,393,819,32.43,67.57,260,18,138,131,345,0,289,170,30,74,0,217,57,0,0,6203
1091,1057,34,246,811,1971,871,202500,498,593,45.65,54.35,239,75,84,210,447,14,271,97,39,0,104,261,106,15,0,6204
450,415,35,337,78,1958,1281,200900,433,17,96.22,3.78,73,34,50,34,488,0,113,81,0,0,0,347,0,24,0,6205
680,604,76,478,126,1956,889,191700,673,7,98.97,1.03,153,26,40,81,429,0,10,55,20,0,14,453,47,0,0,6206
746,705,41,558,147,1975,1516,197700,705,41,94.50,5.50,153,165,182,154,21,0,42,41,0,0,11,337,194,0,10,6207
438,438,0,377,61,1956,1682,238400,438,0,100.00,0.00,12,0,66,111,364,0,0,14,0,0,15,196,282,0,0,6208
879,838,41,491,347,1986,962,177600,613,266,69.74,30.26,202,271,224,45,4,0,98,26,15,0,66,364,118,0,0,6209
814,777,37,307,470,1973,888,165500,421,393,51.72,48.28,102,117,444,69,209,8,349,26,0,0,56,303,109,0,0,6210
651,630,21,427,203,1979,1016,0,335,316,51.46,48.54,140,69,249,37,100,0,132,0,25,0,197,69,113,6,32,6211
1298,1204,94,657,547,1969,909,168100,724,574,55.78,44.22,233,137,371,299,223,25,297,138,0,0,34,424,196,0,8,6212
599,599,0,348,251,1964,999,157500,438,161,73.12,26.88,0,11,135,157,170,0,85,72,0,0,40,136,97,0,0,6213
357,357,0,340,17,1965,0,294900,357,0,100.00,0.00,0,12,74,299,70,0,0,12,9,16,0,69,309,40,0,6214
481,434,47,413,21,1974,0,911500,481,0,100.00,0.00,86,77,52,70,204,0,11,0,6,10,4,13,22,36,339,6215
677,677,0,524,153,2000,1381,334700,643,34,94.98,5.02,220,16,30,88,135,0,30,30,12,8,0,84,243,21,61,6216
708,615,93,485,130,1971,883,140100,353,355,49.86,50.14,193,95,234,362,232,135,57,113,11,0,299,229,145,0,0,6217
522,477,45,324,153,1984,508,111100,371,151,71.07,28.93,61,117,120,0,56,44,25,0,0,0,155,64,15,0,0,6218
826,609,217,144,465,1965,780,252200,358,468,43.34,56.66,163,107,83,46,319,26,168,43,0,34,9,72,80,12,43,6219
426,379,47,183,196,1967,771,279900,266,160,62.44,37.56,24,33,135,84,151,0,121,11,0,0,0,55,48,25,67,6220
334,259,75,231,28,1964,0,226100,222,112,66.47,33.53,47,80,58,97,179,70,40,42,0,0,84,146,36,0,18,6221
489,440,49,416,24,1985,0,157300,311,178,63.60,36.40,95,97,103,86,99,0,0,0,0,0,158,54,43,0,86,6222
737,506,231,382,124,1981,773,190500,500,237,67.84,32.16,156,83,118,14,46,0,14,9,0,0,89,27,43,0,80,6223
849,548,301,406,142,1975,530,121600,558,291,65.72,34.28,74,112,168,29,218,21,61,24,0,0,125,114,35,18,22,6224
932,376,556,323,53,1971,1272,203800,802,130,86.05,13.95,298,130,132,138,244,0,31,0,0,0,65,155,57,40,11,6225
236,145,91,68,77,1952,732,184200,187,49,79.24,20.76,15,0,176,54,138,15,71,20,0,0,123,107,47,0,0,6226
642,592,50,223,369,1965,618,114700,357,285,55.61,44.39,64,42,35,81,270,57,136,18,0,0,28,140,52,0,0,6227
407,361,46,241,120,1973,828,145600,341,66,83.78,16.22,27,81,120,14,90,0,76,83,0,0,30,107,14,0,0,6228
261,261,0,172,89,1956,664,0,159,102,60.92,39.08,9,23,64,11,154,32,8,0,23,0,40,143,0,0,0,6229
509,475,34,372,103,1963,645,143500,457,52,89.78,10.22,58,35,200,73,265,0,81,32,0,0,0,369,76,0,0,6230
295,261,34,179,82,1958,777,130800,224,71,75.93,24.07,45,24,35,12,142,23,24,0,0,0,52,131,15,0,0,6231
378,268,110,83,185,1939,580,87400,219,159,57.94,42.06,8,19,9,0,333,16,194,56,0,0,25,53,17,0,8,6232
419,419,0,113,306,1953,742,111800,302,117,72.08,27.92,18,38,80,11,253,49,169,0,0,0,13,119,15,0,0,6233
632,555,77,395,160,1980,671,186300,397,235,62.82,37.18,248,73,150,58,133,5,106,0,0,10,93,190,73,13,85,6234
995,942,53,255,687,1977,845,183400,304,691,30.55,69.45,244,99,215,154,53,45,416,64,33,0,0,71,73,8,0,6235
788,730,58,181,549,1987,834,0,208,580,26.40,73.60,200,106,519,105,75,0,582,40,0,0,176,87,0,0,0,6236
1374,1374,0,447,927,1994,850,253200,609,765,44.32,55.68,892,98,152,130,240,69,672,241,22,10,9,139,200,0,0,6237
446,393,53,267,126,1969,950,176900,387,59,86.77,13.23,0,18,211,185,10,0,104,42,36,0,12,164,66,0,0,6238
864,790,74,154,636,1985,1014,198200,232,632,26.85,73.15,452,269,268,17,11,35,533,93,11,17,11,182,76,0,10,6239
342,314,28,96,218,1966,905,162700,166,176,48.54,51.46,55,4,61,0,187,0,107,15,0,0,0,83,66,0,9,6240
542,542,0,179,363,1948,1042,394800,302,240,55.72,44.28,113,30,29,93,327,18,250,86,0,39,0,20,119,10,15,6241
477,427,50,261,166,1962,1210,257800,251,226,52.62,47.38,20,138,63,21,131,0,57,116,0,23,16,0,115,10,36,6242
777,777,0,454,323,1945,788,430100,598,179,76.96,23.04,65,13,42,0,669,0,55,47,86,15,0,93,251,100,92,6243
548,548,0,345,203,1950,1236,287900,515,33,93.98,6.02,49,0,30,0,400,0,37,104,0,0,14,118,176,30,0,6244
619,488,131,344,144,1943,1321,242200,582,37,94.02,5.98,64,0,33,54,435,12,96,77,0,0,0,248,153,0,0,6245
403,394,9,186,208,1952,1172,243800,347,56,86.10,13.90,41,13,0,4,248,0,66,41,0,0,4,109,86,0,0,6246
355,355,0,182,173,1959,1105,164000,303,52,85.35,14.65,27,0,67,79,245,0,45,40,30,0,0,281,22,0,0,6247
382,382,0,224,158,1951,871,282700,247,135,64.66,35.34,0,26,69,66,274,0,196,23,14,0,6,114,78,4,0,6248
593,593,0,339,254,1950,943,251500,474,119,79.93,20.07,55,19,47,9,323,0,54,57,46,0,26,170,100,0,0,6249
496,409,87,278,131,1956,1580,216200,486,10,97.98,2.02,32,10,25,52,421,11,41,106,0,0,9,239,90,22,0,6250
638,638,0,276,362,1971,993,264200,373,265,58.46,41.54,8,22,149,21,474,45,152,74,0,0,0,166,167,13,0,6251
322,322,0,154,168,1939,850,232800,275,47,85.40,14.60,43,23,34,8,392,48,86,41,0,0,0,156,62,0,0,6252
511,488,23,241,247,1939,909,353400,391,120,76.52,23.48,9,29,31,0,409,29,187,19,0,0,11,42,145,36,9,6253
470,389,81,251,138,1983,863,279100,372,98,79.15,20.85,83,17,84,12,173,0,33,19,0,0,16,63,58,48,21,6254
821,746,75,563,183,1994,1181,371900,622,199,75.76,24.24,344,16,13,113,68,14,44,46,0,0,13,55,117,123,84,6255
498,498,0,192,306,1969,873,287300,239,259,47.99,52.01,180,35,131,104,116,15,201,37,7,18,39,61,92,20,32,6256
624,624,0,317,307,1991,653,335200,427,197,68.43,31.57,295,51,48,23,176,111,158,47,40,0,0,79,90,9,20,6257
461,437,24,307,130,1959,542,73200,311,150,67.46,32.54,15,9,58,31,279,101,123,0,0,0,138,30,0,0,0,6258
940,900,40,192,708,1939,1185,293900,250,690,26.60,73.40,57,59,77,42,548,121,229,160,64,0,0,43,49,18,13,6259
404,404,0,286,118,1939,1278,393900,350,54,86.63,13.37,0,0,0,0,437,0,51,7,0,0,0,7,117,114,35,6260
638,638,0,156,482,1965,982,368100,167,471,26.18,73.82,125,10,52,30,412,30,288,52,66,9,10,0,76,61,26,6261
619,583,36,319,264,1946,888,402000,240,379,38.77,61.23,11,15,94,32,423,0,369,68,0,0,0,0,60,69,9,6262
318,288,30,288,0,1947,0,525000,288,30,90.57,9.43,12,0,11,33,319,0,41,41,0,0,0,19,60,87,69,6263
386,355,31,271,84,1953,1075,326900,362,24,93.78,6.22,0,0,57,0,307,39,39,30,32,0,17,84,56,0,29,6264
248,248,0,134,114,1939,1620,265000,238,10,95.97,4.03,15,14,21,94,199,0,27,12,69,0,21,164,50,0,0,6265
312,254,58,76,178,1954,879,276900,166,146,53.21,46.79,22,49,21,0,324,13,141,58,51,0,0,102,51,0,0,6266
1101,1101,0,557,544,1955,844,394400,639,462,58.04,41.96,113,80,162,96,665,22,350,21,67,0,0,67,232,216,42,6267
882,824,58,239,585,1939,918,306700,389,493,44.10,55.90,53,0,113,13,686,0,598,27,0,0,0,31,77,15,32,6268
371,358,13,156,202,1939,783,380800,163,208,43.94,56.06,0,0,13,50,171,0,76,0,10,0,0,41,35,31,41,6269
371,371,0,157,214,1939,1308,366200,228,143,61.46,38.54,93,12,0,0,226,0,57,34,51,0,0,14,76,45,23,6270
240,240,0,166,74,1939,1231,719400,166,74,69.17,30.83,12,0,0,0,269,0,35,12,20,0,0,0,24,27,139,6271
309,290,19,239,51,1939,1911,487500,309,0,100.00,0.00,0,0,38,0,252,0,0,0,26,0,0,11,65,60,106,6272
413,392,21,346,46,1939,0,584600,413,0,100.00,0.00,0,0,0,0,362,0,0,0,0,0,0,0,31,159,145,6273
706,694,12,569,125,1939,1505,373700,698,8,98.87,1.13,0,0,21,0,655,0,41,57,35,0,18,39,211,183,83,6274
381,359,22,320,39,1939,1664,371800,362,19,95.01,4.99,0,0,0,27,443,0,32,66,10,0,0,58,182,48,0,6275
817,817,0,787,30,1985,0,484200,817,0,100.00,0.00,247,171,30,113,36,0,0,0,28,27,18,74,98,34,318,6276
730,696,34,642,54,1967,0,285100,730,0,100.00,0.00,37,0,313,311,157,0,0,30,11,0,0,161,541,66,0,6277
581,556,25,398,158,1981,989,230100,511,70,87.95,12.05,113,75,72,124,133,13,50,93,0,0,9,112,138,12,77,6278
1029,945,84,758,187,1987,620,238300,847,182,82.31,17.69,257,104,362,70,127,87,106,15,12,0,0,286,325,30,37,6279
537,472,65,404,68,1963,1611,766100,537,0,100.00,0.00,50,43,91,118,172,0,0,15,38,0,14,27,56,81,243,6280
557,557,0,187,370,1985,1143,420600,319,238,57.27,42.73,95,168,80,39,104,12,112,36,20,0,0,32,30,19,122,6281
816,816,0,230,586,1968,958,526500,182,634,22.30,77.70,109,79,189,139,251,17,340,97,24,0,0,71,41,0,96,6282
1129,1036,93,525,511,1992,1077,46800,229,900,20.28,79.72,555,84,147,197,244,10,493,118,0,0,348,61,11,0,0,6283
1192,1035,157,357,678,1978,972,192100,654,538,54.87,45.13,415,232,284,75,258,52,404,133,22,0,37,120,262,73,0,6284
468,419,49,245,174,1951,940,188800,367,101,78.42,21.58,45,23,76,20,234,11,69,44,0,9,12,170,59,0,24,6285
467,410,57,237,173,1957,1579,615300,374,93,80.09,19.91,27,24,42,62,280,7,32,9,0,42,11,42,0,78,163,6286
525,520,5,297,223,1986,899,563300,347,178,66.10,33.90,47,42,65,94,150,25,109,21,0,0,0,5,21,37,113,6287
764,701,63,290,411,1971,817,224200,231,533,30.24,69.76,104,64,203,111,223,46,159,36,51,0,94,172,112,9,26,6288
292,243,49,97,146,1939,723,223600,148,144,50.68,49.32,0,0,49,57,280,40,56,9,0,0,51,120,16,23,0,6289
628,607,21,564,43,1976,1276,304400,593,35,94.43,5.57,121,64,270,34,201,0,10,10,28,0,31,76,178,142,185,6290
460,445,15,426,19,2001,0,253300,445,15,96.74,3.26,286,0,102,23,57,0,15,25,34,12,0,149,169,64,0,6291
759,743,16,260,483,1982,956,0,193,566,25.43,74.57,341,130,162,0,22,27,418,41,0,0,126,43,0,0,0,6292
544,544,0,263,281,1973,856,214400,380,164,69.85,30.15,28,16,130,49,257,0,149,13,0,0,15,192,111,0,0,6293
587,587,0,380,207,1958,997,211200,515,72,87.73,12.27,48,0,48,99,295,17,17,33,18,0,0,246,108,51,0,6294
470,437,33,144,293,1975,770,178800,145,325,30.85,69.15,101,33,236,42,129,0,194,84,0,0,52,34,77,12,0,6295
286,261,25,19,242,1992,805,0,73,213,25.52,74.48,195,0,29,36,50,36,245,0,0,0,0,0,0,0,0,6296
396,396,0,299,97,1961,1100,217100,352,44,88.89,11.11,22,19,114,55,24,0,45,32,0,7,0,125,25,0,0,6297
540,333,207,264,69,1979,550,130000,375,165,69.44,30.56,56,41,105,19,250,23,4,0,0,0,135,65,30,2,57,6298
501,453,48,106,347,1939,1031,226500,31,470,6.19,93.81,0,12,0,66,471,44,344,97,0,0,0,49,11,4,0,6299
415,415,0,335,80,1980,0,221100,332,83,80.00,20.00,122,78,149,60,91,61,32,0,0,0,0,228,155,24,0,6300
431,366,65,45,321,1955,783,166500,215,216,49.88,50.12,21,10,58,21,448,66,209,52,0,0,11,181,0,0,0,6301
482,392,90,260,132,1977,1100,143700,470,12,97.51,2.49,76,95,367,17,57,17,21,82,0,0,20,459,0,0,0,6302
550,550,0,125,425,1970,819,136900,240,310,43.64,56.36,82,114,398,42,129,143,312,0,0,0,17,150,0,0,0,6303
1230,1181,49,664,517,1990,963,218200,706,524,57.40,42.60,469,231,446,72,41,19,210,109,0,0,9,406,271,50,25,6304
639,551,88,332,219,1978,962,201500,349,290,54.62,45.38,68,63,517,0,41,15,302,0,0,0,177,71,124,0,0,6305
275,275,0,265,10,1939,0,289900,269,6,97.82,2.18,25,0,0,66,221,0,63,36,0,0,0,60,105,10,0,6306
372,349,23,306,43,1972,745,163300,240,132,64.52,35.48,70,36,71,37,170,0,85,25,0,0,41,85,53,0,14,6307
431,431,0,245,186,1994,1029,223900,267,164,61.95,38.05,195,14,96,113,29,0,161,19,0,0,24,58,128,0,0,6308
473,473,0,319,154,1975,811,281100,336,137,71.04,28.96,154,55,145,75,64,0,189,7,17,0,0,121,91,0,0,6309
1264,1211,53,225,986,1967,1178,261400,149,1115,11.79,88.21,345,10,33,30,658,0,374,247,82,9,0,37,66,0,86,6310
372,272,100,144,128,1982,995,168100,217,155,58.33,41.67,61,42,154,7,212,87,112,20,0,0,22,148,43,0,29,6311
402,286,116,240,46,1969,740,259400,316,86,78.61,21.39,42,155,42,24,184,0,52,0,0,0,37,89,83,83,43,6312
413,316,97,247,69,1958,986,200800,388,25,93.95,6.05,28,0,9,118,253,0,38,48,0,0,18,208,39,0,8,6313
242,195,47,165,30,1955,438,230700,232,10,95.87,4.13,19,0,45,7,123,0,10,18,0,0,17,104,18,12,15,6314
381,379,2,260,119,1979,608,160800,280,101,73.49,26.51,146,57,73,49,45,52,45,80,13,0,0,87,68,14,11,6315
419,351,68,209,142,1965,698,128100,411,8,98.09,1.91,0,0,66,71,205,42,149,0,0,0,13,130,8,0,0,6316
296,263,33,209,54,1939,1025,106800,238,58,80.41,19.59,15,0,50,31,209,50,104,15,0,0,4,86,30,0,0,6317
447,431,16,333,98,1972,0,208800,335,112,74.94,25.06,108,15,120,95,150,41,94,0,0,0,62,175,90,26,0,6318
536,465,71,317,148,1956,569,89000,425,111,79.29,20.71,78,72,63,38,244,29,47,0,0,0,98,107,61,31,9,6319
452,368,84,317,51,1988,760,144600,270,182,59.73,40.27,131,66,108,78,63,8,71,10,0,0,54,217,34,0,3,6320
574,574,0,208,366,1955,938,207400,434,140,75.61,24.39,151,0,76,188,162,17,97,59,0,0,13,51,138,0,29,6321
522,351,171,328,23,1971,0,231300,407,115,77.97,22.03,76,171,78,35,227,71,0,32,0,0,53,142,58,16,81,6322
308,238,70,169,69,1977,667,165900,231,77,75.00,25.00,61,24,57,32,102,13,40,0,0,0,27,108,19,3,12,6323
384,293,91,240,53,1974,684,228300,202,182,52.60,47.40,83,20,101,193,57,11,101,0,0,0,53,132,54,31,72,6324
419,380,39,264,116,1960,597,110000,286,133,68.26,31.74,39,63,54,56,189,21,38,0,0,0,91,205,0,0,1,6325
653,542,111,409,133,1965,937,164000,534,119,81.78,18.22,67,129,101,137,208,42,41,43,9,0,43,119,73,17,42,6326
371,361,10,218,143,1966,367,122400,244,127,65.77,34.23,63,0,116,32,175,99,77,35,0,0,39,71,9,0,0,6327
1119,1019,100,658,361,1997,814,64000,671,448,59.96,40.04,398,146,302,0,187,11,0,46,0,0,324,544,22,16,33,6328
391,339,52,260,79,1965,725,240700,367,24,93.86,6.14,34,46,76,22,127,9,89,0,0,0,23,77,45,0,12,6329
282,282,0,268,14,1958,0,213600,223,59,79.08,20.92,94,32,68,18,103,0,0,0,11,0,39,95,60,21,37,6330
357,309,48,145,164,1981,633,0,211,146,59.10,40.90,33,48,142,12,210,47,191,0,0,0,62,135,10,0,0,6331
326,286,40,81,205,1956,582,153900,117,209,35.89,64.11,55,0,75,0,156,56,29,0,18,0,56,42,0,15,0,6332
292,292,0,76,216,1957,478,156600,125,167,42.81,57.19,15,14,16,14,245,75,119,14,0,0,15,67,0,0,0,6333
625,625,0,380,245,1973,1132,164800,620,5,99.20,0.80,273,29,235,85,57,0,68,96,35,0,43,364,15,0,0,6334
912,800,112,336,464,1963,788,199600,437,475,47.92,52.08,36,43,255,210,334,37,389,38,0,0,77,244,47,0,0,6335
600,600,0,545,55,1982,1155,342400,600,0,100.00,0.00,153,20,83,110,97,0,0,10,13,0,0,41,256,107,28,6336
549,537,12,287,250,1966,1359,189900,466,83,84.88,15.12,81,12,42,30,281,0,145,9,0,0,20,162,34,0,12,6337
535,535,0,428,107,1967,1399,250000,443,92,82.80,17.20,49,0,176,344,37,0,0,11,46,0,0,244,219,0,49,6338
593,550,43,181,369,1985,1186,262500,224,369,37.77,62.23,238,135,219,0,0,11,139,15,0,105,14,113,129,24,11,6339
298,257,41,117,140,1961,836,160800,236,62,79.19,20.81,7,52,23,43,69,3,66,0,0,0,0,94,20,0,0,6340
353,353,0,353,0,1951,0,599900,337,16,95.47,4.53,0,6,0,36,191,0,0,0,0,0,0,15,24,62,132,6341
622,622,0,238,384,1949,844,325200,277,345,44.53,55.47,21,131,84,117,235,0,319,47,0,0,0,67,62,33,0,6342
446,446,0,131,315,1972,681,115900,258,188,57.85,42.15,50,21,89,37,303,20,202,40,0,0,40,112,0,0,0,6343
663,621,42,269,352,1985,734,151500,416,247,62.75,37.25,63,8,101,53,296,20,179,14,0,0,30,231,0,0,0,6344
573,548,25,276,272,1986,807,211900,368,205,64.22,35.78,293,45,35,92,106,11,243,7,0,0,0,201,89,10,10,6345
590,590,0,342,248,1958,1201,221600,401,189,67.97,32.03,122,24,20,55,229,0,73,116,0,0,9,184,28,0,0,6346
715,583,132,423,160,1979,1107,249800,575,140,80.42,19.58,194,46,292,47,0,0,89,55,24,0,0,177,184,0,14,6347
574,505,69,255,250,1949,810,124000,468,106,81.53,18.47,56,0,58,13,289,48,65,0,0,0,85,202,9,0,0,6348
546,546,0,516,30,1988,0,278000,526,20,96.34,3.66,294,155,70,0,75,0,35,55,13,0,24,140,170,48,41,6349
570,437,133,269,168,1964,517,180000,345,225,60.53,39.47,46,111,297,79,119,67,142,0,0,0,102,127,13,0,22,6350
287,266,21,46,220,1986,827,202800,69,218,24.04,75.96,230,16,0,98,41,111,218,0,0,0,0,13,13,0,0,6351
527,496,31,418,78,1976,1730,276700,527,0,100.00,0.00,0,122,387,0,0,0,0,17,0,0,0,141,279,40,0,6352
923,906,17,277,629,1980,823,226900,312,611,33.80,66.20,246,222,161,8,181,64,415,45,0,0,0,150,59,0,0,6353
444,426,18,279,147,1985,828,234700,327,117,73.65,26.35,142,15,96,11,185,0,65,7,0,0,66,110,95,24,33,6354
794,547,247,244,303,1958,1041,237500,534,260,67.25,32.75,49,69,153,20,158,12,90,0,0,0,63,132,60,13,7,6355
388,293,95,138,155,1954,1276,212000,311,77,80.15,19.85,106,87,54,27,135,0,193,43,0,0,0,82,27,0,14,6356
836,551,285,459,92,1975,669,237300,636,200,76.08,23.92,165,89,147,122,143,28,47,34,10,0,16,129,51,5,87,6357
358,330,28,277,53,1965,847,245900,277,81,77.37,22.63,52,50,72,47,72,0,80,12,22,0,14,39,54,8,48,6358
459,459,0,391,68,1980,1267,27700,179,280,39.00,61.00,39,20,253,59,2,31,47,0,0,0,163,87,45,0,0,6359
991,811,180,105,706,1971,827,106500,408,583,41.17,58.83,205,84,245,88,118,16,380,38,12,67,15,110,25,0,0,6360
816,799,17,355,444,1978,631,130300,427,389,52.33,47.67,212,0,213,63,361,103,178,47,0,0,105,187,71,0,0,6361
629,629,0,498,131,1942,1213,373300,551,78,87.60,12.40,8,0,9,0,555,0,10,94,51,0,0,71,229,71,8,6362
527,527,0,386,141,1959,719,129100,469,58,88.99,11.01,64,0,95,69,298,0,180,57,0,0,51,219,0,0,0,6363
863,787,76,475,312,1983,1108,263800,679,184,78.68,21.32,340,245,251,61,6,0,68,57,0,95,0,213,215,60,142,6364
434,422,12,326,96,1948,1226,354100,426,8,98.16,1.84,0,20,44,40,256,0,0,0,21,0,0,68,123,77,42,6365
612,557,55,97,460,1939,633,331300,244,368,39.87,60.13,11,36,0,0,503,118,248,0,0,0,0,55,27,9,13,6366
730,683,47,533,150,1974,1372,279100,657,73,90.00,10.00,81,92,273,141,43,0,0,68,16,7,35,202,203,30,0,6367
630,615,15,211,404,1977,915,199500,268,362,42.54,57.46,132,0,86,109,391,0,179,53,0,0,57,169,88,0,0,6368
337,299,38,215,84,1959,1708,314600,337,0,100.00,0.00,0,0,20,99,250,0,9,55,15,0,0,106,152,32,0,6369
500,500,0,203,297,1976,713,143500,257,243,51.40,48.60,90,38,160,164,167,61,206,78,0,0,149,125,0,0,0,6370
1437,1377,60,1043,334,1993,1105,250900,1036,401,72.09,27.91,649,114,199,109,43,0,97,90,33,0,174,110,180,218,170,6371
586,394,192,231,163,1972,508,104000,393,193,67.06,32.94,92,50,148,38,303,61,28,0,0,0,99,86,34,3,42,6372
506,369,137,280,89,1982,0,0,235,271,46.44,53.56,215,129,260,21,94,0,58,26,0,0,229,178,83,23,32,6373
491,356,135,262,94,1965,558,196400,365,126,74.34,25.66,104,44,143,46,318,21,33,0,0,0,68,77,47,15,97,6374
516,479,37,358,121,1976,1220,220400,516,0,100.00,0.00,42,113,174,138,7,0,0,38,0,0,21,272,89,0,11,6375
556,493,63,259,234,1973,1229,394200,391,165,70.32,29.68,37,31,242,131,62,0,57,58,97,0,0,35,148,35,25,6376
624,561,63,182,379,1939,772,333800,357,267,57.21,42.79,45,60,91,81,288,32,170,53,9,0,9,29,28,60,61,6377
346,293,53,129,164,1939,749,393200,187,159,54.05,45.95,44,0,0,39,278,0,103,41,13,0,0,33,59,47,30,6378
647,640,7,413,227,1969,1282,241600,647,0,100.00,0.00,10,27,194,141,194,0,53,98,0,0,0,182,181,0,14,6379
517,472,45,472,0,1980,0,223300,504,13,97.49,2.51,177,236,176,18,15,0,62,7,0,0,18,330,187,0,0,6380
559,487,72,167,320,1974,773,153400,247,312,44.19,55.81,112,76,131,116,87,34,213,0,26,0,0,117,80,0,14,6381
1234,782,452,538,244,1990,1056,267200,974,260,78.93,21.07,340,218,233,179,297,106,132,23,0,0,111,245,199,59,114,6382
397,379,18,276,103,1976,1434,492300,386,11,97.23,2.77,145,32,161,114,60,0,55,52,0,0,51,51,46,77,143,6383
633,633,0,346,287,1939,1217,363500,523,110,82.62,17.38,22,0,0,0,615,0,70,10,34,0,0,107,319,66,31,6384
631,631,0,312,319,1992,636,110600,250,381,39.62,60.38,442,136,189,20,104,74,229,0,0,0,381,115,41,0,0,6385
460,206,254,167,39,1965,803,90400,376,84,81.74,18.26,68,81,59,41,223,38,53,0,0,0,65,58,25,6,17,6386
522,487,35,445,42,1976,0,328800,410,112,78.54,21.46,130,33,130,15,60,0,14,15,0,0,16,79,195,25,11,6387
284,194,90,121,73,1958,677,199000,251,33,88.38,11.62,41,43,55,34,143,3,57,3,0,0,49,62,30,3,14,6388
252,252,0,208,44,1985,1183,178600,252,0,100.00,0.00,134,61,115,0,15,0,0,71,0,0,0,74,150,30,0,6389
303,291,12,193,98,1974,777,139500,218,85,71.95,28.05,29,11,47,26,14,0,24,56,0,0,0,29,18,0,0,6390
40,27,13,7,20,1939,625,0,32,8,80.00,20.00,0,17,0,0,0,0,17,0,0,0,0,0,0,0,0,6391
686,619,67,50,569,1965,397,305600,58,628,8.45,91.55,67,56,69,210,265,342,205,10,0,0,16,82,0,0,0,6392
252,252,0,207,45,1939,0,785500,245,7,97.22,2.78,0,0,0,15,284,0,0,14,0,0,0,27,0,32,226,6393
284,235,49,189,46,1971,0,203900,284,0,100.00,0.00,7,0,133,98,36,0,55,10,0,0,0,190,19,0,0,6394
588,546,42,372,174,1972,850,281600,481,107,81.80,18.20,101,42,238,43,140,0,122,0,0,0,27,183,170,49,0,6395
272,228,44,118,110,1974,883,187200,118,154,43.38,56.62,143,26,156,23,56,21,195,24,0,0,12,56,69,0,4,6396
287,287,0,92,195,1947,726,258200,198,89,68.99,31.01,0,0,46,33,176,9,96,10,0,0,0,85,45,0,0,6397
1242,1205,37,581,624,1984,765,270500,734,508,59.10,40.90,396,222,186,183,110,84,322,27,0,0,0,243,363,44,0,6398
883,310,573,125,185,1950,1002,295300,643,240,72.82,27.18,89,165,118,70,550,45,232,0,20,0,0,36,77,11,0,6399
691,501,190,376,125,1983,790,261900,517,174,74.82,25.18,255,114,102,68,149,0,90,9,0,0,10,147,210,10,42,6400
506,374,132,147,227,1939,774,362800,388,118,76.68,23.32,47,21,13,40,220,0,38,39,0,26,16,21,112,6,44,6401
890,890,0,497,393,1976,1077,551800,570,320,64.04,35.96,86,157,99,386,165,0,286,40,0,0,0,27,12,102,308,6402
555,345,210,254,91,1970,573,207900,388,167,69.91,30.09,95,57,119,34,286,32,24,0,0,0,129,72,51,3,51,6403
1237,682,555,537,145,1986,991,199200,1022,215,82.62,17.38,549,208,231,87,37,9,60,36,0,0,5,236,140,93,94,6404
481,481,0,393,88,1968,1083,195700,427,54,88.77,11.23,87,16,26,28,337,0,121,10,0,0,18,269,44,0,0,6405
963,894,69,80,814,1983,712,140600,90,873,9.35,90.65,327,232,77,99,8,75,546,23,0,0,12,52,0,0,0,6406
361,361,0,85,276,1947,850,426900,122,239,33.80,66.20,0,30,96,0,262,0,160,21,0,0,0,28,90,66,0,6407
884,858,26,233,625,1957,719,235900,463,421,52.38,47.62,20,0,320,87,541,80,350,67,0,0,18,243,66,22,4,6408
364,364,0,145,219,1955,1084,239100,249,115,68.41,31.59,49,0,17,31,223,44,82,6,0,0,0,105,83,0,0,6409
471,432,39,195,237,1968,935,143900,364,107,77.28,22.72,73,17,245,55,251,63,289,29,0,0,74,155,0,0,0,6410
612,582,30,162,420,1981,630,157100,211,401,34.48,65.52,233,0,265,0,33,0,216,63,37,0,15,127,20,6,0,6411
782,646,136,310,336,1944,1222,320600,550,232,70.33,29.67,217,12,14,0,571,68,153,102,21,0,8,105,229,53,10,6412
1029,1017,12,307,710,1986,1124,357500,417,612,40.52,59.48,254,494,153,13,0,0,405,235,0,0,0,59,112,73,30,6413
883,789,94,71,718,1982,794,0,157,726,17.78,82.22,399,182,410,148,194,213,865,42,0,0,16,84,14,0,0,6414
912,385,527,344,41,1981,533,169400,736,176,80.70,19.30,264,142,187,66,198,7,16,0,0,0,128,130,43,13,44,6415
312,312,0,134,178,1962,843,111500,227,85,72.76,27.24,0,58,56,15,149,22,71,77,0,0,21,76,11,0,0,6416
710,561,149,470,91,1991,0,394100,568,142,80.00,20.00,109,45,154,21,191,19,32,11,0,0,23,92,88,29,149,6417
772,771,1,715,56,2003,1667,332000,758,14,98.19,1.81,448,63,42,30,44,0,0,0,0,33,15,97,245,108,81,6418
1106,1065,41,401,664,1973,962,376700,534,572,48.28,51.72,171,85,364,182,349,30,616,124,58,0,0,37,117,78,43,6419
741,628,113,461,167,1975,696,255200,518,223,69.91,30.09,137,101,239,69,90,62,36,0,0,0,34,103,121,32,82,6420
378,351,27,249,102,1957,1345,210800,342,36,90.48,9.52,109,83,10,13,202,0,22,106,32,0,42,167,10,27,0,6421
321,278,43,262,16,1977,0,174700,305,16,95.02,4.98,86,63,110,0,11,0,18,14,0,0,9,145,65,19,0,6422
625,575,50,332,243,1965,886,95000,485,140,77.60,22.40,134,18,183,105,104,14,106,0,0,0,137,247,0,0,13,6423
420,330,90,319,11,1984,0,288900,288,132,68.57,31.43,91,49,72,88,66,46,11,0,0,0,19,83,155,38,0,6424
1405,1393,12,325,1068,2001,1060,188400,374,1031,26.62,73.38,758,169,142,33,33,41,500,155,0,0,0,262,57,0,0,6425
700,700,0,539,161,1975,1171,242800,654,46,93.43,6.57,90,50,240,125,173,0,182,0,0,0,19,200,225,0,0,6426
542,441,101,137,304,1975,807,121900,182,360,33.58,66.42,89,0,344,50,144,12,360,6,0,0,33,155,10,0,26,6427
1553,604,949,444,160,1982,1164,274000,1398,155,90.02,9.98,628,216,282,113,126,48,22,43,0,0,20,202,153,51,114,6428
757,757,0,582,175,1971,1066,456300,649,108,85.73,14.27,60,56,198,165,97,0,23,12,0,0,0,0,80,122,339,6429
380,380,0,201,179,1981,568,0,135,245,35.53,64.47,56,117,34,91,26,20,62,0,0,0,60,96,21,0,0,6430
296,296,0,186,110,1965,1045,192000,250,46,84.46,15.54,33,15,81,0,107,0,78,0,0,0,0,90,68,0,0,6431
362,321,41,215,106,1939,1328,409900,258,104,71.27,28.73,37,13,0,9,293,10,60,50,21,0,0,10,78,68,42,6432
973,866,107,105,761,1993,738,0,81,892,8.32,91.68,218,205,111,132,83,95,533,0,0,0,43,78,0,0,0,6433
418,403,15,370,33,2001,0,598000,418,0,100.00,0.00,363,12,135,62,22,0,0,0,0,0,0,32,68,75,327,6434
895,794,101,172,622,1949,991,372500,229,666,25.59,74.41,20,17,44,101,710,29,452,143,66,0,17,0,81,0,64,6435
473,241,232,146,95,1972,0,172300,257,216,54.33,45.67,85,130,77,38,93,0,48,0,0,0,95,121,102,7,13,6436
466,426,40,360,66,1978,807,469200,422,44,90.56,9.44,59,47,131,31,149,0,24,60,0,0,31,39,70,49,117,6437
426,403,23,169,234,1968,1162,224300,269,157,63.15,36.85,131,48,27,0,304,0,183,81,50,0,9,76,73,12,0,6438
528,528,0,160,368,1985,774,192200,233,295,44.13,55.87,122,117,325,15,22,143,218,20,0,0,34,103,12,0,0,6439
392,346,46,192,154,1952,664,114400,305,87,77.81,22.19,85,13,108,32,207,16,90,18,0,0,98,165,3,0,0,6440
327,319,8,169,150,1963,458,104700,211,116,64.53,35.47,108,48,59,31,252,54,160,0,0,0,115,123,0,0,8,6441
683,580,103,451,129,1978,585,229700,517,166,75.70,24.30,93,70,221,47,183,17,61,10,0,0,33,172,64,27,85,6442
571,555,16,349,206,1967,850,167900,513,58,89.84,10.16,0,0,249,134,92,0,40,0,0,0,24,237,65,8,12,6443
610,307,303,219,88,1985,625,273400,443,167,72.62,27.38,126,13,119,84,184,0,45,7,0,0,19,53,62,30,81,6444
443,418,25,302,116,1962,1758,272900,417,26,94.13,5.87,0,16,46,65,294,0,23,33,19,0,0,158,171,0,17,6445
339,339,0,318,21,1990,1063,287200,339,0,100.00,0.00,126,121,91,0,0,12,0,0,0,0,0,26,290,0,0,6446
355,355,0,194,161,1969,1091,278700,262,93,73.80,26.20,84,0,145,39,82,0,124,13,0,0,0,39,153,0,21,6447
1555,1430,125,933,497,1995,1416,242400,1110,445,71.38,28.62,1065,160,185,43,14,0,132,178,105,42,12,212,522,122,59,6448
668,668,0,308,360,1971,1238,328900,338,330,50.60,49.40,71,43,21,14,363,0,137,23,23,0,20,14,74,70,92,6449
1329,878,451,591,287,1983,510,69900,595,734,44.77,55.23,261,184,332,115,126,53,56,0,0,0,123,197,48,4,31,6450
1304,1103,201,768,335,1979,688,214000,865,439,66.33,33.67,300,109,356,133,245,62,76,0,0,0,60,359,173,71,130,6451
733,733,0,456,277,1951,1386,328900,664,69,90.59,9.41,108,0,20,7,431,0,62,95,15,0,14,163,176,31,10,6452
900,662,238,0,662,1990,690,0,108,792,12.00,88.00,237,122,195,95,203,171,353,164,17,0,0,0,0,0,0,6453
345,293,52,259,34,1980,950,358300,300,45,86.96,13.04,101,49,117,49,43,0,10,0,0,0,0,24,54,61,126,6454
979,926,53,476,450,1983,935,236200,563,416,57.51,42.49,360,294,202,28,0,9,292,47,0,0,8,208,300,11,0,6455
322,290,32,193,97,1977,929,215400,225,97,69.88,30.12,59,56,82,29,74,45,0,21,0,0,26,117,72,8,11,6456
752,669,83,519,150,2003,1087,141900,639,113,84.97,15.03,480,165,53,37,0,0,69,97,0,0,288,274,7,0,0,6457
830,736,94,600,136,1977,1198,226400,781,49,94.10,5.90,385,0,242,89,105,0,102,66,0,0,23,229,340,32,8,6458
319,279,40,47,232,1980,744,118400,132,187,41.38,58.62,45,71,14,26,81,0,178,0,0,0,17,16,0,8,18,6459
458,410,48,0,410,1974,1002,0,0,458,0.00,100.00,66,58,320,130,36,0,464,54,0,0,0,8,15,0,0,6460
277,238,39,159,79,1959,607,358300,221,56,79.78,20.22,87,58,60,36,78,19,73,11,0,0,49,18,66,26,31,6461
728,622,106,241,381,1955,758,226300,485,243,66.62,33.38,11,10,83,57,572,81,133,186,0,0,12,241,50,6,0,6462
686,646,40,499,147,1955,1015,218100,611,75,89.07,10.93,165,30,79,184,398,0,224,58,12,0,13,189,160,96,91,6463
808,808,0,55,753,1977,915,9999,0,808,0.00,100.00,159,81,311,279,36,0,615,25,0,0,97,10,0,0,0,6464
632,632,0,196,436,1975,861,230300,209,423,33.07,66.93,60,114,243,160,40,32,262,78,0,0,9,104,69,0,0,6465
395,395,0,341,54,1976,0,327600,386,9,97.72,2.28,49,13,299,15,0,0,29,0,0,0,0,145,153,38,11,6466
1265,1265,0,796,469,2000,1407,338200,1045,220,82.61,17.39,681,355,72,0,22,0,134,69,46,19,5,41,557,153,32,6467
1240,1196,44,413,783,1973,902,203900,577,663,46.53,53.47,51,139,430,435,126,51,503,85,0,0,13,370,102,0,0,6468
389,389,0,223,166,1976,336,9999,30,359,7.71,92.29,84,199,132,0,32,74,87,16,0,0,169,87,0,0,0,6469
613,510,103,235,275,1966,818,308300,300,313,48.94,51.06,123,22,69,53,118,0,63,0,0,0,0,97,11,75,40,6470
559,517,42,501,16,1996,0,350300,543,16,97.14,2.86,277,0,12,17,14,0,0,24,0,0,0,13,186,80,17,6471
1240,1109,131,575,534,2000,1174,296100,760,480,61.29,38.71,870,91,13,7,67,14,300,279,20,0,54,70,150,8,71,6472
288,288,0,215,73,1973,941,233400,238,50,82.64,17.36,73,0,107,0,39,17,6,12,0,0,0,102,73,0,9,6473
349,308,41,248,60,1976,1117,232100,349,0,100.00,0.00,51,65,146,0,0,0,0,20,0,0,0,97,81,64,0,6474
1186,1079,107,192,887,1998,1110,299300,207,979,17.45,82.55,894,62,135,18,30,15,537,173,17,0,0,12,174,44,0,6475
369,344,25,259,85,1979,715,237200,284,85,76.96,23.04,51,20,68,44,197,9,14,11,0,0,36,174,61,23,10,6476
418,384,34,240,144,1992,666,133300,357,61,85.41,14.59,122,104,52,65,78,87,103,28,0,0,22,170,0,0,11,6477
375,313,62,211,102,1939,612,173800,293,82,78.13,21.87,0,27,0,56,327,12,90,29,0,0,14,173,92,0,0,6478
394,373,21,115,258,1962,1087,254400,301,93,76.40,23.60,91,0,158,58,154,29,179,25,10,0,10,188,15,5,0,6479
137,101,36,31,70,1966,806,0,42,95,30.66,69.34,25,0,36,24,113,25,97,0,0,0,0,15,18,0,0,6480
714,645,69,230,415,1974,859,190100,445,269,62.32,37.68,112,11,220,66,284,10,255,168,11,0,15,190,0,0,0,6481
455,304,151,276,28,1980,817,291200,423,32,92.97,7.03,203,75,85,12,137,3,7,0,0,3,14,68,84,17,75,6482
488,431,57,181,250,1978,1026,382500,386,102,79.10,20.90,158,59,77,57,226,18,142,99,21,8,0,0,70,30,117,6483
490,442,48,78,364,1939,784,132100,287,203,58.57,41.43,36,10,85,11,379,119,193,28,0,0,9,136,26,0,0,6484
601,601,0,335,266,1968,863,191300,373,228,62.06,37.94,101,90,91,262,165,0,277,16,9,0,21,208,65,16,0,6485
1347,1070,277,628,442,2000,793,124700,1070,277,79.44,20.56,981,132,86,0,0,0,249,107,0,0,150,487,97,18,0,6486
458,312,146,117,195,1972,626,168600,213,245,46.51,53.49,98,154,87,33,294,93,207,0,0,0,41,65,42,0,7,6487
813,750,63,512,238,1939,1276,277500,749,64,92.13,7.87,36,22,42,84,607,0,186,67,11,0,10,188,209,35,11,6488
470,442,28,226,216,1939,1421,371600,355,115,75.53,24.47,32,18,62,0,290,115,58,48,29,0,0,12,93,27,7,6489
1053,1017,36,873,144,1974,1598,280800,1053,0,100.00,0.00,113,216,298,87,212,0,18,12,22,0,0,276,483,53,52,6490
543,543,0,361,182,1959,913,228300,432,111,79.56,20.44,31,0,53,130,297,0,132,89,0,0,16,171,103,0,0,6491
385,344,41,193,151,1980,645,123200,271,114,70.39,29.61,188,35,34,103,47,45,29,15,0,0,178,95,9,0,0,6492
306,306,0,76,230,1967,853,184100,180,126,58.82,41.18,50,16,44,77,179,32,130,52,0,0,0,75,37,0,0,6493
312,268,44,198,70,1963,620,187300,298,14,95.51,4.49,48,11,34,0,96,0,45,13,0,0,12,85,21,13,0,6494
248,196,52,171,25,1969,0,135000,199,49,80.24,19.76,18,11,95,62,56,0,23,0,0,0,0,198,0,11,0,6495
299,264,35,248,16,1974,738,170800,228,71,76.25,23.75,87,12,99,29,52,41,0,0,0,0,50,61,53,0,0,6496
689,636,53,450,186,1939,1470,318800,617,72,89.55,10.45,0,0,18,43,520,0,39,27,60,0,13,144,250,0,33,6497
546,520,26,270,250,1939,936,304100,368,178,67.40,32.60,89,0,42,41,492,65,128,27,0,0,0,282,138,18,0,6498
982,908,74,328,580,1974,881,230500,490,492,49.90,50.10,236,30,170,166,321,170,182,114,0,0,0,298,68,23,16,6499
351,351,0,328,23,1959,0,380600,319,32,90.88,9.12,51,37,28,29,283,0,39,10,26,0,11,31,96,63,124,6500
590,545,45,391,154,1979,594,185600,405,185,68.64,31.36,180,62,134,14,160,15,14,0,0,0,100,208,126,62,19,6501
317,317,0,142,175,1966,860,160400,225,92,70.98,29.02,60,15,126,0,247,91,31,13,0,0,31,127,46,19,10,6502
708,604,104,412,192,1964,619,135900,582,126,82.20,17.80,63,51,132,91,400,42,136,10,4,0,84,237,61,19,15,6503
342,274,68,143,131,1948,850,93200,285,57,83.33,16.67,122,0,54,45,205,0,21,0,0,25,133,64,8,10,14,6504
1119,1024,95,312,712,1965,745,129900,527,592,47.10,52.90,174,172,226,253,231,217,383,64,12,82,0,157,59,0,0,6505
1078,974,104,367,607,1985,784,163500,533,545,49.44,50.56,351,52,108,83,372,158,311,38,0,0,7,365,25,0,0,6506
977,895,82,359,536,1969,878,172900,500,477,51.18,48.82,132,73,295,252,246,36,461,67,0,0,1,328,47,0,0,6507
524,524,0,490,34,1992,0,220600,433,91,82.63,17.37,329,59,138,0,33,12,15,55,0,0,115,210,141,0,11,6508
373,373,0,342,31,1967,0,266200,373,0,100.00,0.00,11,11,106,279,8,0,15,0,0,0,0,150,171,5,8,6509
627,565,62,318,247,1969,802,226200,395,232,63.00,37.00,93,192,145,45,216,151,179,55,0,0,0,226,45,0,0,6510
850,850,0,83,767,1939,947,357000,20,830,2.35,97.65,112,30,0,39,430,63,301,84,10,54,16,0,13,0,57,6511
450,450,0,409,41,1985,0,260000,450,0,100.00,0.00,99,264,122,12,0,0,0,0,8,0,0,175,266,24,0,6512
1296,921,375,615,306,1976,658,235200,935,361,72.15,27.85,326,118,211,117,424,25,150,0,0,0,67,270,202,59,33,6513
542,527,15,209,318,1946,563,168000,225,317,41.51,58.49,20,62,63,81,364,145,140,49,0,0,0,198,20,0,0,6514
521,396,125,279,117,1977,863,184200,357,164,68.52,31.48,91,67,86,14,195,5,70,0,0,0,70,102,45,4,24,6515
498,444,54,296,148,1939,1044,231300,432,66,86.75,13.25,18,0,16,34,417,52,78,21,0,0,6,152,148,8,20,6516
615,615,0,171,444,1991,773,258500,229,386,37.24,62.76,289,9,11,10,343,16,285,26,57,0,0,107,102,10,0,6517
511,473,38,184,289,1949,1197,296300,459,52,89.82,10.18,25,0,107,61,366,0,131,35,9,105,0,102,129,20,0,6518
551,551,0,456,95,1958,1349,195000,543,8,98.55,1.45,26,20,36,96,269,0,51,16,0,0,0,346,24,0,0,6519
496,441,55,159,282,1944,1020,129600,365,131,73.59,26.41,113,13,38,89,324,11,133,44,0,30,18,124,21,0,0,6520
400,400,0,294,106,1975,566,160700,314,86,78.50,21.50,21,107,176,0,74,27,99,17,0,0,56,76,0,0,0,6521
346,322,24,156,166,1939,1030,211400,277,69,80.06,19.94,40,36,15,0,225,17,61,31,0,0,5,109,27,0,8,6522
335,266,69,176,90,1964,547,113200,241,94,71.94,28.06,60,21,48,47,199,0,190,0,0,0,26,96,0,0,0,6523
294,294,0,258,36,1939,1536,331900,282,12,95.92,4.08,13,0,0,0,151,0,0,18,0,0,0,0,111,0,22,6524
701,580,121,361,219,1979,763,183500,434,267,61.91,38.09,193,108,144,52,261,77,216,33,0,0,54,130,80,14,6,6525
1204,1124,80,175,949,1939,446,444100,9,1195,0.75,99.25,325,87,42,5,591,482,203,17,8,0,22,17,59,24,44,6526
1028,831,197,533,298,1998,860,369200,672,356,65.37,34.63,878,14,40,0,46,10,177,43,25,44,28,73,241,82,223,6527
1514,939,575,389,550,1959,865,185900,1195,319,78.93,21.07,476,203,272,224,541,65,278,43,12,0,67,341,167,94,17,6528
509,509,0,394,115,1971,926,296100,454,55,89.19,10.81,50,168,126,138,123,0,30,75,7,0,0,72,278,98,34,6529
634,585,49,239,346,1970,1309,394500,328,306,51.74,48.26,45,45,191,111,256,72,71,94,13,13,9,54,83,80,84,6530
327,280,47,125,155,1972,636,143600,202,125,61.77,38.23,98,4,88,35,153,45,168,15,0,0,0,58,42,0,4,6531
667,667,0,449,218,1948,843,154100,589,78,88.31,11.69,0,0,20,60,586,11,31,12,0,0,38,513,11,0,0,6532
532,532,0,117,415,1987,751,164400,190,342,35.71,64.29,177,21,107,35,62,36,132,20,0,0,0,90,28,0,0,6533
474,395,79,162,233,1952,923,123900,391,83,82.49,17.51,0,11,64,47,205,8,101,45,0,0,31,69,0,0,0,6534
872,819,53,304,515,1976,964,244800,327,545,37.50,62.50,103,277,307,87,120,23,264,38,89,13,44,138,129,11,0,6535
366,355,11,237,118,1981,860,245800,287,79,78.42,21.58,128,24,172,18,105,0,119,51,0,0,23,91,63,0,77,6536
745,646,99,532,114,1965,1322,333100,745,0,100.00,0.00,0,29,44,376,95,0,14,153,11,0,0,96,236,14,20,6537
462,312,150,221,91,1972,807,163400,362,100,78.35,21.65,82,27,113,34,240,29,45,18,0,0,117,103,59,0,0,6538
551,551,0,347,204,1939,1063,561500,377,174,68.42,31.58,0,0,24,0,447,0,122,24,0,0,0,11,120,66,128,6539
332,298,34,113,185,1939,882,356500,180,152,54.22,45.78,33,0,0,19,137,0,26,0,19,0,0,21,87,12,13,6540
482,445,37,427,18,1939,0,626900,482,0,100.00,0.00,22,0,0,0,371,0,0,0,0,0,0,22,33,75,263,6541
438,412,26,90,322,1944,994,329400,151,287,34.47,65.53,0,29,29,50,182,0,144,29,0,0,0,14,29,9,65,6542
809,780,29,114,666,1975,654,179000,187,622,23.11,76.89,268,80,142,61,28,64,304,17,0,0,89,96,0,0,0,6543
470,394,76,243,151,1944,729,156800,368,102,78.30,21.70,29,38,67,31,228,15,29,11,0,0,80,118,15,2,24,6544
316,305,11,96,209,1963,741,109400,176,140,55.70,44.30,48,37,144,70,155,57,232,32,0,0,33,42,0,14,0,6545
563,533,30,334,199,1986,552,88300,348,215,61.81,38.19,93,19,111,109,159,132,13,0,0,0,185,134,8,11,0,6546
341,282,59,161,121,1946,843,165500,201,140,58.94,41.06,0,33,49,55,188,40,88,0,27,0,36,97,0,0,0,6547
519,463,56,398,65,1977,0,200800,450,69,86.71,13.29,113,50,89,44,134,3,28,0,0,0,43,188,87,27,9,6548
451,451,0,396,55,1972,1170,212700,431,20,95.57,4.43,21,11,288,148,7,0,20,43,0,0,18,220,141,23,0,6549
795,765,30,351,414,1982,736,21900,155,640,19.50,80.50,146,163,177,178,44,47,289,0,0,0,241,65,13,0,44,6550
737,701,36,134,567,1974,707,157900,150,587,20.35,79.65,44,10,167,243,171,29,364,0,0,0,0,85,87,0,0,6551
257,233,24,168,65,1979,731,328600,194,63,75.49,24.51,42,27,89,12,136,6,13,18,5,0,0,84,97,63,3,6552
563,542,21,337,205,1960,1014,151300,492,71,87.39,12.61,50,0,117,119,226,53,84,11,0,0,0,281,73,0,0,6553
1168,1111,57,409,702,1977,816,200800,746,422,63.87,36.13,268,40,339,132,172,12,360,52,0,0,10,366,79,21,0,6554
660,417,243,233,184,1974,738,170800,481,179,72.88,27.12,76,65,58,75,174,27,82,16,0,0,25,88,41,7,29,6555
294,282,12,248,34,1978,0,255200,251,43,85.37,14.63,130,64,17,32,93,0,0,27,0,0,29,57,100,0,48,6556
349,237,112,23,214,1975,749,0,28,321,8.02,91.98,83,14,63,80,108,27,246,64,0,11,0,0,0,0,0,6557
398,398,0,284,114,1946,863,395000,354,44,88.94,11.06,30,0,50,42,181,0,53,33,0,0,19,41,86,39,32,6558
593,567,26,67,500,1969,644,200800,159,434,26.81,73.19,11,14,51,84,382,185,196,0,0,0,0,81,10,0,0,6559
728,692,36,407,285,1972,835,189200,328,400,45.05,54.95,64,0,406,136,0,0,287,20,0,0,0,101,158,0,0,6560
434,365,69,327,38,1939,0,664000,434,0,100.00,0.00,0,0,0,0,370,0,0,0,0,0,0,13,0,22,318,6561
664,609,55,311,298,1954,824,287000,393,271,59.19,40.81,12,13,106,127,346,9,163,21,29,0,0,133,187,8,8,6562
416,416,0,195,221,1939,1254,386300,234,182,56.25,43.75,0,0,18,48,303,23,60,32,2,0,0,27,85,90,25,6563
595,580,15,476,104,1952,1210,377200,579,16,97.31,2.69,0,0,30,0,556,0,30,18,0,0,37,150,288,0,14,6564
923,895,28,580,315,1984,985,195400,827,96,89.60,10.40,303,181,352,11,0,0,112,108,0,0,13,464,87,13,0,6565
495,467,28,447,20,1939,0,560700,467,28,94.34,5.66,15,0,0,0,554,0,22,10,10,10,0,11,156,179,171,6566
903,903,0,473,430,1966,883,195400,612,291,67.77,32.23,134,59,245,83,308,42,179,114,11,0,19,210,194,0,10,6567
413,395,18,215,180,1991,934,287800,286,127,69.25,30.75,137,22,125,51,47,0,177,54,0,0,7,32,68,35,0,6568
262,262,0,174,88,1975,1091,141300,262,0,100.00,0.00,0,0,265,129,0,27,106,72,0,0,0,189,0,0,0,6569
845,845,0,348,497,1993,1322,635000,385,460,45.56,54.44,711,283,0,13,0,0,272,257,13,13,29,0,23,56,262,6570
1062,952,110,569,383,1991,1158,273700,636,426,59.89,40.11,423,478,19,82,0,0,311,117,0,0,0,76,341,12,0,6571
460,429,31,389,40,1975,1023,173500,447,13,97.17,2.83,51,31,363,27,7,0,0,63,0,0,35,326,55,0,0,6572
540,506,34,376,130,1972,589,170200,371,169,68.70,31.30,27,54,88,46,233,34,34,9,0,0,59,192,36,18,14,6573
733,644,89,283,361,1939,846,152800,650,83,88.68,11.32,58,0,73,26,651,14,399,55,0,0,44,126,92,0,0,6574
385,385,0,141,244,1954,904,122900,337,48,87.53,12.47,48,27,13,44,215,19,52,50,0,0,0,184,13,19,0,6575
685,524,161,359,165,1974,859,175600,556,129,81.17,18.83,168,56,59,76,244,19,95,6,0,0,56,159,36,19,33,6576
891,867,24,516,351,1958,869,142100,713,178,80.02,19.98,65,32,161,106,600,96,132,62,0,0,177,401,47,0,4,6577
498,403,95,260,143,1964,1105,216900,462,36,92.77,7.23,16,0,35,140,200,0,9,21,0,0,0,115,237,0,0,6578
269,237,32,237,0,1975,0,237700,256,13,95.17,4.83,12,46,184,53,12,12,36,20,0,0,0,157,42,0,0,6579
287,259,28,211,48,1956,822,164500,258,29,89.90,10.10,14,6,107,76,63,0,47,8,0,0,8,142,6,8,0,6580
514,453,61,275,178,1975,707,204300,351,163,68.29,31.71,102,31,159,50,100,35,124,43,0,0,19,135,59,7,11,6581
364,285,79,76,209,1978,807,238500,203,161,55.77,44.23,96,68,22,13,220,78,12,45,23,0,0,0,9,20,9,6582
820,701,119,469,232,1993,746,282700,709,111,86.46,13.54,443,116,51,64,238,13,97,59,8,0,116,257,248,65,49,6583
508,490,18,167,323,1982,1070,123700,134,374,26.38,73.62,183,264,238,25,0,0,393,127,0,0,19,127,8,0,4,6584
496,419,77,354,65,1992,959,164600,344,152,69.35,30.65,181,130,193,21,0,0,8,21,0,0,129,209,73,38,0,6585
528,505,23,458,47,1970,1080,412700,509,19,96.40,3.60,119,48,141,130,101,0,79,0,38,0,25,64,145,44,121,6586
727,696,31,565,131,1956,1736,332000,723,4,99.45,0.55,59,76,102,57,452,0,20,39,0,0,0,130,439,42,32,6587
1003,958,45,679,279,2004,1426,236100,839,164,83.65,16.35,719,12,0,0,18,0,90,29,29,20,0,177,221,67,8,6588
1218,1218,0,660,558,1981,669,242200,648,570,53.20,46.80,367,340,323,148,83,65,321,59,0,0,34,312,258,87,45,6589
697,668,29,226,442,1965,986,219800,321,376,46.05,53.95,68,89,208,133,327,98,228,104,0,0,63,168,48,22,0,6590
487,487,0,438,49,1995,1814,368200,487,0,100.00,0.00,587,15,9,0,11,0,0,0,0,0,0,23,370,134,95,6591
205,173,32,146,27,1956,788,161200,195,10,95.12,4.88,13,29,36,41,226,0,26,23,0,0,18,254,0,11,0,6592
597,576,21,9,567,1957,920,0,25,572,4.19,95.81,203,15,8,49,369,41,530,19,0,0,0,0,0,7,0,6593
1019,1019,0,880,139,1991,870,232000,868,151,85.18,14.82,713,169,153,75,94,4,94,49,31,0,53,398,388,70,92,6594
344,273,71,179,94,1975,720,107600,210,134,61.05,38.95,65,15,146,27,121,33,49,6,0,0,42,131,34,14,23,6595
637,413,224,286,127,1981,1131,277300,353,284,55.42,44.58,423,46,61,24,91,0,26,9,0,0,8,116,254,57,100,6596
839,777,62,549,228,1984,890,172600,668,171,79.62,20.38,354,79,70,69,530,37,97,287,9,0,166,282,108,14,0,6597
278,278,0,259,19,1939,0,563400,278,0,100.00,0.00,6,0,11,0,315,0,0,0,11,0,0,27,26,84,110,6598
556,556,0,402,154,1978,1450,233800,556,0,100.00,0.00,109,26,277,74,0,0,13,11,46,0,0,141,187,0,0,6599
1205,1084,121,341,743,1996,1080,284100,510,695,42.32,57.68,865,162,81,0,63,0,444,249,15,38,0,42,189,22,85,6600
556,478,78,220,258,1949,872,113200,426,130,76.62,23.38,17,0,11,28,353,33,106,35,0,0,21,146,21,30,0,6601
1240,1141,99,1062,79,1974,980,348100,1094,146,88.23,11.77,203,326,173,209,292,0,29,0,12,0,14,40,483,339,274,6602
497,487,10,307,180,1981,725,100300,253,244,50.91,49.09,204,48,136,13,29,10,177,14,0,0,47,105,8,0,0,6603
667,426,241,219,207,1992,845,128500,511,156,76.61,23.39,424,117,146,12,55,44,151,27,0,0,60,180,52,60,49,6604
488,488,0,312,176,1967,761,200800,438,50,89.75,10.25,183,51,83,55,91,0,12,91,9,0,9,203,81,0,12,6605
516,470,46,339,131,1946,558,149200,366,150,70.93,29.07,112,59,33,0,338,30,119,32,0,0,140,191,7,10,13,6606
550,406,144,243,163,1971,839,179200,363,187,66.00,34.00,144,12,172,36,172,99,37,0,0,0,43,89,111,8,0,6607
318,286,32,197,89,1975,786,178500,137,181,43.08,56.92,20,27,261,0,0,0,22,0,0,0,217,26,18,0,25,6608
418,362,56,195,167,1949,725,169800,265,153,63.40,36.60,51,8,107,0,254,8,162,0,5,11,0,132,39,43,12,6609
601,542,59,390,152,1962,610,175300,450,151,74.88,25.12,173,31,79,125,294,82,77,57,23,0,9,285,65,0,14,6610
666,601,65,504,97,1953,1301,537800,627,39,94.14,5.86,48,33,87,72,455,0,28,34,0,37,0,63,145,69,240,6611
333,316,17,153,163,1978,810,95000,109,224,32.73,67.27,72,26,265,10,0,0,183,0,0,0,70,120,0,0,0,6612
454,454,0,227,227,1939,1175,370400,353,101,77.75,22.25,63,32,56,13,316,11,35,79,11,0,10,56,146,72,22,6613
956,938,18,624,314,1969,990,226800,753,203,78.77,21.23,75,226,114,219,146,3,126,81,0,0,34,128,301,11,30,6614
263,239,24,125,114,1939,824,207600,172,91,65.40,34.60,7,10,10,7,364,10,196,21,0,0,7,31,75,18,0,6615
613,613,0,218,395,1953,1016,283000,405,208,66.07,33.93,20,9,110,38,371,0,203,47,27,0,10,112,83,9,0,6616
505,457,48,329,128,1939,1113,406700,469,36,92.87,7.13,46,0,61,0,321,0,45,79,8,0,14,54,208,20,0,6617
430,408,22,315,93,1948,1396,360100,404,26,93.95,6.05,38,13,0,15,250,0,16,27,0,0,11,68,120,29,28,6618
616,616,0,474,142,1953,1044,279900,552,64,89.61,10.39,120,0,21,74,342,0,109,80,0,0,0,147,163,0,6,6619
657,657,0,369,288,1973,908,367000,441,216,67.12,32.88,72,117,155,57,293,9,106,12,27,61,0,131,187,70,42,6620
1481,1380,101,232,1148,1997,984,191800,411,1070,27.75,72.25,869,82,43,97,328,60,582,252,73,75,0,213,61,0,0,6621
429,332,97,219,113,1978,734,155100,311,118,72.49,27.51,51,45,76,82,136,24,30,6,21,0,66,80,25,9,5,6622
805,766,39,394,372,1991,996,181800,705,100,87.58,12.42,212,119,240,60,192,0,307,56,0,0,15,288,118,26,0,6623
748,725,23,418,307,1957,1087,163300,657,91,87.83,12.17,114,18,77,102,385,0,132,84,11,0,12,427,30,0,0,6624
424,358,66,91,267,1979,791,236700,130,294,30.66,69.34,150,253,150,34,23,158,239,8,0,0,83,30,55,0,0,6625
346,346,0,242,104,1971,1012,105900,195,151,56.36,43.64,40,86,74,49,54,6,81,11,0,0,110,52,16,0,0,6626
1316,1291,25,617,674,1996,897,264300,754,562,57.29,42.71,853,59,77,21,59,13,320,23,71,0,21,150,458,13,0,6627
492,420,72,321,99,1974,1049,173800,394,98,80.08,19.92,47,117,151,57,90,0,28,54,0,0,78,154,47,0,30,6628
526,506,20,190,316,1977,847,216200,319,207,60.65,39.35,92,97,158,87,38,24,208,24,0,0,0,151,56,9,0,6629
476,471,5,309,162,1973,720,264200,317,159,66.60,33.40,199,33,119,41,136,15,116,0,0,0,15,84,203,56,23,6630
627,593,34,288,305,1978,757,170800,288,339,45.93,54.07,209,51,217,53,81,118,149,57,0,0,38,167,43,0,0,6631
644,644,0,417,227,1969,1085,134000,499,145,77.48,22.52,61,62,141,145,222,0,76,16,0,0,203,238,56,0,0,6632
398,301,97,196,105,1939,487,179000,334,64,83.92,16.08,0,0,44,24,202,26,59,46,0,0,41,75,10,0,0,6633
649,649,0,222,427,1984,708,142400,368,281,56.70,43.30,178,124,130,31,181,42,261,85,0,0,25,152,31,0,0,6634
826,754,72,426,328,1977,1188,316800,584,242,70.70,29.30,164,306,242,88,18,0,104,82,33,0,0,125,274,55,77,6635
537,537,0,469,68,1979,1323,324700,517,20,96.28,3.72,35,145,388,0,0,0,0,58,19,0,0,95,300,35,23,6636
405,322,83,102,220,1963,1094,140600,259,146,63.95,36.05,30,0,0,0,221,0,34,14,0,0,0,72,104,27,0,6637
980,770,210,613,157,1974,863,306300,848,132,86.53,13.47,312,206,351,80,87,0,103,6,0,0,74,197,194,169,263,6638
447,430,17,95,335,1950,745,127200,233,214,52.13,47.87,52,36,87,73,196,17,272,46,0,0,0,78,0,0,0,6639
527,471,56,109,362,1939,924,595000,188,339,35.67,64.33,0,0,34,105,546,0,462,64,0,0,0,14,48,83,14,6640
746,746,0,332,414,1948,949,304100,325,421,43.57,56.43,34,8,40,11,621,69,166,131,21,0,0,74,136,28,28,6641
327,327,0,313,14,1939,0,488300,327,0,100.00,0.00,0,0,59,0,316,0,9,0,40,0,31,9,89,109,88,6642
417,379,38,287,92,1983,1075,277500,253,164,60.67,39.33,78,41,69,35,106,0,22,15,0,0,44,111,66,11,35,6643
575,499,76,0,499,1974,1057,0,26,549,4.52,95.48,181,0,7,32,228,24,255,123,8,0,0,0,0,0,0,6644
1138,1138,0,467,671,1974,393,132600,472,666,41.48,58.52,308,179,268,130,256,199,333,29,70,0,40,299,35,0,10,6645
774,634,140,548,86,1978,945,330800,740,34,95.61,4.39,287,43,161,77,137,8,101,14,0,0,20,105,117,111,160,6646
699,644,55,459,185,1992,982,222700,591,108,84.55,15.45,242,107,121,24,80,0,68,17,0,0,0,234,221,34,0,6647
613,550,63,439,111,1969,903,328300,552,61,90.05,9.95,103,66,193,113,114,35,48,11,0,0,10,73,195,87,60,6648
889,780,109,194,586,1983,707,158300,340,549,38.25,61.75,216,124,245,70,156,118,443,56,0,0,0,158,0,0,0,6649
373,310,63,251,59,1991,0,54400,19,354,5.09,94.91,181,138,153,0,15,25,29,0,0,0,272,37,0,0,0,6650
429,429,0,363,66,1982,940,193600,400,29,93.24,6.76,102,103,137,30,77,0,88,66,31,0,6,198,0,0,0,6651
698,576,122,465,111,1968,814,162200,416,282,59.60,40.40,33,55,195,115,305,113,39,26,0,29,155,172,47,10,16,6652
801,652,149,465,187,1976,628,106800,268,533,33.46,66.54,189,154,221,124,192,20,140,42,0,0,157,87,128,20,37,6653
285,189,96,133,56,1986,489,233600,138,147,48.42,51.58,102,9,72,9,86,0,0,0,0,0,19,51,32,0,44,6654
444,378,66,200,178,1977,430,318000,189,255,42.57,57.43,127,95,172,68,75,13,50,49,0,0,58,242,69,21,35,6655
807,681,126,483,198,1983,1545,200500,785,22,97.27,2.73,125,176,182,114,86,0,37,45,13,0,0,356,145,15,0,6656
402,331,71,167,164,1939,800,317600,290,112,72.14,27.86,20,22,30,0,354,88,46,15,33,9,9,36,98,47,6,6657
716,684,32,435,249,1965,584,153300,445,271,62.15,37.85,72,99,122,80,322,43,88,14,33,0,51,246,42,0,25,6658
529,529,0,485,44,1971,1813,381600,529,0,100.00,0.00,24,59,145,194,9,0,15,21,17,0,12,43,141,113,32,6659
847,776,71,447,329,1991,893,184000,378,469,44.63,55.37,637,24,99,124,19,40,295,65,6,0,157,260,34,0,0,6660
591,591,0,502,89,1955,2500,703500,591,0,100.00,0.00,53,43,70,0,394,0,84,0,15,31,0,0,12,9,409,6661
549,485,64,368,117,1974,700,213800,444,105,80.87,19.13,90,47,181,40,167,17,54,0,0,0,31,253,103,21,25,6662
573,540,33,107,433,1968,662,138000,300,273,52.36,47.64,88,47,36,57,397,143,215,84,0,0,23,95,0,0,0,6663
893,893,0,774,119,1996,1103,248600,838,55,93.84,6.16,571,17,17,45,76,0,22,39,47,0,20,163,390,25,14,6664
422,394,28,223,171,1972,1500,601500,399,23,94.55,5.45,102,42,21,28,164,0,52,12,0,0,12,8,54,6,155,6665
483,437,46,322,115,1973,1111,295300,409,74,84.68,15.32,113,0,71,83,213,8,9,52,0,0,0,159,171,46,35,6666
393,322,71,278,44,1980,1155,405900,382,11,97.20,2.80,104,63,60,27,145,33,35,0,0,0,11,133,58,0,87,6667
569,551,18,483,68,1979,773,457100,556,13,97.72,2.28,176,53,313,117,59,0,45,45,0,0,10,38,143,97,173,6668
263,206,57,171,35,1953,847,158200,221,42,84.03,15.97,33,16,19,13,126,2,16,0,0,0,58,54,23,2,15,6669
755,690,65,326,364,1975,801,183300,424,331,56.16,43.84,252,87,187,24,112,105,72,19,0,35,46,250,63,0,0,6670
457,427,30,314,113,1976,986,147500,380,77,83.15,16.85,110,47,183,46,17,0,77,38,26,0,36,226,0,0,0,6671
965,926,39,323,603,1979,845,199000,534,431,55.34,44.66,467,192,287,29,7,14,443,61,0,0,39,347,78,0,0,6672
1096,1004,92,785,219,1981,1215,335000,954,142,87.04,12.96,375,242,376,178,54,90,103,121,0,0,0,53,482,209,51,6673
692,692,0,526,166,1992,911,243500,568,124,82.08,17.92,493,68,49,52,21,0,161,28,0,0,0,91,321,28,10,6674
187,187,0,152,35,1978,1138,546300,177,10,94.65,5.35,34,12,89,0,103,0,0,0,0,0,0,44,98,29,67,6675
984,895,89,716,179,1975,803,160400,727,257,73.88,26.12,259,123,295,80,197,13,188,14,0,0,99,262,143,66,64,6676
458,386,72,221,165,1979,628,235100,254,204,55.46,44.54,192,7,177,13,113,25,212,0,0,0,26,127,63,11,0,6677
992,908,84,610,298,1986,1060,165500,777,215,78.33,21.67,443,56,181,82,198,13,104,70,0,0,85,499,96,26,34,6678
695,517,178,417,100,1971,852,93900,494,201,71.08,28.92,176,47,137,55,232,57,99,0,0,0,131,140,97,2,12,6679
357,330,27,268,62,1976,525,275000,266,91,74.51,25.49,53,30,85,62,200,0,39,0,0,0,26,122,105,0,11,6680
277,277,0,191,86,1975,1305,239100,157,120,56.68,43.32,20,7,12,37,83,0,20,8,0,0,15,11,81,0,24,6681
224,224,0,69,155,1939,742,73800,167,57,74.55,25.45,20,0,72,42,225,30,176,0,0,0,20,61,0,0,0,6682
601,381,220,310,71,1977,0,285000,466,135,77.54,22.46,158,53,97,96,133,0,0,1,16,0,72,80,86,44,132,6683
633,547,86,413,134,1987,1071,151800,459,174,72.51,27.49,247,52,79,0,65,0,40,86,0,0,26,226,53,12,0,6684
364,364,0,285,79,1991,739,154700,269,95,73.90,26.10,78,61,128,65,94,30,62,28,7,0,85,126,54,16,18,6685
852,710,142,423,287,1974,750,344300,625,227,73.36,26.64,94,75,219,262,302,48,197,0,23,0,0,86,153,139,195,6686
879,847,32,564,283,1988,1097,155900,723,156,82.25,17.75,285,84,321,70,53,0,47,0,0,0,90,588,72,16,0,6687
760,760,0,655,105,1988,976,269300,731,29,96.18,3.82,255,58,235,29,98,39,13,0,0,0,16,212,301,10,0,6688
723,502,221,441,61,1984,738,291900,505,218,69.85,30.15,115,50,107,123,70,0,76,0,0,0,24,105,49,39,55,6689
220,220,0,162,58,1974,1113,137000,192,28,87.27,12.73,8,24,174,50,55,33,8,50,0,0,26,166,28,0,0,6690
833,821,12,694,127,1981,1659,308300,820,13,98.44,1.56,199,106,191,76,245,0,31,80,0,0,0,105,347,129,77,6691
435,345,90,257,88,1976,448,139600,274,161,62.99,37.01,103,55,22,46,41,33,27,0,0,0,71,64,22,0,0,6692
656,612,44,478,134,1978,993,203000,574,82,87.50,12.50,191,137,201,20,88,0,28,103,0,0,12,377,117,0,0,6693
584,549,35,159,390,1975,762,137200,282,302,48.29,51.71,181,139,178,124,113,11,296,47,0,0,6,144,13,0,15,6694
1995,1995,0,1465,530,1998,848,194700,1544,451,77.39,22.61,1161,128,363,5,186,179,249,0,0,0,49,908,360,7,16,6695
527,520,7,360,160,1972,824,237800,437,90,82.92,17.08,134,37,74,87,130,7,48,23,0,0,22,144,122,52,17,6696
407,286,121,19,267,1989,1139,0,173,234,42.51,57.49,194,73,79,58,74,73,211,62,0,0,19,60,0,0,0,6697
906,815,91,187,628,1988,872,185500,298,608,32.89,67.11,477,262,154,67,0,23,324,53,133,56,11,153,12,0,0,6698
755,697,58,501,196,1991,1068,234800,578,177,76.56,23.44,392,135,129,20,12,0,99,92,33,0,30,146,279,9,0,6699
577,547,30,71,476,1993,1695,278500,79,498,13.69,86.31,307,35,94,46,91,106,149,9,70,141,8,28,36,0,0,6700
374,374,0,305,69,1975,0,144300,184,190,49.20,50.80,119,45,265,0,14,0,49,12,0,0,257,125,0,0,0,6701
516,489,27,437,52,1990,732,215800,496,20,96.12,3.88,120,46,122,25,67,11,36,0,0,0,95,165,73,0,0,6702
606,559,47,308,251,1991,923,164100,336,270,55.45,44.55,479,151,154,33,106,56,278,109,0,14,210,55,67,0,42,6703
920,920,0,299,621,1999,972,217100,452,468,49.13,50.87,521,14,22,49,248,61,341,73,26,0,24,227,70,0,0,6704
492,446,46,326,120,1939,1131,809700,356,136,72.36,27.64,54,25,0,9,407,0,0,17,10,0,0,12,38,13,298,6705
789,740,49,642,98,1995,0,164900,654,135,82.89,17.11,326,135,209,58,46,45,0,27,0,0,41,300,233,15,48,6706
986,986,0,518,468,1986,748,169800,622,364,63.08,36.92,291,248,103,0,95,0,184,24,0,46,38,226,116,11,0,6707
509,476,33,359,117,1948,914,244700,458,51,89.98,10.02,16,15,5,57,440,21,48,10,17,0,35,119,104,69,51,6708
445,445,0,305,140,1975,977,211800,343,102,77.08,22.92,39,41,351,19,8,32,98,43,9,0,8,132,70,0,0,6709
1021,962,59,364,598,1968,874,313500,570,451,55.83,44.17,138,53,177,112,541,56,272,68,33,0,20,181,250,35,64,6710
591,532,59,348,184,1974,744,371100,507,84,85.79,14.21,173,53,109,21,206,31,46,17,0,0,21,134,110,22,147,6711
448,381,67,287,94,1965,788,182600,373,75,83.26,16.74,92,66,75,40,132,22,68,32,0,0,48,166,14,7,0,6712
661,643,18,584,59,1974,1400,264300,540,121,81.69,18.31,182,47,220,52,137,0,0,80,27,0,22,146,143,85,99,6713
1151,1139,12,1040,99,1997,1382,217700,995,156,86.45,13.55,956,32,19,21,45,0,0,6,9,0,167,367,438,19,0,6714
1369,1369,0,893,476,1995,1095,501100,965,404,70.49,29.51,978,268,20,17,38,0,145,158,0,13,31,11,144,256,526,6715
748,733,15,460,273,1994,926,244100,582,166,77.81,22.19,489,55,132,45,64,43,253,97,0,0,10,161,138,18,65,6716
324,315,9,268,47,1949,788,125700,324,0,100.00,0.00,32,84,10,0,238,0,44,0,0,0,51,196,19,0,11,6717
452,397,55,78,319,1939,709,310700,95,357,21.02,78.98,35,0,10,0,197,9,89,31,0,0,0,58,0,0,16,6718
642,590,52,522,68,1975,1238,238500,574,68,89.41,10.59,191,38,151,17,85,11,7,12,3,0,9,89,98,105,142,6719
124,114,10,47,67,1983,0,133100,57,67,45.97,54.03,0,0,8,9,42,0,27,0,0,0,0,30,0,0,2,6720
450,354,96,347,7,1986,0,228900,406,44,90.22,9.78,346,67,186,128,57,38,28,16,0,0,43,166,177,47,97,6721
797,754,43,736,18,1998,0,303600,797,0,100.00,0.00,535,174,0,8,0,0,0,0,10,0,0,62,371,198,45,6722
667,628,39,443,185,1979,1415,305800,601,66,90.10,9.90,116,0,285,28,201,9,41,91,0,0,71,106,76,48,39,6723
390,390,0,357,33,1981,0,279400,367,23,94.10,5.90,109,103,186,51,58,0,10,0,12,0,0,81,241,32,50,6724
807,770,37,224,546,1966,595,204900,423,384,52.42,47.58,47,33,164,138,415,272,172,79,0,0,8,149,74,0,0,6725
744,692,52,560,132,1988,1037,55800,317,427,42.61,57.39,398,173,62,13,72,15,14,12,14,0,401,42,102,79,39,6726
412,363,49,316,47,1983,917,240000,296,116,71.84,28.16,74,70,89,40,43,8,16,1,0,0,2,115,62,41,47,6727
410,383,27,338,45,1972,599,112500,339,71,82.68,17.32,23,66,98,63,199,62,103,0,0,0,106,74,23,0,0,6728
378,364,14,229,135,1991,829,84300,229,149,60.58,39.42,116,54,56,34,76,1,47,10,0,0,62,158,12,0,4,6729
533,533,0,477,56,1939,1677,434600,533,0,100.00,0.00,0,0,27,0,531,0,0,13,0,76,27,9,88,178,152,6730
470,416,54,313,103,1988,408,233900,276,194,58.72,41.28,136,43,48,25,154,3,12,10,0,0,7,148,101,10,14,6731
514,475,39,425,50,1976,1406,243100,514,0,100.00,0.00,42,36,407,18,7,0,0,99,0,0,11,196,155,0,0,6732
768,752,16,709,43,1990,0,362800,694,74,90.36,9.64,388,93,169,47,75,0,54,41,20,0,29,45,204,29,193,6733
298,298,0,240,58,1939,1830,416500,281,17,94.30,5.70,0,0,0,0,342,0,0,0,36,0,0,17,101,121,56,6734
320,320,0,168,152,1966,683,92200,250,70,78.13,21.88,8,0,52,19,139,25,114,0,0,0,55,24,0,0,0,6735
745,671,74,381,290,1957,788,186500,691,54,92.75,7.25,13,134,14,96,415,14,198,37,0,0,27,303,40,0,12,6736
566,513,53,412,101,1960,1763,449000,555,11,98.06,1.94,22,20,68,211,308,0,6,23,44,0,0,41,147,88,193,6737
978,934,44,520,414,1987,794,153100,364,614,37.22,62.78,334,133,251,15,9,7,141,21,0,0,186,166,37,11,19,6738
1048,913,135,537,376,1987,744,139600,441,607,42.08,57.92,598,142,225,72,56,80,279,18,0,11,76,233,142,38,35,6739
653,653,0,514,139,1979,0,227400,546,107,83.61,16.39,122,92,150,12,35,0,56,13,0,0,21,118,81,23,63,6740
556,528,28,478,50,1955,765,552600,506,50,91.01,8.99,35,30,128,82,310,20,68,10,0,0,0,56,45,141,210,6741
1346,1292,54,1028,264,1995,1093,338500,1180,166,87.67,12.33,1179,16,30,0,42,0,67,62,41,0,22,87,581,166,162,6742
470,470,0,406,64,1983,1568,235100,455,15,96.81,3.19,42,317,150,12,17,0,11,21,13,0,16,162,280,12,23,6743
508,459,49,106,353,1973,589,117600,216,292,42.52,57.48,23,40,240,82,102,56,296,66,15,0,0,40,14,0,0,6744
913,854,59,785,69,1979,828,295000,709,204,77.66,22.34,494,67,224,117,33,62,60,0,44,12,90,145,314,89,43,6745
1205,1053,152,668,385,1975,691,100900,626,579,51.95,48.05,370,26,256,114,328,96,132,129,0,0,303,325,62,12,0,6746
379,379,0,321,58,1939,0,151100,347,32,91.56,8.44,0,0,45,31,385,0,53,80,0,0,9,241,0,13,0,6747
1649,1569,80,936,633,1993,733,130100,1334,315,80.90,19.10,814,75,252,69,348,46,322,118,15,0,36,564,293,28,56,6748
652,553,99,438,115,1951,1007,318500,515,137,78.99,21.01,75,0,70,116,389,43,118,14,0,0,22,79,197,52,59,6749
752,543,209,281,262,1967,856,114100,422,330,56.12,43.88,86,26,201,107,253,0,137,50,0,0,139,270,47,0,14,6750
754,715,39,384,331,1991,881,220000,469,285,62.20,37.80,144,97,129,127,150,0,182,109,0,0,29,202,98,14,13,6751
446,406,40,343,63,1973,0,224300,333,113,74.66,25.34,134,31,119,84,114,7,57,0,0,0,9,209,86,43,37,6752
784,784,0,647,137,1970,1566,280700,736,48,93.88,6.12,69,49,291,260,171,44,79,0,28,0,14,212,322,42,85,6753
576,536,40,215,321,1989,938,230500,364,212,63.19,36.81,500,90,124,65,121,0,347,129,11,0,34,137,30,23,0,6754
433,421,12,121,300,1987,841,271300,111,322,25.64,74.36,88,74,29,64,89,25,118,20,8,0,35,0,40,14,0,6755
326,282,44,166,116,1944,650,125800,272,54,83.44,16.56,23,25,6,9,324,49,72,0,0,0,146,49,0,0,0,6756
384,384,0,357,27,1939,0,568800,340,44,88.54,11.46,34,0,0,0,270,0,0,14,10,0,0,11,0,51,184,6757
674,674,0,294,380,1971,821,219300,401,273,59.50,40.50,22,74,91,78,414,0,230,57,0,0,30,306,26,17,13,6758
289,289,0,138,151,1939,1304,346800,220,69,76.12,23.88,17,23,16,21,307,81,39,47,15,0,0,67,56,28,0,6759
634,593,41,574,19,1980,0,426500,618,16,97.48,2.52,170,93,133,69,58,0,0,0,0,0,0,20,199,100,204,6760
623,511,112,321,190,1977,1093,191500,511,112,82.02,17.98,360,106,105,79,92,0,140,44,0,0,0,228,175,108,12,6761
353,266,87,235,31,1978,0,258900,191,162,54.11,45.89,49,54,103,12,101,0,0,0,0,0,50,151,45,13,0,6762
640,581,59,299,282,1975,698,242500,397,243,62.03,37.97,316,66,96,73,158,11,110,0,23,67,42,145,134,60,61,6763
1127,1036,91,691,345,1994,963,232600,711,416,63.09,36.91,585,45,148,51,132,13,67,71,51,82,59,151,103,68,60,6764
937,838,99,253,585,1999,879,351800,367,570,39.17,60.83,364,106,298,17,17,99,244,80,0,0,17,46,68,110,59,6765
391,352,39,261,91,1974,503,244800,306,85,78.26,21.74,118,75,47,10,90,0,11,0,0,0,99,112,10,0,41,6766
227,157,70,117,40,1964,867,87800,159,68,70.04,29.96,58,12,73,3,151,5,29,4,0,0,97,106,2,11,0,6767
1028,997,31,529,468,1977,1106,273800,509,519,49.51,50.49,336,97,250,89,55,0,274,64,30,23,0,146,130,49,49,6768
838,726,112,361,365,1974,728,149700,572,266,68.26,31.74,114,46,406,93,206,32,327,27,0,0,33,422,0,0,0,6769
531,475,56,225,250,1971,954,231000,225,306,42.37,57.63,15,27,81,63,403,0,94,29,15,0,27,201,138,17,0,6770
437,343,94,282,61,1982,782,188500,332,105,75.97,24.03,171,21,51,11,139,6,36,0,0,0,21,175,56,16,22,6771
241,241,0,202,39,1963,1153,286400,182,59,75.52,24.48,158,22,29,65,39,10,0,0,0,0,0,45,79,79,40,6772
424,424,0,424,0,1975,0,395200,368,56,86.79,13.21,159,43,141,46,116,0,0,4,0,0,0,84,175,55,132,6773
1805,1641,164,1167,474,1998,1177,385700,1385,420,76.73,23.27,1228,11,209,120,67,0,156,275,0,15,17,49,327,172,561,6774
512,471,41,276,195,1982,1007,214700,355,157,69.34,30.66,233,179,132,19,72,0,172,71,5,0,13,135,116,52,17,6775
764,751,13,147,604,1977,792,95400,161,603,21.07,78.93,97,148,153,70,149,37,262,25,0,0,106,127,10,0,11,6776
748,312,436,228,84,1979,689,213600,637,111,85.16,14.84,191,78,173,42,281,9,42,33,0,0,10,130,105,2,0,6777
720,598,122,61,537,1939,868,293600,53,667,7.36,92.64,0,11,109,74,587,35,291,211,9,0,14,57,10,22,51,6778
703,619,84,132,487,1974,891,218600,250,453,35.56,64.44,158,13,121,26,295,49,374,25,0,0,5,83,24,0,11,6779
690,690,0,603,87,1992,991,218000,508,182,73.62,26.38,190,53,123,21,114,0,0,0,0,0,139,161,102,24,0,6780
1088,1088,0,912,176,2000,1537,227200,1088,0,100.00,0.00,599,19,300,41,33,0,10,112,15,0,0,361,415,0,0,6781
467,445,22,182,263,1965,1022,246100,198,269,42.40,57.60,0,0,114,126,230,0,281,26,0,0,0,43,64,0,13,6782
639,566,73,264,302,1964,621,181300,382,257,59.78,40.22,195,59,295,69,123,44,316,27,0,0,3,200,97,0,13,6783
448,448,0,420,28,1963,0,598800,448,0,100.00,0.00,58,13,30,63,169,0,0,0,0,0,8,14,15,30,266,6784
485,467,18,364,103,1957,1377,384000,414,71,85.36,14.64,134,63,15,25,183,0,36,26,0,10,0,35,121,42,130,6785
507,481,26,135,346,1943,673,258700,219,288,43.20,56.80,53,0,14,86,355,53,198,0,0,0,0,31,81,0,25,6786
1149,1073,76,97,976,1980,792,195800,256,893,22.28,77.72,467,258,212,71,128,75,374,222,134,114,37,106,33,0,0,6787
81,81,0,16,65,1954,828,0,81,0,100.00,0.00,10,10,0,0,37,0,0,0,0,0,0,17,16,0,0,6788
591,507,84,366,141,1965,1255,334300,483,108,81.73,18.27,107,100,138,164,215,0,78,57,0,17,0,180,129,144,42,6789
339,339,0,132,207,1975,1013,263600,174,165,51.33,48.67,20,63,206,113,19,12,180,37,0,0,0,26,166,0,0,6790
836,729,107,579,150,1982,275,258600,566,270,67.70,32.30,205,146,191,36,159,43,45,0,0,0,111,146,218,10,35,6791
959,912,47,843,69,1990,1375,207800,761,198,79.35,20.65,572,62,111,171,66,5,65,76,0,0,245,208,215,23,90,6792
789,776,13,201,575,1976,1538,256400,63,726,7.98,92.02,133,40,49,267,144,15,114,101,65,22,0,78,67,20,77,6793
1001,830,171,287,543,1978,926,351500,320,681,31.97,68.03,223,257,306,158,51,6,602,0,0,0,10,11,180,55,37,6794
1107,1096,11,597,499,1986,1135,266200,724,383,65.40,34.60,452,429,148,42,14,0,181,102,68,14,0,222,371,28,19,6795
593,494,99,306,188,1967,1056,169200,554,39,93.42,6.58,146,28,186,142,197,27,155,14,76,0,0,212,139,0,0,6796
286,256,30,113,143,1946,630,53800,224,62,78.32,21.68,9,34,49,0,196,47,95,0,0,0,83,17,0,0,0,6797
758,722,36,598,124,1981,1000,311700,694,64,91.56,8.44,243,164,298,23,36,0,25,3,0,0,10,80,281,44,147,6798
1062,937,125,517,420,1990,816,107700,412,650,38.79,61.21,426,22,260,40,22,0,178,48,36,0,297,161,0,0,0,6799
660,506,154,487,19,1992,0,426400,647,13,98.03,1.97,509,70,94,0,43,0,48,0,0,0,27,12,167,134,212,6800
444,391,53,292,99,1949,1316,289500,403,41,90.77,9.23,46,0,52,0,369,0,66,12,17,0,0,197,163,0,0,6801
376,376,0,214,162,1976,968,232300,307,69,81.65,18.35,78,73,219,49,8,0,60,53,0,0,0,178,92,28,8,6802
221,203,18,188,15,1974,0,425000,174,47,78.73,21.27,93,57,64,18,37,0,43,8,10,0,0,20,42,79,17,6803
572,522,50,224,298,1968,786,124100,345,227,60.31,39.69,96,18,10,51,263,62,169,0,0,0,10,189,8,0,0,6804
481,481,0,337,144,1956,1441,277500,467,14,97.09,2.91,69,65,108,47,126,0,16,0,0,10,0,74,244,0,12,6805
345,345,0,71,274,1975,548,141100,89,256,25.80,74.20,29,6,14,51,198,0,99,6,0,0,0,116,29,0,0,6806
717,664,53,163,501,1961,935,184400,318,399,44.35,55.65,109,11,26,150,285,22,147,12,95,45,25,111,38,18,0,6807
597,597,0,184,413,1974,883,240000,191,406,31.99,68.01,11,89,148,313,28,0,76,17,14,0,0,223,132,49,0,6808
1137,1137,0,462,675,1987,900,160600,803,334,70.62,29.38,452,66,335,0,68,11,236,116,0,0,12,465,22,0,0,6809
473,449,24,414,35,1977,0,396600,461,12,97.46,2.54,132,70,169,14,29,0,0,11,0,0,0,38,69,105,154,6810
193,193,0,152,41,1973,0,253400,154,39,79.79,20.21,46,21,161,10,51,10,21,0,7,0,90,41,71,0,0,6811
799,734,65,695,39,1975,1779,583100,777,22,97.25,2.75,135,65,224,176,328,0,0,6,8,0,0,66,140,83,570,6812
859,647,212,574,73,1980,490,123700,571,288,66.47,33.53,376,101,269,58,61,13,52,36,0,0,110,218,121,10,39,6813
762,540,222,470,70,1974,947,281000,714,48,93.70,6.30,253,80,165,135,163,9,10,12,3,0,53,126,103,73,198,6814
255,209,46,166,43,1965,0,245500,197,58,77.25,22.75,0,15,39,143,98,0,17,0,0,0,14,65,148,12,12,6815
1108,1057,51,674,383,2002,895,270800,794,314,71.66,28.34,620,31,93,8,35,0,73,47,17,0,0,200,195,79,91,6816
303,303,0,258,45,1979,0,225000,248,55,81.85,18.15,115,31,169,28,16,0,0,0,0,0,26,76,161,24,20,6817
1938,1785,153,977,808,1995,1123,218700,1290,648,66.56,33.44,1243,237,268,24,58,0,362,220,34,0,13,468,580,71,0,6818
861,861,0,227,634,1939,949,309800,118,743,13.70,86.30,137,78,15,17,504,46,295,209,0,0,0,27,101,13,40,6819
1001,940,61,823,117,1994,1154,283900,741,260,74.03,25.97,710,130,93,31,0,0,28,41,34,0,142,129,308,161,103,6820
421,352,69,306,46,1973,0,327300,386,35,91.69,8.31,69,108,159,40,94,41,0,12,0,0,0,110,105,94,55,6821
316,316,0,273,43,1977,773,0,266,50,84.18,15.82,83,98,123,71,46,67,6,29,22,0,29,99,61,23,24,6822
647,623,24,531,92,1975,984,568800,509,138,78.67,21.33,162,73,210,45,148,12,59,8,0,0,64,27,68,84,282,6823
359,316,43,175,141,1976,1185,259700,200,159,55.71,44.29,161,34,110,30,54,22,0,0,0,0,78,95,75,8,34,6824
672,543,129,437,106,1982,929,227100,502,170,74.70,25.30,124,252,272,55,24,15,75,21,0,0,27,150,162,0,96,6825
434,400,34,258,142,1971,486,138000,212,222,48.85,51.15,65,52,60,84,87,0,37,10,0,0,243,48,10,0,0,6826
344,339,5,287,52,1975,860,317000,273,71,79.36,20.64,29,12,43,91,182,0,31,36,0,0,11,95,77,73,23,6827
1031,962,69,622,340,1999,947,176000,589,442,57.13,42.87,593,75,165,49,49,42,218,61,8,47,113,188,201,0,0,6828
497,497,0,348,149,1982,835,172800,293,204,58.95,41.05,99,65,145,29,127,0,72,80,0,0,89,128,51,27,9,6829
436,412,24,278,134,1951,765,207100,436,0,100.00,0.00,0,0,22,40,281,0,49,0,0,0,12,177,85,20,0,6830
987,987,0,551,436,1989,942,21500,56,931,5.67,94.33,325,194,176,6,70,0,264,57,0,0,402,33,0,15,0,6831
902,902,0,709,193,1965,1366,299800,819,83,90.80,9.20,77,135,306,166,321,28,108,14,21,0,16,174,450,30,91,6832
359,279,80,157,122,1973,963,156000,325,34,90.53,9.47,23,46,144,0,110,0,45,58,0,0,0,170,11,0,0,6833
508,508,0,325,183,1950,1275,292900,443,65,87.20,12.80,0,0,12,26,320,0,15,45,28,0,0,74,148,12,19,6834
411,386,25,289,97,1959,825,190300,340,71,82.73,17.27,28,14,96,43,143,31,0,38,0,0,10,110,82,11,0,6835
899,899,0,714,185,2001,985,280600,790,109,87.88,12.12,710,61,155,29,33,0,92,21,58,0,14,89,532,93,89,6836
614,577,37,487,90,1977,0,319300,550,64,89.58,10.42,83,134,239,28,48,0,41,39,0,0,12,187,132,64,43,6837
486,486,0,414,72,1983,1386,206300,449,37,92.39,7.61,100,99,207,16,15,0,0,0,0,0,0,314,123,0,0,6838
885,812,73,258,554,1973,888,227000,230,655,25.99,74.01,0,133,162,146,180,12,205,42,0,0,35,136,72,61,16,6839
1042,884,158,508,376,1993,876,288600,655,387,62.86,37.14,618,307,35,62,21,5,392,33,18,0,0,126,276,141,23,6840
311,267,44,235,32,1975,0,313800,252,59,81.03,18.97,72,11,87,152,50,0,14,2,0,0,11,72,96,74,45,6841
499,480,19,124,356,1971,873,250000,230,269,46.09,53.91,36,10,164,148,218,81,291,17,8,0,8,40,75,18,8,6842
425,425,0,311,114,1968,833,282100,340,85,80.00,20.00,43,42,125,276,18,0,158,25,7,0,14,71,188,0,11,6843
431,431,0,400,31,1976,0,220300,431,0,100.00,0.00,40,0,197,202,0,0,36,13,0,0,0,183,182,13,12,6844
1029,284,745,227,57,1984,0,399300,964,65,93.68,6.32,158,107,190,90,114,0,14,0,0,0,0,46,47,10,80,6845
413,368,45,257,111,1973,844,0,186,227,45.04,54.96,103,12,153,99,122,35,68,0,5,0,147,94,58,14,27,6846
328,252,76,118,134,1970,746,163500,189,139,57.62,42.38,61,28,58,29,141,91,38,0,0,0,49,60,6,0,0,6847
763,724,39,161,563,1972,962,267100,152,611,19.92,80.08,29,171,412,142,52,0,321,19,0,0,85,91,24,0,0,6848
201,149,52,134,15,1945,0,116700,182,19,90.55,9.45,68,0,9,5,245,5,24,0,0,29,60,19,9,29,42,6849
563,534,29,458,76,1976,959,111800,356,207,63.23,36.77,169,161,167,58,0,0,57,53,0,0,151,257,8,0,0,6850
1292,1109,183,138,971,1983,966,307900,54,1238,4.18,95.82,599,279,237,29,245,291,556,187,118,34,0,105,14,23,0,6851
369,369,0,369,0,1939,0,444900,369,0,100.00,0.00,12,0,0,0,305,0,0,0,0,0,0,43,116,131,27,6852
1022,976,46,666,310,1992,973,333000,852,170,83.37,16.63,350,386,134,0,75,9,120,61,56,0,0,80,467,35,52,6853
550,492,58,409,83,1979,786,317900,430,120,78.18,21.82,94,123,117,43,20,0,24,0,0,0,57,96,62,75,63,6854
482,482,0,392,90,1985,1115,358300,367,115,76.14,23.86,133,52,74,31,70,0,36,0,0,0,10,75,66,24,149,6855
305,305,0,215,90,1963,0,218200,232,73,76.07,23.93,166,54,63,30,79,0,43,0,0,0,60,37,79,14,118,6856
798,798,0,565,233,1981,1363,200400,756,42,94.74,5.26,123,185,291,25,66,0,32,35,0,20,0,415,149,19,20,6857
661,482,179,318,164,1975,586,158500,437,224,66.11,33.89,114,56,88,69,150,50,40,29,0,0,70,127,49,3,12,6858
939,939,0,434,505,1991,705,157800,549,390,58.47,41.53,455,119,241,33,40,72,174,126,0,0,0,227,211,20,24,6859
419,396,23,256,140,1972,972,255700,367,52,87.59,12.41,74,22,141,34,121,0,47,70,17,0,0,105,133,10,10,6860
525,525,0,363,162,1939,888,415600,396,129,75.43,24.57,12,0,28,37,413,14,90,134,22,0,23,0,100,82,11,6861
576,540,36,441,99,1976,0,350000,464,112,80.56,19.44,80,33,110,19,51,0,16,0,0,0,0,45,120,46,54,6862
1452,1452,0,519,933,1973,782,333300,627,825,43.18,56.82,264,42,460,188,383,15,692,0,0,0,13,90,336,34,31,6863
1113,1062,51,331,731,1964,708,149800,500,613,44.92,55.08,126,175,176,211,419,148,567,38,0,0,94,260,0,0,0,6864
1009,869,140,353,516,1978,698,178000,667,342,66.11,33.89,356,157,265,185,103,167,479,45,0,0,0,319,40,0,16,6865
477,444,33,386,58,1973,0,133800,369,108,77.36,22.64,105,31,127,34,296,30,94,0,0,0,112,250,38,0,26,6866
1587,1460,127,1135,325,1993,961,206600,834,753,52.55,47.45,646,337,107,65,396,17,287,35,28,0,251,321,197,133,163,6867
409,409,0,357,52,1990,833,458800,366,43,89.49,10.51,122,45,42,25,133,0,30,0,0,0,0,24,79,72,117,6868
950,925,25,326,599,1951,800,388200,380,570,40.00,60.00,9,0,125,363,449,266,242,91,11,0,0,52,139,122,5,6869
346,346,0,107,239,1957,779,222900,160,186,46.24,53.76,116,14,60,114,226,73,206,0,41,0,51,112,9,8,0,6870
59,59,0,52,7,1939,0,230000,52,7,88.14,11.86,37,0,0,0,49,13,25,0,0,0,0,11,37,0,0,6871
486,392,94,226,166,1974,677,111100,288,198,59.26,40.74,43,26,86,37,128,7,68,9,0,0,129,96,0,0,0,6872
300,300,0,164,136,1952,1043,526500,175,125,58.33,41.67,16,0,0,12,217,0,33,0,0,0,0,16,29,24,143,6873
244,213,31,149,64,1969,1333,342200,193,51,79.10,20.90,102,12,24,10,132,0,26,0,0,0,43,46,51,46,54,6874
2335,1879,456,1245,634,2000,1159,459000,2025,310,86.72,13.28,1640,128,182,83,41,0,261,86,41,50,87,39,284,304,557,6875
1552,1520,32,1086,434,2003,1416,205900,1460,92,94.07,5.93,1357,14,0,15,0,0,0,169,0,0,14,852,315,0,15,6876
1528,1458,70,839,619,1978,710,103900,837,691,54.78,45.22,539,153,510,109,238,145,270,68,51,0,342,274,155,10,93,6877
421,421,0,244,177,1975,799,146000,360,61,85.51,14.49,40,54,174,50,41,6,91,9,0,10,0,220,14,0,0,6878
430,406,24,361,45,1939,1578,464700,425,5,98.84,1.16,0,0,0,0,441,0,0,36,13,0,0,13,38,139,160,6879
1483,395,1088,276,119,1978,0,269600,1230,253,82.94,17.06,540,188,236,237,262,0,45,0,0,0,19,147,65,15,156,6880
933,828,105,742,86,1971,1125,329400,807,126,86.50,13.50,137,101,136,101,266,15,0,36,34,0,25,45,158,69,326,6881
459,370,89,333,37,1978,0,271000,391,68,85.19,14.81,432,61,171,28,0,0,0,14,0,0,0,121,273,63,171,6882
328,319,9,200,119,1994,1438,267500,253,75,77.13,22.87,56,62,85,28,27,0,0,15,0,0,18,117,39,41,0,6883
1104,1065,39,506,559,1989,1140,447000,530,574,48.01,51.99,483,600,41,0,45,14,264,241,0,0,0,34,38,152,307,6884
530,500,30,436,64,1978,840,291400,394,136,74.34,25.66,134,75,97,37,123,0,53,9,0,0,20,61,183,34,50,6885
349,293,56,270,23,1973,0,342100,314,35,89.97,10.03,38,56,101,10,166,37,30,11,0,0,26,62,81,15,82,6886
479,445,34,406,39,1978,796,160700,328,151,68.48,31.52,110,64,96,20,289,6,69,0,37,0,55,234,30,70,11,6887
577,480,97,165,315,1980,1016,75400,478,99,82.84,17.16,146,113,57,71,33,0,13,82,0,0,35,91,28,14,12,6888
595,513,82,400,113,1983,804,271400,448,147,75.29,24.71,127,89,116,61,91,38,7,14,0,0,0,51,236,39,56,6889
479,471,8,160,311,1976,303,140000,233,246,48.64,51.36,36,72,116,27,96,100,52,0,0,0,43,50,39,0,0,6890
1123,508,615,257,251,1976,794,441800,879,244,78.27,21.73,441,64,100,79,403,90,63,29,36,6,27,59,16,11,202,6891
923,813,110,580,233,1968,790,173600,691,232,74.86,25.14,129,9,187,114,448,52,221,14,11,0,48,383,94,31,21,6892
389,383,6,273,110,1968,836,342100,314,75,80.72,19.28,166,24,59,72,114,0,84,24,0,0,35,78,67,17,63,6893
618,618,0,443,175,1979,1077,180400,514,104,83.17,16.83,289,107,201,13,209,42,62,24,0,0,53,344,209,13,0,6894
436,408,28,129,279,1966,557,203800,141,295,32.34,67.66,12,24,118,205,214,69,243,11,0,0,11,71,52,0,0,6895
853,703,150,308,395,1973,800,140100,508,345,59.55,40.45,92,104,341,56,234,80,242,89,36,42,48,217,0,0,0,6896
320,272,48,192,80,1972,774,313600,276,44,86.25,13.75,85,33,152,0,104,26,54,0,0,0,30,93,78,0,44,6897
649,541,108,430,111,1977,909,52600,222,427,34.21,65.79,246,70,258,49,57,68,17,0,0,0,441,78,0,2,0,6898
402,390,12,376,14,1939,1750,742300,382,20,95.02,4.98,40,27,23,22,262,0,11,11,0,0,11,37,19,17,241,6899
439,439,0,358,81,1966,892,291100,378,61,86.10,13.90,0,0,34,334,0,0,0,11,0,13,26,52,194,72,0,6900
1033,952,81,711,241,1986,1020,220800,945,88,91.48,8.52,628,133,406,32,58,0,223,139,8,0,0,271,389,73,47,6901
472,437,35,196,241,1969,765,145700,298,174,63.14,36.86,21,0,0,44,162,0,36,12,0,0,26,153,0,0,0,6902
394,370,24,325,45,1954,1476,281300,394,0,100.00,0.00,0,18,26,86,234,0,28,60,14,0,26,58,80,59,18,6903
365,313,52,249,64,1941,1174,302700,365,0,100.00,0.00,63,0,50,0,352,0,18,76,0,0,0,245,114,12,0,6904
397,397,0,384,13,1978,0,228500,397,0,100.00,0.00,72,146,144,13,23,0,0,0,6,0,0,137,255,0,0,6905
672,560,112,471,89,1973,1165,269000,442,230,65.77,34.23,247,99,203,7,201,0,33,53,0,0,12,88,210,158,111,6906
444,400,44,256,144,1975,728,132100,281,163,63.29,36.71,139,37,70,40,174,5,35,0,0,0,56,96,13,19,107,6907
440,395,45,306,89,1967,739,120100,360,80,81.82,18.18,116,31,84,32,245,0,70,18,0,0,112,177,15,19,11,6908
1117,1096,21,429,667,1975,690,39600,334,783,29.90,70.10,145,35,544,223,114,49,488,0,0,0,286,147,11,12,0,6909
772,728,44,718,10,1972,0,524600,772,0,100.00,0.00,115,110,313,101,169,0,0,0,39,0,0,9,112,142,459,6910
1005,925,80,656,269,1987,1086,261000,705,300,70.15,29.85,395,423,270,0,15,0,145,24,43,104,0,143,404,57,78,6911
1029,952,77,238,714,1989,953,241300,177,852,17.20,82.80,755,413,75,0,0,30,627,152,20,0,0,58,86,0,0,6912
795,795,0,698,97,1979,1375,287900,783,12,98.49,1.51,67,304,363,15,0,0,28,0,19,0,0,51,517,78,26,6913
1101,1061,40,756,305,1989,984,182400,912,189,82.83,17.17,753,121,99,105,15,34,115,163,0,0,15,368,213,33,20,6914
683,532,151,427,105,1985,887,201600,462,221,67.64,32.36,220,51,192,52,202,0,55,0,0,0,98,64,85,19,28,6915
726,670,56,400,270,1989,1098,297200,410,316,56.47,43.53,246,164,110,18,10,0,137,84,18,0,0,81,85,54,55,6916
614,555,59,474,81,2001,0,363800,614,0,100.00,0.00,410,83,110,0,21,24,10,46,14,0,0,16,70,109,307,6917
753,691,62,551,140,1977,670,197600,516,237,68.53,31.47,235,91,238,108,177,16,88,14,0,0,132,445,57,0,0,6918
587,587,0,572,15,1992,0,346100,587,0,100.00,0.00,327,187,72,0,27,0,0,14,0,0,15,84,195,176,129,6919
1421,1378,43,1317,61,1998,1690,226300,1397,24,98.31,1.69,749,65,180,88,161,29,34,0,0,0,11,552,598,0,0,6920
243,243,0,71,172,1950,617,0,166,77,68.31,31.69,34,51,64,24,74,45,57,13,0,0,24,96,12,0,0,6921
1344,350,994,246,104,1983,1074,192900,1093,251,81.32,18.68,229,164,98,42,464,25,87,9,10,0,20,139,44,10,40,6922
542,542,0,431,111,1979,782,127800,404,138,74.54,25.46,224,17,110,54,54,34,78,16,0,0,154,136,0,0,0,6923
442,442,0,210,232,1962,538,98200,271,171,61.31,38.69,10,10,128,11,170,0,36,36,0,0,30,169,0,0,0,6924
1026,414,612,319,95,1988,841,295000,863,163,84.11,15.89,545,152,192,96,150,0,18,0,0,0,0,73,61,98,108,6925
995,920,75,194,726,1977,732,535700,383,612,38.49,61.51,132,133,195,97,235,171,265,170,18,0,18,14,13,20,70,6926
1016,892,124,793,99,1975,1675,736600,689,327,67.81,32.19,244,108,21,75,475,0,0,57,0,27,0,9,50,72,578,6927
1032,901,131,200,701,1978,705,183700,296,736,28.68,71.32,386,298,217,53,30,145,500,68,0,54,12,103,32,0,0,6928
566,490,76,0,490,1994,1104,0,28,538,4.95,95.05,432,105,0,0,0,0,245,143,15,74,0,16,0,0,0,6929
846,823,23,631,192,1968,669,240200,674,172,79.67,20.33,161,57,244,71,235,9,16,11,0,0,52,138,272,9,192,6930
757,623,134,500,123,1976,957,193300,588,169,77.68,22.32,189,144,167,46,205,0,76,35,2,0,37,285,154,22,7,6931
808,738,70,637,101,1984,628,236000,547,261,67.70,32.30,343,68,217,141,49,14,76,10,0,0,47,144,228,99,97,6932
654,586,68,208,378,1969,727,223700,349,305,53.36,46.64,16,115,179,247,83,49,218,36,0,0,11,199,50,0,0,6933
627,535,92,261,274,1982,939,470000,468,159,74.64,25.36,145,20,141,100,315,0,80,72,0,0,17,45,68,62,172,6934
809,809,0,410,399,1992,948,153300,462,347,57.11,42.89,328,119,277,10,80,13,223,97,0,0,0,390,0,0,0,6935
629,609,20,181,428,1964,0,389000,234,395,37.20,62.80,167,22,149,77,99,75,194,57,45,0,0,13,44,23,22,6936
182,150,32,150,0,1972,0,140600,155,27,85.16,14.84,56,0,160,32,76,0,36,7,0,0,81,76,68,23,0,6937
562,495,67,370,125,1967,721,536200,510,52,90.75,9.25,147,90,76,28,164,15,36,0,0,0,25,22,68,63,195,6938
298,265,33,87,178,1960,613,286100,121,177,40.60,59.40,47,0,15,13,85,9,36,15,0,0,6,28,38,11,0,6939
271,271,0,225,46,1973,512,174000,254,17,93.73,6.27,133,60,36,63,16,0,0,29,0,0,55,117,60,7,40,6940
638,638,0,510,128,1988,719,296700,506,132,79.31,20.69,275,109,140,0,17,0,70,0,0,0,20,139,124,44,127,6941
534,475,59,176,299,1957,648,371900,295,239,55.24,44.76,68,26,26,116,310,57,225,0,8,0,0,42,69,57,42,6942
570,531,39,448,83,1977,0,187800,429,141,75.26,24.74,354,43,238,52,29,96,58,21,0,0,61,123,182,94,19,6943
496,496,0,376,120,1992,1025,176900,478,18,96.37,3.63,193,14,169,11,131,8,76,25,0,0,0,315,86,8,0,6944
654,654,0,628,26,1978,0,342200,540,114,82.57,17.43,150,97,178,117,143,0,11,72,0,0,14,64,182,84,142,6945
451,392,59,191,201,1981,1003,222600,316,135,70.07,29.93,70,66,61,60,84,0,53,44,0,0,0,116,54,43,8,6946
759,745,14,322,423,1939,1359,664000,321,438,42.29,57.71,99,18,44,62,632,0,236,84,58,0,15,49,21,48,258,6947
1893,1794,99,1092,702,2003,1253,471100,1495,398,78.98,21.02,1027,106,124,82,29,13,128,102,70,24,14,28,164,224,253,6948
520,520,0,498,22,1963,0,244300,520,0,100.00,0.00,0,0,53,235,213,0,16,67,0,0,38,134,223,23,0,6949
1710,1621,89,838,783,1994,1071,208500,1178,532,68.89,31.11,751,180,456,82,77,186,189,198,10,0,214,266,393,22,0,6950
488,449,39,270,179,1978,913,179000,418,70,85.66,14.34,168,15,161,9,73,30,83,52,45,0,8,118,33,9,10,6951
265,203,62,168,35,1981,0,290700,214,51,80.75,19.25,74,24,54,0,115,25,0,0,0,0,12,43,39,20,49,6952
632,573,59,135,438,1966,680,110900,235,397,37.18,62.82,98,50,253,83,232,100,336,50,0,0,25,175,0,0,0,6953
236,195,41,185,10,1978,0,332800,181,55,76.69,23.31,53,0,172,87,88,72,15,29,0,0,56,70,91,27,26,6954
343,321,22,224,97,1983,0,238000,231,112,67.35,32.65,96,34,77,61,81,0,38,6,0,0,13,82,89,23,67,6955
543,361,182,273,88,1963,969,158200,481,62,88.58,11.42,55,65,93,45,364,6,97,0,0,0,30,164,79,27,19,6956
557,427,130,280,147,1990,711,221700,280,277,50.27,49.73,258,40,101,17,61,38,162,33,0,0,9,159,76,0,0,6957
760,720,40,529,191,1978,1151,297800,660,100,86.84,13.16,155,137,267,49,111,35,116,47,0,0,0,115,224,77,105,6958
900,856,44,242,614,1977,865,189600,381,519,42.33,57.67,362,154,228,33,163,0,534,112,0,0,0,213,37,0,0,6959
550,403,147,305,98,1971,917,143900,414,136,75.27,24.73,173,73,96,84,72,0,18,18,0,0,151,194,117,0,0,6960
1140,1140,0,672,468,1980,1055,409200,850,290,74.56,25.44,360,210,253,176,209,0,171,142,30,11,0,18,336,201,241,6961
434,412,22,403,9,1979,0,305900,426,8,98.16,1.84,105,13,207,47,101,0,0,24,0,0,0,80,146,74,104,6962
447,447,0,161,286,1996,1307,384800,194,253,43.40,56.60,417,9,27,37,19,0,141,163,19,0,7,13,0,0,102,6963
380,312,68,278,34,1993,0,270500,248,132,65.26,34.74,162,82,66,0,37,12,31,33,0,0,10,83,83,56,11,6964
593,593,0,488,105,2001,2608,334800,409,184,68.97,31.03,376,26,27,43,50,0,19,10,20,0,104,37,57,157,78,6965
1152,1101,51,758,343,2001,1313,168400,988,164,85.76,14.24,677,88,96,14,134,0,60,90,0,0,90,468,203,5,32,6966
1071,1071,0,785,286,2001,1429,272500,896,175,83.66,16.34,623,143,254,43,67,101,20,65,0,12,13,377,267,97,99,6967
995,895,100,815,80,2001,0,257900,783,212,78.69,21.31,640,164,119,31,52,0,97,73,0,0,63,226,224,103,93,6968
705,650,55,594,56,1983,794,301800,605,100,85.82,14.18,294,107,266,29,63,11,16,11,0,0,46,156,216,137,103,6969
505,458,47,341,117,1965,794,215000,382,123,75.64,24.36,33,21,134,146,126,0,37,14,0,0,98,180,61,0,34,6970
528,479,49,160,319,1975,520,72500,390,138,73.86,26.14,80,122,91,9,109,80,124,34,0,0,38,102,0,0,0,6971
766,654,112,485,169,1978,1071,249600,574,192,74.93,25.07,179,116,255,51,201,9,89,13,0,27,80,190,274,14,35,6972
987,962,25,496,466,1975,834,169400,578,409,58.56,41.44,155,36,174,91,182,113,89,20,0,0,45,243,56,0,22,6973
497,497,0,232,265,1978,1054,152900,203,294,40.85,59.15,266,31,263,57,9,0,272,10,0,0,52,205,38,0,0,6974
427,401,26,271,130,1959,1084,242900,360,67,84.31,15.69,64,10,43,39,326,21,25,103,10,0,10,157,97,0,0,6975
480,458,22,315,143,1943,839,216800,424,56,88.33,11.67,24,22,21,18,299,0,46,19,40,0,18,88,117,0,0,6976
743,671,72,573,98,1990,1555,246000,655,88,88.16,11.84,659,37,151,35,101,0,83,25,39,0,0,75,373,45,177,6977
350,326,24,261,65,1973,690,148600,279,71,79.71,20.29,18,73,129,91,169,0,80,0,0,0,85,196,97,0,0,6978
319,246,73,196,50,1980,969,325800,231,88,72.41,27.59,164,44,51,16,195,14,76,0,0,0,39,65,56,22,88,6979
690,643,47,549,94,1982,935,300400,412,278,59.71,40.29,60,60,185,148,141,0,79,14,9,0,46,57,157,111,51,6980
438,316,122,280,36,1959,0,214400,413,25,94.29,5.71,128,43,238,25,113,48,47,0,0,0,0,294,70,0,0,6981
431,431,0,343,88,1939,1209,281200,405,26,93.97,6.03,24,0,0,0,406,0,13,48,24,0,0,88,200,18,0,6982
377,377,0,329,48,1969,0,306600,344,33,91.25,8.75,17,0,144,236,0,0,43,20,13,0,0,44,236,41,0,6983
685,593,92,500,93,1983,0,244800,502,183,73.28,26.72,241,187,228,11,93,0,84,146,0,0,0,107,187,64,67,6984
359,359,0,190,169,1994,933,174600,233,126,64.90,35.10,316,30,0,0,0,0,109,0,0,0,17,85,49,39,0,6985
390,390,0,175,215,1966,737,174200,208,182,53.33,46.67,85,86,65,27,200,69,168,16,0,24,12,78,36,21,0,6986
247,247,0,202,45,1953,1130,224500,247,0,100.00,0.00,38,0,0,30,276,0,79,10,0,0,0,136,87,32,0,6987
317,283,34,196,87,1972,705,119000,268,49,84.54,15.46,0,0,157,37,73,11,0,0,0,0,18,126,17,0,0,6988
1668,1624,44,1121,503,2002,1012,181300,1323,345,79.32,20.68,1134,45,85,105,199,55,190,196,62,0,175,684,121,0,24,6989
671,634,37,570,64,1988,1372,256600,671,0,100.00,0.00,280,53,236,59,21,0,13,0,29,0,9,208,246,119,25,6990
864,819,45,659,160,1995,608,248700,709,155,82.06,17.94,390,79,54,20,195,0,25,14,8,0,0,194,244,64,146,6991
607,607,0,367,240,1955,940,406400,394,213,64.91,35.09,105,36,37,120,377,0,189,72,10,28,22,47,94,120,57,6992
1023,882,141,397,485,1978,743,178100,716,307,69.99,30.01,379,67,206,55,357,27,187,62,0,0,178,266,122,50,0,6993
1467,1273,194,1007,266,2001,1436,365700,1452,15,98.98,1.02,666,89,124,84,91,0,93,73,12,0,30,132,151,82,407,6994
355,345,10,313,32,1985,0,313200,258,97,72.68,27.32,172,7,68,48,34,10,0,29,28,0,8,49,89,42,74,6995
706,565,141,407,158,1976,881,213500,471,235,66.71,33.29,199,118,168,123,164,50,80,11,0,0,86,251,109,14,49,6996
985,862,123,448,414,1990,683,158300,534,451,54.21,45.79,352,49,238,0,83,90,256,11,0,0,37,304,0,10,14,6997
587,535,52,428,107,1965,942,161100,524,63,89.27,10.73,34,31,74,115,299,58,29,55,0,0,10,292,57,9,11,6998
315,315,0,220,95,1979,1144,356500,248,67,78.73,21.27,20,52,112,27,95,0,23,0,0,0,8,39,51,35,139,6999
681,681,0,495,186,1974,1887,287800,623,58,91.48,8.52,184,86,240,91,90,0,121,83,0,0,0,94,170,130,93,7000
1208,991,217,497,494,1976,802,213800,825,383,68.29,31.71,316,79,237,59,451,119,298,13,13,0,52,331,92,33,10,7001
384,367,17,251,116,1980,988,262200,243,141,63.28,36.72,34,69,151,46,101,23,42,63,0,0,6,90,90,6,50,7002
581,440,141,310,130,1979,0,98800,385,196,66.27,33.73,141,42,141,83,0,4,50,9,7,11,25,193,48,15,10,7003
277,243,34,130,113,1971,985,515900,227,50,81.95,18.05,24,25,52,3,157,18,66,24,2,0,24,23,7,19,45,7004
1127,1112,15,626,486,2001,1057,256500,720,407,63.89,36.11,798,87,108,30,85,0,356,98,43,0,62,262,154,15,0,7005
1090,1030,60,573,457,1983,997,305800,790,300,72.48,27.52,266,447,396,0,6,0,143,107,58,0,11,158,444,147,47,7006
347,347,0,49,298,1993,940,0,49,298,14.12,85.88,133,215,79,0,0,0,341,12,0,0,0,12,27,0,0,7007
631,620,11,360,260,1978,973,206400,478,153,75.75,24.25,211,62,382,0,0,0,126,56,0,0,37,217,189,30,0,7008
888,828,60,507,321,1977,749,205700,563,325,63.40,36.60,201,56,352,50,187,76,184,32,12,0,43,302,96,39,0,7009
404,404,0,338,66,1939,2045,436900,404,0,100.00,0.00,0,0,0,0,380,0,0,31,46,0,0,18,115,69,101,7010
766,766,0,590,176,1987,1110,257900,659,107,86.03,13.97,331,43,150,30,125,0,98,56,0,0,16,187,252,9,52,7011
709,633,76,473,160,1977,0,300900,519,190,73.20,26.80,146,61,126,44,211,28,9,0,0,0,12,99,212,31,86,7012
989,970,19,483,487,1990,1083,258900,655,334,66.23,33.77,691,101,211,89,70,0,246,201,50,24,14,142,279,40,35,7013
984,885,99,171,714,1978,917,255100,268,716,27.24,72.76,421,115,105,130,155,88,539,48,0,0,0,131,30,0,0,7014
720,683,37,466,217,1988,1318,177400,683,37,94.86,5.14,297,149,241,27,82,0,89,67,17,0,0,436,153,0,13,7015
1025,941,84,437,504,1985,881,280400,578,447,56.39,43.61,354,115,193,70,167,0,404,35,0,12,0,127,78,14,112,7016
467,467,0,451,16,1969,0,172300,450,17,96.36,3.64,0,52,116,294,31,0,13,0,0,0,0,340,140,0,0,7017
1326,1130,196,955,175,1998,897,169400,1105,221,83.33,16.67,678,125,202,32,99,24,69,125,8,7,212,546,116,15,0,7018
734,683,51,467,216,1973,768,169700,481,253,65.53,34.47,194,32,25,143,404,118,107,22,0,0,121,270,21,12,29,7019
312,256,56,99,157,1954,762,130500,275,37,88.14,11.86,0,0,17,13,244,8,165,9,0,0,42,37,13,0,0,7020
292,292,0,282,10,1981,0,13400,61,231,20.89,79.11,77,110,110,0,68,5,49,0,0,0,234,0,15,0,0,7021
787,775,12,522,253,2003,1373,276100,687,100,87.29,12.71,427,105,43,31,28,0,25,52,9,0,32,171,203,112,0,7022
652,612,40,567,45,1978,783,367100,538,114,82.52,17.48,138,102,217,52,160,0,35,47,0,0,22,177,184,128,45,7023
613,490,123,282,208,1986,822,187500,514,99,83.85,16.15,168,96,182,94,94,42,167,0,0,0,35,275,92,0,17,7024
573,550,23,395,155,1988,1035,165600,340,233,59.34,40.66,294,62,132,41,130,9,80,36,0,0,156,151,113,31,27,7025
794,686,108,580,106,1992,849,157000,580,214,73.05,26.95,487,13,143,16,46,0,81,23,0,0,32,204,53,15,153,7026
1548,1289,259,590,699,1971,844,146600,860,688,55.56,44.44,419,116,356,143,394,0,436,111,38,0,49,419,255,0,0,7027
1133,1022,111,792,230,1998,1857,489600,1133,0,100.00,0.00,947,116,11,0,0,0,0,10,20,0,0,76,212,146,575,7028
317,317,0,253,64,1956,1060,329700,290,27,91.48,8.52,91,55,77,37,186,16,87,130,0,0,0,21,81,21,32,7029
1065,863,202,318,545,1982,671,310500,496,569,46.57,53.43,320,128,45,20,304,0,226,50,13,0,0,202,91,34,84,7030
410,356,54,312,44,1978,1250,434500,379,31,92.44,7.56,85,76,18,16,123,0,0,10,0,0,65,24,56,37,126,7031
788,760,28,512,248,1979,1213,332000,715,73,90.74,9.26,426,110,249,22,122,0,76,45,24,0,0,58,286,31,226,7032
398,266,132,187,79,1975,1101,277200,299,99,75.13,24.87,0,21,212,62,0,0,37,55,0,0,0,32,171,0,0,7033
1030,933,97,304,629,1997,1052,130600,333,697,32.33,67.67,430,0,111,35,181,3,361,78,14,0,108,180,13,0,0,7034
1138,872,266,671,201,1993,1006,268700,865,273,76.01,23.99,676,265,91,0,0,0,13,94,26,0,34,231,285,23,148,7035
355,288,67,265,23,1979,0,354000,332,23,93.52,6.48,35,59,34,16,153,4,40,0,0,0,12,79,16,79,30,7036
798,722,76,538,184,1975,549,120300,307,491,38.47,61.53,211,87,358,182,41,71,174,14,0,0,280,98,86,15,64,7037
692,619,73,208,411,1967,843,165500,295,397,42.63,57.37,195,243,111,20,193,83,119,27,129,55,0,133,33,0,0,7038
924,890,34,505,385,1982,921,115700,570,354,61.69,38.31,418,49,199,99,153,45,143,12,0,0,199,270,20,41,51,7039
855,777,78,309,468,1989,765,186900,376,479,43.98,56.02,237,103,297,128,11,25,212,57,16,49,14,326,43,0,0,7040
839,821,18,689,132,1980,1396,222100,826,13,98.45,1.55,250,168,269,22,48,0,0,72,12,0,0,329,258,30,13,7041
377,313,64,134,179,1978,544,117600,165,212,43.77,56.23,156,29,155,14,46,73,48,0,0,0,37,122,28,0,11,7042
499,436,63,110,326,1947,814,130700,336,163,67.33,32.67,100,0,36,120,311,79,226,0,0,0,6,91,4,0,0,7043
1078,990,88,6,984,1992,1133,0,7,1071,0.65,99.35,772,197,80,0,0,0,655,327,31,0,0,0,0,0,0,7044
683,653,30,25,628,1972,693,218800,49,634,7.17,92.83,161,88,135,148,129,184,330,39,0,24,0,21,29,0,0,7045
721,447,274,386,61,1972,693,215300,560,161,77.67,22.33,302,60,221,133,141,0,74,0,0,0,0,126,72,43,108,7046
1773,1678,95,1027,651,2004,1490,314900,1358,415,76.59,23.41,1541,37,6,0,27,0,224,245,84,0,0,91,619,179,61,7047
296,256,40,165,91,1976,806,272100,189,107,63.85,36.15,106,35,47,12,11,0,0,0,0,0,0,28,21,21,132,7048
663,269,394,230,39,1987,0,218900,450,213,67.87,32.13,260,73,174,86,123,0,50,88,0,0,86,110,51,31,28,7049
199,199,0,185,14,1979,0,92300,129,70,64.82,35.18,12,100,41,14,183,37,99,0,0,0,57,95,12,0,0,7050
1033,950,83,708,242,1993,1073,174400,762,271,73.77,26.23,337,93,220,54,14,21,43,14,0,0,57,449,74,0,0,7051
769,744,25,543,201,1976,1096,282100,683,86,88.82,11.18,278,73,197,94,205,0,18,45,28,0,9,163,310,99,117,7052
1070,968,102,856,112,1995,0,252100,1070,0,100.00,0.00,938,53,112,14,101,16,0,103,69,0,0,267,725,25,13,7053
470,428,42,61,367,1991,1096,546400,47,423,10.00,90.00,288,11,109,44,11,0,157,145,0,0,16,0,1,0,5,7054
308,265,43,149,116,1977,1677,296800,243,65,78.90,21.10,162,31,18,0,105,0,19,37,0,0,0,40,134,46,40,7055
1151,1030,121,226,804,1980,964,129900,165,986,14.34,85.66,75,457,490,110,25,15,757,14,0,0,11,189,0,0,0,7056
450,396,54,275,121,1988,0,348100,323,127,71.78,28.22,209,45,53,34,118,0,32,0,0,0,27,94,102,45,105,7057
825,754,71,494,260,1979,653,207100,627,198,76.00,24.00,182,37,90,25,362,15,67,35,0,0,88,87,167,7,27,7058
952,920,32,632,288,1980,772,26900,218,734,22.90,77.10,257,105,195,130,169,0,243,25,19,0,209,153,47,10,32,7059
605,605,0,487,118,1972,2169,196300,605,0,100.00,0.00,140,0,165,50,177,0,54,40,0,0,0,257,43,31,49,7060
470,470,0,427,43,1977,0,140800,302,168,64.26,35.74,89,46,349,0,0,0,112,32,0,0,87,221,32,0,0,7061
672,611,61,435,176,1997,1232,329400,476,196,70.83,29.17,344,29,177,8,67,35,128,0,0,0,71,26,139,108,68,7062
227,204,23,169,35,1985,472,109400,154,73,67.84,32.16,53,60,59,57,69,0,47,0,0,0,34,46,41,0,0,7063
592,517,75,483,34,1974,1121,314100,577,15,97.47,2.53,126,21,154,92,13,0,0,65,0,0,30,71,134,71,35,7064
722,722,0,405,317,1997,2573,366500,414,308,57.34,42.66,458,26,72,59,131,0,18,0,38,170,0,91,122,102,129,7065
679,663,16,363,300,1965,795,177900,603,76,88.81,11.19,66,42,74,182,200,13,128,14,0,0,0,288,95,13,13,7066
707,685,22,549,136,1975,0,294500,565,142,79.92,20.08,271,74,146,68,203,25,58,19,0,0,10,168,260,93,104,7067
1013,935,78,486,449,1976,943,226700,582,431,57.45,42.55,97,106,230,230,318,0,230,95,0,0,19,445,182,10,0,7068
355,355,0,314,41,1978,0,95200,167,188,47.04,52.96,249,32,184,38,42,68,65,0,0,0,96,204,68,0,0,7069
483,444,39,322,122,1972,584,293000,327,156,67.70,32.30,145,20,166,93,43,49,86,37,12,0,20,53,146,23,41,7070
663,663,0,417,246,2001,710,219800,454,209,68.48,31.52,435,132,0,0,39,8,58,9,0,56,75,225,114,26,19,7071
455,366,89,229,137,1978,787,157500,213,242,46.81,53.19,32,163,201,104,108,63,245,58,0,0,25,98,20,18,0,7072
503,411,92,53,358,1990,781,0,159,344,31.61,68.39,148,79,148,24,121,15,198,0,82,0,12,0,41,13,0,7073
369,254,115,218,36,1971,705,289100,305,64,82.66,17.34,45,68,76,42,122,2,3,3,0,0,39,81,60,28,40,7074
499,499,0,396,103,1998,1556,370100,486,13,97.39,2.61,121,53,110,47,92,0,12,28,57,0,0,49,100,9,87,7075
471,436,35,378,58,1961,1109,464300,391,80,83.01,16.99,0,7,69,116,319,0,45,11,0,0,7,85,114,36,213,7076
877,792,85,617,175,1977,986,201000,778,99,88.71,11.29,278,124,295,50,175,0,78,141,0,0,98,383,188,0,10,7077
610,610,0,538,72,1974,2145,242900,412,198,67.54,32.46,166,35,215,20,98,9,14,74,0,0,67,122,91,55,59,7078
952,888,64,311,577,1972,729,187300,492,460,51.68,48.32,172,113,170,45,374,114,360,54,0,0,0,167,31,0,25,7079
355,355,0,332,23,1995,0,444000,332,23,93.52,6.48,188,24,157,29,28,0,14,19,0,0,0,13,195,85,100,7080
2215,2047,168,746,1301,2002,1297,246500,801,1414,36.16,63.84,1635,36,0,41,0,0,326,420,9,0,11,355,358,34,7,7081
1090,984,106,298,686,1974,816,188300,519,571,47.61,52.39,299,97,426,92,102,96,573,121,0,0,36,154,36,0,0,7082
811,811,0,508,303,1959,806,250000,663,148,81.75,18.25,84,0,224,172,341,9,361,49,28,0,21,141,180,22,0,7083
270,270,0,226,44,1994,1025,251900,257,13,95.19,4.81,214,19,0,9,65,0,12,0,0,0,13,104,144,12,22,7084
428,428,0,305,123,1977,606,224600,316,112,73.83,26.17,47,117,153,57,138,0,56,17,0,0,43,147,182,0,0,7085
769,685,84,151,534,1965,599,158200,289,480,37.58,62.42,92,35,145,239,264,212,307,20,0,0,10,91,21,0,0,7086
179,162,17,0,162,1998,794,0,52,127,29.05,70.95,93,0,90,16,117,58,156,22,25,12,0,0,24,0,0,7087
410,293,117,38,255,1977,865,256700,100,310,24.39,75.61,200,30,103,26,59,0,218,8,0,0,0,9,29,0,35,7088
1036,840,196,247,593,1979,853,0,237,799,22.88,77.12,361,119,320,61,0,0,415,53,0,11,136,180,14,0,0,7089
333,333,0,236,97,1977,1460,283500,246,87,73.87,26.13,46,128,126,29,39,0,11,11,18,17,0,68,141,6,8,7090
357,307,50,200,107,1964,1682,233600,325,32,91.04,8.96,6,10,55,183,58,0,41,19,0,0,0,147,71,0,0,7091
316,316,0,101,215,1952,1056,270200,224,92,70.89,29.11,80,8,38,29,155,58,68,63,0,0,0,61,26,19,0,7092
380,301,79,133,168,1955,881,226800,268,112,70.53,29.47,0,55,0,52,268,45,37,0,25,0,15,177,45,0,9,7093
821,718,103,102,616,1963,863,263300,167,654,20.34,79.66,13,73,133,88,507,64,395,40,13,33,0,36,57,0,0,7094
496,469,27,387,82,1976,905,231700,415,81,83.67,16.33,79,79,147,38,122,9,63,47,0,0,21,135,110,12,19,7095
656,656,0,539,117,1978,903,476900,626,30,95.43,4.57,123,23,125,68,145,18,10,21,16,0,16,54,129,91,116,7096
630,570,60,426,144,1975,757,194900,330,300,52.38,47.62,176,59,156,95,113,11,82,35,41,0,59,89,114,55,55,7097
473,434,39,372,62,1976,806,251100,368,105,77.80,22.20,109,51,52,59,153,25,4,30,0,0,45,145,88,7,38,7098
658,586,72,456,130,1976,595,291200,506,152,76.90,23.10,139,122,296,98,137,30,51,10,33,0,81,140,129,86,105,7099
565,516,49,431,85,1995,941,378400,447,118,79.12,20.88,351,116,114,0,110,0,39,0,37,0,53,24,101,97,247,7100
276,276,0,217,59,1977,0,298700,175,101,63.41,36.59,154,53,72,27,121,22,23,28,0,0,44,106,79,18,88,7101
822,740,82,687,53,1988,1422,405800,807,15,98.18,1.82,412,145,240,0,10,0,0,19,10,0,0,42,115,138,375,7102
2247,1469,778,1050,419,1996,956,170400,1901,346,84.60,15.40,929,431,204,105,108,47,177,0,0,0,94,289,258,103,240,7103
438,409,29,370,39,1977,0,172200,271,167,61.87,38.13,95,78,115,86,99,0,34,59,0,0,104,97,20,26,122,7104
1344,480,864,411,69,1991,0,215600,1110,234,82.59,17.41,414,273,253,58,172,9,134,0,0,0,118,124,35,67,61,7105
1786,1507,279,1330,177,1995,829,167100,1069,717,59.85,40.15,1037,217,170,52,31,12,71,0,0,0,111,627,288,55,88,7106
1285,993,292,446,547,1977,728,160000,503,782,39.14,60.86,370,136,249,109,222,181,314,16,0,0,85,53,53,19,12,7107
573,453,120,60,393,1981,855,236800,112,461,19.55,80.45,261,122,143,90,222,33,587,82,69,0,9,37,21,0,0,7108
453,453,0,391,62,1995,766,125700,262,191,57.84,42.16,191,75,173,32,55,0,55,0,0,0,132,274,30,0,0,7109
535,482,53,346,136,1972,665,115500,349,186,65.23,34.77,79,97,72,80,211,23,68,7,0,0,151,173,12,0,6,7110
797,797,0,400,397,1959,978,207900,517,280,64.87,35.13,130,37,26,184,324,56,165,62,0,0,0,297,87,0,0,7111
1038,1038,0,282,756,1980,759,177900,497,541,47.88,52.12,554,65,264,54,55,123,436,143,15,16,0,247,12,0,0,7112
446,446,0,294,152,1974,698,198500,380,66,85.20,14.80,79,43,62,135,111,32,46,20,0,0,0,158,102,26,11,7113
384,373,11,337,36,1974,1550,337700,384,0,100.00,0.00,104,13,147,136,112,0,25,62,0,0,0,12,272,68,73,7114
417,417,0,303,114,1952,1635,288700,371,46,88.97,11.03,0,0,14,11,366,0,55,0,0,0,14,117,181,12,12,7115
324,324,0,21,303,1944,533,164100,111,213,34.26,65.74,69,50,66,22,448,182,147,0,0,0,57,47,0,0,0,7116
666,597,69,168,429,1945,672,240900,217,449,32.58,67.42,65,8,43,41,368,5,209,58,0,0,0,105,23,0,12,7117
255,255,0,108,147,1974,728,117900,131,124,51.37,48.63,90,0,0,49,175,12,101,12,0,0,0,156,0,0,0,7118
280,217,63,192,25,1979,0,159800,212,68,75.71,24.29,31,91,103,57,69,0,0,0,0,0,119,149,35,17,0,7119
906,891,15,205,686,1990,707,158200,386,520,42.60,57.40,233,65,412,133,110,231,428,60,0,0,0,46,56,0,0,7120
396,369,27,209,160,1976,900,175500,315,81,79.55,20.45,138,31,112,26,132,0,123,6,0,0,15,228,28,0,0,7121
492,492,0,423,69,1975,692,294400,372,120,75.61,24.39,75,40,61,61,195,22,0,0,0,0,47,137,97,71,58,7122
396,352,44,249,103,1958,628,268900,305,91,77.02,22.98,53,89,0,0,191,16,41,15,0,0,18,60,34,0,35,7123
483,428,55,374,54,1991,0,239200,449,34,92.96,7.04,291,0,34,40,92,19,0,56,12,0,9,50,150,17,84,7124
347,309,38,237,72,1984,895,238500,249,98,71.76,28.24,109,74,65,131,110,0,129,21,0,0,69,108,65,36,22,7125
1079,974,105,696,278,1976,1311,166800,937,142,86.84,13.16,344,16,359,168,95,0,93,133,0,0,13,557,160,0,17,7126
752,595,157,465,130,1980,890,287100,517,235,68.75,31.25,316,90,170,46,65,0,0,0,0,0,16,168,263,68,124,7127
437,437,0,337,100,1991,0,371000,365,72,83.52,16.48,194,79,52,49,9,0,36,0,33,0,0,9,53,80,138,7128
1061,1012,49,918,94,1993,1305,334500,829,232,78.13,21.87,715,62,85,23,185,10,103,127,36,11,30,23,279,197,200,7129
484,484,0,402,82,1983,0,147100,227,257,46.90,53.10,238,63,114,12,58,4,64,11,0,0,116,32,81,58,35,7130
852,832,20,737,95,1985,1338,247300,849,3,99.65,0.35,140,300,296,47,11,0,32,39,0,0,0,96,516,42,20,7131
964,759,205,620,139,1976,721,289300,787,177,81.64,18.36,262,121,143,89,330,0,170,22,0,0,75,153,235,117,92,7132
315,288,27,202,86,1977,842,387000,194,121,61.59,38.41,77,0,42,47,65,0,31,0,0,0,17,12,44,25,90,7133
894,894,0,332,562,1973,807,271300,437,457,48.88,51.12,269,179,266,170,145,113,311,274,67,0,14,49,107,37,11,7134
605,592,13,439,153,1987,1136,0,178,427,29.42,70.58,163,109,169,0,0,13,0,34,0,0,208,57,52,0,0,7135
836,733,103,256,477,1978,713,258800,427,409,51.08,48.92,129,103,175,13,138,93,150,34,0,0,33,76,110,31,0,7136
1561,1452,109,885,567,1991,775,163700,911,650,58.36,41.64,570,223,70,198,173,72,312,151,0,0,266,159,191,13,28,7137
1518,1419,99,712,707,1991,930,191500,1149,369,75.69,24.31,965,380,143,43,27,0,498,234,0,0,5,256,387,9,54,7138
1021,945,76,836,109,1997,2065,293200,991,30,97.06,2.94,686,121,142,18,5,0,0,0,0,0,0,31,426,133,295,7139
325,288,37,263,25,1974,896,315400,269,56,82.77,17.23,46,84,95,127,12,0,30,0,0,0,0,9,114,45,154,7140
460,460,0,377,83,1991,0,224800,383,77,83.26,16.74,313,155,56,167,49,0,65,0,0,0,136,310,55,28,0,7141
421,167,254,124,43,1981,1327,320700,417,4,99.05,0.95,170,122,127,47,10,0,13,31,10,0,67,0,136,103,27,7142
1076,834,242,396,438,1998,939,198100,853,223,79.28,20.72,533,60,113,38,172,13,176,80,29,4,13,137,127,21,87,7143
667,523,144,350,173,1982,0,562500,535,132,80.21,19.79,304,103,133,16,26,0,14,0,0,0,0,57,78,22,253,7144
348,331,17,253,78,1974,983,359000,287,61,82.47,17.53,49,34,65,14,149,0,17,0,27,0,10,66,54,73,64,7145
2001,1921,80,1511,410,2000,1154,224200,1971,30,98.50,1.50,1728,245,187,27,76,0,267,279,20,0,25,394,678,205,130,7146
541,484,57,431,53,1993,1066,287200,356,185,65.80,34.20,589,51,105,31,27,0,0,0,0,0,54,48,222,102,240,7147
671,671,0,612,59,1990,0,305400,586,85,87.33,12.67,262,180,186,11,0,0,0,44,0,0,121,22,229,127,26,7148
699,555,144,349,206,2002,1174,149700,633,66,90.56,9.44,499,92,170,0,12,37,94,167,41,0,33,211,158,32,0,7149
1284,1094,190,758,336,1996,925,374100,672,612,52.34,47.66,686,106,95,9,30,0,43,70,49,0,0,130,138,91,240,7150
761,581,180,344,237,1982,649,622900,482,279,63.34,36.66,343,211,181,63,38,0,115,67,0,0,0,12,64,88,284,7151
252,188,64,79,109,1939,866,531300,246,6,97.62,2.38,33,8,35,18,217,0,106,26,0,0,9,0,104,9,22,7152
1371,1325,46,812,513,1998,1069,150700,1079,292,78.70,21.30,941,115,75,0,40,0,171,169,0,17,38,378,154,47,84,7153
382,382,0,112,270,1946,775,0,334,48,87.43,12.57,34,28,30,48,292,15,110,103,0,0,11,125,55,0,13,7154
806,778,28,375,403,1982,967,246000,475,331,58.93,41.07,200,274,303,54,50,173,203,13,23,0,32,142,259,14,10,7155
654,654,0,500,154,1980,1542,249000,654,0,100.00,0.00,226,46,250,62,62,30,0,73,0,0,14,257,203,8,11,7156
643,643,0,447,196,1970,807,262700,489,154,76.05,23.95,119,46,141,242,70,0,57,12,0,0,12,139,290,18,0,7157
390,390,0,275,115,1976,1295,276800,335,55,85.90,14.10,0,36,383,0,11,0,95,36,0,0,0,23,187,11,0,7158
949,899,50,744,155,1988,1559,303600,932,17,98.21,1.79,389,489,71,7,34,44,0,10,33,0,8,86,389,216,175,7159
766,766,0,662,104,1982,1140,214400,718,48,93.73,6.27,266,147,205,75,59,0,48,93,18,0,0,259,222,31,0,7160
565,498,67,294,204,1980,1688,241700,399,166,70.62,29.38,137,189,81,38,78,0,38,52,25,121,0,113,133,0,0,7161
610,561,49,388,173,1976,1129,271800,365,245,59.84,40.16,26,99,372,42,0,0,119,0,0,0,27,79,239,26,0,7162
528,528,0,496,32,1958,0,437800,528,0,100.00,0.00,12,0,62,104,260,0,0,0,0,0,0,35,103,71,229,7163
1197,1112,85,668,444,1998,1264,221300,1041,156,86.97,13.03,785,157,168,11,85,0,40,185,45,0,81,464,244,23,7,7164
522,522,0,420,102,1978,1500,352200,463,59,88.70,11.30,143,24,138,49,127,0,23,5,8,0,0,28,189,91,137,7165
1073,1005,68,888,117,1984,899,297500,974,99,90.77,9.23,506,168,208,45,127,3,109,93,1,0,20,253,280,62,187,7166
909,909,0,405,504,1989,984,417400,459,450,50.50,49.50,458,537,42,19,0,0,324,199,40,0,10,9,210,152,112,7167
589,556,33,478,78,1980,1266,267600,554,35,94.06,5.94,126,65,133,158,45,16,45,6,0,0,0,167,225,28,40,7168
592,570,22,224,346,1976,1044,221100,364,228,61.49,38.51,240,55,145,108,45,18,187,62,28,0,0,136,132,0,0,7169
852,852,0,651,201,1996,1137,238100,788,64,92.49,7.51,626,144,20,0,18,0,14,112,0,18,0,200,415,29,5,7170
1052,896,156,168,728,1977,769,145500,322,730,30.61,69.39,173,232,279,122,315,46,732,25,0,0,8,109,0,0,0,7171
296,251,45,110,141,1951,884,244400,291,5,98.31,1.69,99,43,68,33,88,34,83,34,0,0,7,70,33,28,33,7172
1802,1637,165,822,815,1995,1005,277000,1099,703,60.99,39.01,1394,109,148,13,184,12,583,154,0,86,34,344,468,72,0,7173
757,725,32,559,166,1974,859,299600,713,44,94.19,5.81,94,45,292,91,261,0,44,40,30,0,18,140,209,94,134,7174
290,290,0,240,50,1960,0,0,213,77,73.45,26.55,63,50,68,30,100,0,13,0,0,0,52,65,82,13,4,7175
481,446,35,258,188,1974,758,221300,335,146,69.65,30.35,105,24,136,46,17,0,95,11,0,0,0,106,50,28,5,7176
1101,965,136,626,339,1974,635,225700,715,386,64.94,35.06,233,89,164,45,339,11,156,7,0,0,85,317,113,52,68,7177
1482,1368,114,1163,205,1996,920,232400,1254,228,84.62,15.38,1071,34,91,39,91,9,110,52,0,21,0,339,623,42,31,7178
592,570,22,465,105,1971,599,190200,459,133,77.53,22.47,97,23,152,58,280,0,71,52,0,0,45,109,180,38,43,7179
453,339,114,32,307,1987,0,0,131,322,28.92,71.08,147,44,44,0,13,0,89,30,29,29,15,13,43,0,0,7180
603,557,46,408,149,1973,573,48700,176,427,29.19,70.81,144,80,177,109,99,32,154,0,0,0,207,110,15,25,0,7181
1057,1031,26,358,673,1971,724,176000,594,463,56.20,43.80,129,65,442,284,181,128,323,13,0,0,17,507,37,23,23,7182
527,506,21,461,45,1996,838,184700,358,169,67.93,32.07,299,37,58,4,142,0,37,35,0,0,53,171,94,44,51,7183
391,391,0,163,228,1994,1081,238600,305,86,78.01,21.99,328,17,24,21,10,0,88,102,0,0,0,116,83,11,0,7184
802,802,0,469,333,1993,1171,202900,787,15,98.13,1.87,618,181,114,0,39,15,107,136,0,0,0,292,299,0,0,7185
1117,1023,94,222,801,1992,865,177600,268,849,23.99,76.01,720,145,170,111,182,46,876,37,0,0,0,101,67,17,35,7186
1125,963,162,798,165,1993,983,303000,826,299,73.42,26.58,557,92,163,26,80,0,79,0,20,0,77,170,165,91,208,7187
431,262,169,254,8,1978,0,0,331,100,76.80,23.20,67,33,105,28,84,0,19,13,0,0,17,68,69,26,49,7188
870,714,156,614,100,1995,1107,198800,552,318,63.45,36.55,753,49,71,0,30,0,0,0,0,0,39,294,239,79,71,7189
1252,1237,15,573,664,1995,1081,186000,976,276,77.96,22.04,975,144,150,0,14,14,408,104,31,109,7,278,273,14,0,7190
642,552,90,360,192,1958,686,159700,537,105,83.64,16.36,99,11,65,19,328,22,57,0,0,0,94,54,98,25,83,7191
537,464,73,270,194,1939,436,87600,386,151,71.88,28.12,45,31,26,6,547,35,145,9,0,0,110,122,10,10,0,7192
742,681,61,640,41,1971,1420,502600,726,16,97.84,2.16,152,165,133,61,152,0,0,6,0,0,0,43,249,161,169,7193
690,690,0,331,359,1974,847,189200,481,209,69.71,30.29,249,12,65,173,99,0,82,14,31,0,0,208,171,42,0,7194
814,802,12,85,717,1939,1011,435000,0,814,0.00,100.00,25,35,55,316,456,68,507,147,17,8,0,0,40,0,0,7195
1575,1458,117,1143,315,1998,1545,577100,1345,230,85.40,14.60,1599,14,68,0,17,0,0,253,63,0,0,59,220,141,842,7196
556,556,0,377,179,1969,854,183600,362,194,65.11,34.89,8,98,116,40,293,0,141,0,14,0,14,341,0,0,0,7197
454,395,59,117,278,1976,987,146500,249,205,54.85,45.15,84,76,13,23,136,40,30,13,0,0,11,164,40,0,13,7198
747,747,0,427,320,1948,811,290900,505,242,67.60,32.40,8,28,17,175,480,24,329,144,0,0,0,20,124,17,20,7199
589,524,65,394,130,1966,1000,271600,474,115,80.48,19.52,14,47,167,146,255,0,67,12,0,0,0,273,161,106,10,7200
977,925,52,743,182,1975,1128,220300,899,78,92.02,7.98,145,125,179,225,445,27,45,13,0,0,7,523,372,57,0,7201
452,427,25,350,77,1975,1054,287100,341,111,75.44,24.56,255,47,126,44,130,0,20,17,0,0,43,130,190,104,22,7202
486,390,96,334,56,1975,0,173500,294,192,60.49,39.51,147,43,198,92,194,18,75,0,0,0,38,197,188,40,28,7203
372,372,0,310,62,1981,544,114600,168,204,45.16,54.84,148,12,145,69,31,11,43,0,0,0,95,111,66,0,0,7204
661,619,42,421,198,1990,869,19200,174,487,26.32,73.68,397,197,158,0,40,24,168,21,0,0,321,118,25,0,0,7205
864,791,73,633,158,1978,862,229800,653,211,75.58,24.42,327,30,125,54,202,8,127,18,0,0,38,170,250,22,56,7206
331,331,0,306,25,1954,0,220600,278,53,83.99,16.01,79,16,64,37,205,0,13,0,0,0,25,100,163,0,46,7207
356,314,42,256,58,1976,731,0,151,205,42.42,57.58,103,57,67,62,142,31,79,9,0,0,134,86,39,18,0,7208
520,474,46,450,24,1992,0,402700,444,76,85.38,14.62,218,18,92,34,99,0,23,10,0,0,0,78,110,97,129,7209
844,730,114,590,140,1976,866,185100,677,167,80.21,19.79,173,93,126,51,371,27,83,48,0,10,53,329,143,4,15,7210
536,527,9,458,69,1991,962,229200,394,142,73.51,26.49,313,94,126,37,178,0,166,17,0,0,92,319,73,0,33,7211
474,421,53,228,193,1955,925,174500,440,34,92.83,7.17,99,35,26,54,196,61,97,9,0,0,0,228,0,0,0,7212
658,541,117,149,392,1939,712,206600,308,350,46.81,53.19,76,23,50,19,487,162,230,8,10,0,24,82,9,7,0,7213
578,547,31,395,152,1980,1037,162700,512,66,88.58,11.42,277,86,55,37,111,0,36,7,0,0,59,380,48,0,0,7214
432,432,0,398,34,1974,0,239600,298,134,68.98,31.02,34,81,139,80,107,0,15,0,0,29,0,148,139,25,49,7215
416,378,38,309,69,1973,788,168300,302,114,72.60,27.40,201,112,74,15,31,0,15,0,0,0,17,128,161,0,112,7216
365,271,94,185,86,1976,775,265900,237,128,64.93,35.07,54,62,89,70,59,0,13,0,0,0,70,85,125,23,18,7217
608,589,19,486,103,1975,763,214000,519,89,85.36,14.64,105,82,107,92,221,16,73,16,0,0,52,228,68,43,53,7218
555,427,128,320,107,1974,1007,227700,483,72,87.03,12.97,102,120,84,65,175,0,27,0,0,0,34,101,155,48,138,7219
782,712,70,462,250,1974,832,158300,610,172,78.01,21.99,53,35,561,125,31,0,253,55,0,8,0,453,23,0,0,7220
1517,918,599,586,332,1988,923,315600,1057,460,69.68,30.32,465,190,272,61,271,48,114,21,9,0,20,173,150,31,102,7221
576,532,44,458,74,2002,1669,182700,423,153,73.44,26.56,473,87,92,0,23,15,21,38,0,0,118,213,133,9,49,7222
548,494,54,462,32,1939,0,426300,509,39,92.88,7.12,0,11,25,8,390,49,0,0,0,10,20,43,163,78,49,7223
693,551,142,105,446,1980,1448,299100,15,678,2.16,97.84,62,234,136,28,97,0,152,52,27,18,0,27,88,65,42,7224
999,971,28,663,308,1962,1033,398300,764,235,76.48,23.52,50,9,166,345,410,35,49,80,12,12,8,78,322,185,113,7225
611,611,0,265,346,1976,1103,193500,321,290,52.54,47.46,92,54,316,73,81,9,75,107,13,84,0,161,108,0,0,7226
1030,1030,0,821,209,1990,978,333400,931,99,90.39,9.61,619,28,299,110,114,0,115,29,59,0,0,281,308,151,212,7227
886,877,9,797,80,1996,1488,262100,874,12,98.65,1.35,680,63,42,39,63,37,0,41,17,0,0,254,319,58,140,7228
333,333,0,238,95,1939,1461,366700,304,29,91.29,8.71,19,25,14,28,334,0,36,37,19,0,8,59,152,76,22,7229
560,515,45,384,131,1972,584,201500,347,213,61.96,38.04,142,56,212,25,242,79,64,9,0,0,96,237,49,28,40,7230
820,748,72,689,59,1977,1902,481300,726,94,88.54,11.46,260,183,156,22,243,37,52,0,10,7,9,128,312,16,245,7231
655,561,94,359,202,1972,732,170900,535,120,81.68,18.32,174,91,254,135,77,97,50,11,0,0,80,251,157,11,7,7232
799,670,129,362,308,1973,590,68900,460,339,57.57,42.43,144,130,133,133,303,231,122,29,0,0,165,122,31,8,0,7233
794,756,38,513,243,1976,966,166100,649,145,81.74,18.26,223,39,156,76,323,11,117,71,0,0,52,296,128,63,24,7234
381,381,0,381,0,1983,0,465300,381,0,100.00,0.00,117,194,82,8,48,0,0,0,0,21,0,36,60,107,177,7235
1285,845,440,650,195,1977,1341,246600,1247,38,97.04,2.96,491,107,211,57,237,0,99,29,0,0,0,471,247,14,27,7236
1329,1315,14,701,614,1992,1063,254900,695,634,52.29,47.71,663,76,325,42,27,14,258,211,69,26,29,199,313,0,0,7237
630,594,36,223,371,1994,976,330200,233,397,36.98,63.02,321,113,0,4,0,0,125,61,0,0,0,0,108,91,23,7238
1511,1511,0,851,660,2001,886,337100,909,602,60.16,39.84,776,46,198,60,12,75,154,21,17,0,0,143,267,161,119,7239
1231,1231,0,889,342,1990,1175,385400,944,287,76.69,23.31,503,522,47,49,20,0,253,36,9,77,14,0,257,281,200,7240
752,720,32,591,129,1975,1007,363200,601,151,79.92,20.08,228,51,276,70,110,0,25,16,12,0,97,86,154,137,162,7241
555,517,38,480,37,1985,1580,642300,548,7,98.74,1.26,144,123,68,25,64,0,25,14,0,0,0,36,12,21,316,7242
620,620,0,542,78,1993,1639,316900,554,66,89.35,10.65,259,76,116,101,174,0,0,20,0,0,11,94,242,127,141,7243
1798,1703,95,1491,212,1996,1250,274800,1642,156,91.32,8.68,865,108,392,22,114,0,113,97,3,0,29,203,838,118,41,7244
1165,1072,93,759,313,1995,965,129800,590,575,50.64,49.36,842,169,76,38,149,36,302,76,0,0,383,385,27,13,0,7245
762,698,64,314,384,1994,943,189100,589,173,77.30,22.70,357,126,11,0,0,17,86,13,0,0,0,316,47,15,0,7246
317,299,18,234,65,1971,970,162900,260,57,82.02,17.98,57,115,82,78,75,0,108,27,0,0,42,212,18,0,0,7247
598,598,0,495,103,1989,925,271900,566,32,94.65,5.35,298,94,70,219,62,0,93,42,50,0,0,212,201,60,33,7248
1208,1121,87,770,351,1991,1296,226500,1091,117,90.31,9.69,646,92,211,86,102,67,74,58,24,0,66,462,253,35,24,7249
484,484,0,396,88,1981,0,442400,428,56,88.43,11.57,149,48,137,31,107,0,7,0,7,14,40,45,136,34,140,7250
318,318,0,293,25,1994,1688,376100,308,10,96.86,3.14,139,35,13,66,36,0,29,0,0,0,0,56,95,17,92,7251
635,635,0,493,142,1982,1157,288100,363,272,57.17,42.83,103,91,188,24,0,10,20,29,0,0,0,74,163,49,41,7252
834,796,38,13,783,1994,1284,0,129,705,15.47,84.53,802,92,24,0,0,0,284,510,11,0,0,0,0,0,0,7253
860,860,0,663,197,1998,1499,220200,659,201,76.63,23.37,840,24,11,0,0,0,0,93,67,0,218,194,255,0,0,7254
564,564,0,440,124,1995,1586,268700,564,0,100.00,0.00,386,143,50,0,19,19,0,54,43,0,0,171,264,0,10,7255
1076,1027,49,551,476,2007,1210,222600,414,662,38.48,61.52,284,79,44,179,35,0,172,65,0,0,0,14,113,0,38,7256
591,547,44,451,96,1992,1603,338000,485,106,82.06,17.94,348,102,116,0,19,0,97,39,0,17,0,13,246,139,19,7257
599,504,95,487,17,1992,0,225200,476,123,79.47,20.53,296,96,96,29,0,0,0,0,0,0,0,243,203,0,0,7258
679,679,0,640,39,0,2770,457900,671,8,98.82,1.18,576,0,8,0,32,0,0,0,0,0,0,12,45,208,319,7259
2281,2046,235,905,1141,1998,1298,377500,1015,1266,44.50,55.50,1377,282,97,150,198,0,408,482,52,49,0,16,293,234,109,7260
611,611,0,383,228,1971,990,338800,381,230,62.36,37.64,11,57,189,248,124,0,190,53,0,0,0,45,79,25,189,7261
918,901,17,349,552,1974,856,406500,431,487,46.95,53.05,73,90,254,121,154,42,278,14,9,0,0,54,131,46,76,7262
981,922,59,498,424,1972,1317,396300,636,345,64.83,35.17,303,26,83,349,325,0,132,191,32,0,0,65,355,55,186,7263
1076,981,95,650,331,1975,868,306900,756,320,70.26,29.74,249,166,451,135,161,18,301,82,0,53,0,182,293,105,55,7264
1348,1306,42,1071,235,1980,1543,377100,1348,0,100.00,0.00,397,65,328,59,229,12,99,0,0,0,13,93,339,214,245,7265
421,396,25,368,28,1978,1143,257000,395,26,93.82,6.18,24,152,264,22,21,0,0,118,0,0,0,102,176,45,0,7266
580,486,94,469,17,2001,0,183300,491,89,84.66,15.34,311,41,79,23,22,0,48,0,0,0,0,333,57,0,38,7267
388,244,144,173,71,1966,762,99100,271,117,69.85,30.15,85,47,67,59,221,5,64,8,0,0,74,134,9,0,12,7268
716,673,43,363,310,1978,625,178600,395,321,55.17,44.83,246,49,223,51,105,91,85,12,13,0,90,194,41,25,25,7269
484,422,62,308,114,1962,1352,223400,452,32,93.39,6.61,55,63,176,51,77,10,38,0,0,0,24,106,165,0,0,7270
366,305,61,106,199,1976,518,104000,106,260,28.96,71.04,60,11,176,29,90,113,43,0,0,0,20,73,4,0,23,7271
871,848,23,689,159,1994,1089,209300,728,143,83.58,16.42,648,68,44,37,144,0,86,36,0,0,93,241,341,45,8,7272
826,778,48,612,166,1982,937,165100,561,265,67.92,32.08,348,174,452,33,51,14,180,43,8,0,103,437,108,0,0,7273
439,415,24,322,93,1976,1497,223100,435,4,99.09,0.91,49,267,279,0,0,0,12,17,0,0,0,283,142,0,0,7274
457,449,8,294,155,1975,976,233300,383,74,83.81,16.19,33,52,280,22,62,0,12,65,0,0,22,202,95,11,42,7275
607,607,0,489,118,1992,1302,245900,597,10,98.35,1.65,347,80,52,133,25,0,0,45,0,0,0,313,260,19,0,7276
240,240,0,171,69,2003,1337,208300,224,16,93.33,6.67,236,0,15,0,7,0,0,0,0,0,0,47,100,0,7,7277
1466,1356,110,700,656,1998,1318,353000,702,764,47.89,52.11,1106,152,205,0,10,0,139,369,92,15,0,127,260,28,317,7278
987,978,9,393,585,1978,905,422300,480,507,48.63,51.37,174,146,505,93,52,0,392,85,0,0,14,85,122,125,114,7279
715,619,96,506,113,1993,1463,360900,688,27,96.22,3.78,310,86,111,64,80,0,0,17,7,0,0,118,160,125,204,7280
560,560,0,459,101,1976,0,13600,54,506,9.64,90.36,50,114,356,17,23,9,24,0,0,0,423,83,0,0,0,7281
969,821,148,196,625,1989,928,146900,401,568,41.38,58.62,373,63,276,148,70,16,606,27,0,0,54,190,0,0,0,7282
428,412,16,297,115,1967,1115,205200,428,0,100.00,0.00,60,0,184,123,44,12,77,31,0,0,11,237,43,0,0,7283
769,630,139,408,222,1976,761,263800,463,306,60.21,39.79,179,83,107,92,135,0,22,0,0,0,79,104,113,66,52,7284
557,300,257,198,102,1973,522,151700,336,221,60.32,39.68,59,121,82,41,191,23,14,0,0,0,75,130,18,3,36,7285
544,380,164,244,136,1949,728,181600,435,109,79.96,20.04,46,43,62,48,184,3,18,0,1,0,91,74,10,7,42,7286
849,604,245,456,148,1994,617,271800,584,265,68.79,31.21,355,53,31,77,116,0,46,17,0,0,101,94,106,62,40,7287
742,638,104,322,316,1973,961,210200,486,256,65.50,34.50,96,129,198,114,152,0,241,29,61,13,41,235,29,0,0,7288
210,190,20,190,0,1973,0,394100,200,10,95.24,4.76,44,7,78,30,118,0,0,0,0,10,0,73,44,36,98,7289
717,631,86,0,631,1996,1211,0,24,693,3.35,96.65,629,42,11,0,23,0,254,373,53,0,0,0,0,0,0,7290
735,696,39,552,144,1993,695,223600,545,190,74.15,25.85,487,55,88,53,65,25,124,46,15,0,38,257,135,29,19,7291
389,389,0,134,255,1954,774,200000,168,221,43.19,56.81,132,0,13,29,276,34,110,36,0,0,77,121,9,0,38,7292
435,435,0,374,61,1960,1508,350000,435,0,100.00,0.00,69,39,45,154,123,0,0,31,0,0,0,28,158,67,107,7293
1600,1600,0,1418,182,1999,1669,441700,1573,27,98.31,1.69,1235,11,36,0,21,0,0,61,43,15,14,91,386,207,454,7294
292,255,37,0,255,1975,888,0,0,292,0.00,100.00,0,27,116,185,138,106,311,0,0,0,0,0,0,0,0,7295
750,667,83,8,659,1996,1237,0,19,731,2.53,97.47,752,8,0,0,8,32,265,403,13,0,0,5,0,0,0,7296
623,610,13,312,298,1975,822,233600,320,303,51.36,48.64,116,54,308,60,150,12,332,58,0,0,11,156,111,0,8,7297
970,970,0,758,212,1986,1293,300800,915,55,94.33,5.67,316,321,237,14,41,0,29,20,39,0,0,180,547,59,14,7298
1210,1145,65,606,539,1945,803,228000,814,396,67.27,32.73,60,80,166,127,707,60,255,58,10,0,13,341,225,26,60,7299
447,421,26,20,401,1978,917,0,20,427,4.47,95.53,81,107,97,39,13,0,236,13,0,0,0,0,36,0,0,7300
605,560,45,191,369,1968,743,147500,335,270,55.37,44.63,184,50,88,90,133,81,163,0,0,0,124,96,40,0,0,7301
485,463,22,344,119,1964,875,377800,441,44,90.93,9.07,66,34,94,26,260,10,31,36,0,0,13,63,85,22,104,7302
1015,1015,0,778,237,1995,1244,290300,883,132,87.00,13.00,702,135,80,20,13,0,175,53,0,0,15,151,415,70,25,7303
953,953,0,620,333,1994,1356,335200,711,242,74.61,25.39,793,205,27,0,0,0,132,98,43,0,17,88,419,94,14,7304
429,375,54,347,28,1987,0,298800,268,161,62.47,37.53,72,242,37,113,35,47,12,15,0,0,0,53,160,50,116,7305
967,848,119,455,393,1980,692,226600,685,282,70.84,29.16,252,145,49,75,192,18,280,87,0,0,14,169,54,18,0,7306
588,540,48,497,43,1996,1521,361200,588,0,100.00,0.00,435,24,51,13,0,0,0,28,0,0,0,7,263,159,66,7307
791,720,71,194,526,2003,1347,262900,179,612,22.63,77.37,348,17,6,0,0,0,93,110,7,0,0,71,90,0,0,7308
630,587,43,0,587,1995,1133,0,10,620,1.59,98.41,523,87,20,0,0,0,341,258,0,0,0,0,0,0,0,7309
695,695,0,273,422,1978,1096,147300,370,325,53.24,46.76,155,159,301,68,0,0,341,38,18,0,14,211,0,33,0,7310
445,445,0,224,221,1979,1080,259800,230,215,51.69,48.31,40,88,176,42,0,0,109,27,17,0,0,8,88,35,0,7311
278,246,32,102,144,1978,898,173200,171,107,61.51,38.49,35,0,72,77,90,40,74,18,0,0,0,91,28,0,0,7312
685,660,25,618,42,1976,0,309300,685,0,100.00,0.00,31,40,358,98,38,0,0,9,9,0,14,112,343,78,0,7313
415,386,29,351,35,1970,860,347800,378,37,91.08,8.92,75,53,97,47,116,0,19,0,0,0,18,55,90,40,166,7314
1208,1208,0,662,546,1998,1041,305600,853,355,70.61,29.39,1081,30,27,8,43,0,242,135,17,53,0,155,367,61,48,7315
1005,913,92,842,71,1982,1673,371200,983,22,97.81,2.19,202,385,407,0,14,0,25,12,0,0,0,87,275,233,275,7316
1303,1290,13,404,886,1997,1038,377000,470,833,36.07,63.93,1236,439,46,19,33,11,1000,170,0,0,0,0,111,122,205,7317
463,414,49,302,112,1976,762,303200,337,126,72.79,27.21,99,70,93,30,116,30,55,0,0,0,16,79,108,30,41,7318
229,210,19,122,88,1971,838,270400,169,60,73.80,26.20,18,59,43,9,55,0,11,0,0,0,29,70,35,11,10,7319
263,241,22,190,51,1968,604,174000,219,44,83.27,16.73,42,40,66,23,132,19,40,0,0,0,43,105,18,3,31,7320
632,428,204,274,154,1986,478,244400,366,266,57.91,42.09,128,53,115,54,254,42,11,0,0,4,52,132,25,24,36,7321
732,653,79,446,207,1976,694,171400,640,92,87.43,12.57,111,86,246,119,27,0,0,119,0,0,20,366,70,0,0,7322
965,875,90,661,214,1992,886,217500,792,173,82.07,17.93,605,17,113,95,190,0,215,33,0,0,79,406,165,0,39,7323
268,268,0,187,81,1967,536,143000,228,40,85.07,14.93,61,34,84,32,145,33,44,0,0,0,50,110,56,6,0,7324
816,657,159,490,167,1972,600,186800,572,244,70.10,29.90,110,30,118,64,350,34,97,4,0,0,126,210,55,0,37,7325
689,661,28,620,41,1975,1151,401300,595,94,86.36,13.64,241,85,211,46,94,0,41,0,34,0,6,47,243,82,176,7326
615,615,0,586,29,1980,0,418200,500,115,81.30,18.70,310,52,64,79,52,0,46,0,0,0,0,65,161,51,234,7327
389,332,57,227,105,1968,685,174600,274,115,70.44,29.56,103,52,77,61,156,50,70,0,0,0,55,164,16,13,2,7328
456,433,23,385,48,1975,932,259400,292,164,64.04,35.96,142,56,179,47,121,0,31,0,15,0,21,115,195,90,23,7329
552,552,0,409,143,1981,950,315100,450,102,81.52,18.48,224,106,145,84,103,7,87,8,0,0,3,122,247,12,160,7330
284,263,21,206,57,1972,988,194100,238,46,83.80,16.20,44,22,46,23,106,0,30,0,0,0,44,64,68,4,5,7331
965,405,560,299,106,1993,1438,324200,802,163,83.11,16.89,597,191,6,85,442,0,133,0,0,0,15,82,67,55,144,7332
619,513,106,372,141,1964,0,294400,540,79,87.24,12.76,134,88,124,21,150,15,21,0,0,0,0,126,177,54,124,7333
236,200,36,151,49,1955,922,142200,208,28,88.14,11.86,31,11,13,19,126,4,17,8,0,0,24,39,32,13,20,7334
731,345,386,254,91,1964,589,162500,653,78,89.33,10.67,84,73,193,68,408,7,21,69,0,0,58,151,37,10,22,7335
399,344,55,214,130,1958,736,170900,317,82,79.45,20.55,116,22,28,16,244,10,59,0,0,0,68,160,25,39,13,7336
406,361,45,272,89,1974,904,311900,302,104,74.38,25.62,40,86,68,119,125,0,63,49,0,0,22,58,173,14,28,7337
783,724,59,549,175,1971,645,276900,616,167,78.67,21.33,190,20,348,61,227,60,105,17,0,0,47,164,150,84,97,7338
1268,186,1082,140,46,1984,942,480000,1237,31,97.56,2.44,235,148,294,49,288,0,7,23,0,0,0,13,86,29,40,7339
426,295,131,146,149,1973,882,250000,378,48,88.73,11.27,79,105,45,36,255,90,88,49,0,0,10,54,97,14,36,7340
385,385,0,232,153,1971,687,114600,271,114,70.39,29.61,66,61,138,96,101,33,79,0,0,0,123,177,21,0,11,7341
338,338,0,331,7,1992,0,422300,338,0,100.00,0.00,154,47,53,0,0,0,0,0,0,0,0,17,62,71,104,7342
339,339,0,302,37,1996,1375,558900,315,24,92.92,7.08,282,17,10,0,6,0,0,17,6,9,9,49,23,43,159,7343
224,224,0,155,69,1976,563,91400,74,150,33.04,66.96,60,25,111,18,48,54,0,0,0,0,74,117,17,0,0,7344
326,310,16,263,47,1985,709,178000,261,65,80.06,19.94,83,45,64,9,142,9,88,11,0,0,21,112,61,0,12,7345
388,311,77,76,235,1953,580,77600,189,199,48.71,51.29,31,76,71,80,207,73,170,14,0,0,87,29,0,0,0,7346
346,346,0,170,176,1958,612,152800,264,82,76.30,23.70,9,0,83,94,192,11,15,0,0,0,53,119,9,0,0,7347
1076,949,127,706,243,2001,543,257600,796,280,73.98,26.02,432,22,251,75,28,23,0,78,0,21,25,304,171,73,41,7348
779,711,68,306,405,1977,828,226900,328,451,42.11,57.89,262,141,359,85,100,0,500,20,0,0,17,110,183,9,52,7349
1050,1006,44,382,624,1993,2277,272800,630,420,60.00,40.00,394,167,37,223,88,16,42,54,14,470,0,71,118,9,44,7350
1078,932,146,626,306,1985,897,189600,876,202,81.26,18.74,408,211,380,70,65,13,378,123,0,0,0,360,204,0,0,7351
1502,1413,89,799,614,1994,1128,209900,1352,150,90.01,9.99,1083,165,82,149,14,15,274,192,0,0,0,416,425,13,40,7352
1238,1100,138,752,348,1992,1153,160400,1143,95,92.33,7.67,899,82,32,92,45,16,88,284,11,0,36,504,182,6,23,7353
797,761,36,474,287,1981,791,198000,307,490,38.52,61.48,219,24,139,135,198,7,93,114,0,31,168,28,93,57,84,7354
672,625,47,273,352,1979,728,241700,407,265,60.57,39.43,331,209,260,58,114,170,317,32,19,32,0,142,162,69,15,7355
326,241,85,118,123,1962,700,73900,178,148,54.60,45.40,43,57,58,40,205,62,16,9,0,0,71,64,0,0,0,7356
413,393,20,271,122,1966,492,121300,301,112,72.88,27.12,28,11,54,44,192,16,64,0,0,0,132,80,10,3,0,7357
223,213,10,147,66,1953,555,99000,189,34,84.75,15.25,8,33,46,65,177,42,86,0,0,0,74,96,8,0,0,7358
406,339,67,126,213,1939,827,220000,214,192,52.71,47.29,112,0,10,0,385,12,135,56,11,0,8,44,135,0,17,7359
1433,399,1034,335,64,1978,769,375900,1026,407,71.60,28.40,296,67,312,138,363,3,58,19,0,0,5,39,140,58,80,7360
1288,350,938,329,21,1993,0,266300,1103,185,85.64,14.36,300,162,155,180,338,0,53,22,0,0,5,114,78,20,13,7361
1072,920,152,785,135,1980,1483,453900,749,323,69.87,30.13,263,140,163,60,230,0,58,0,0,0,99,145,218,156,180,7362
553,388,165,257,131,1988,956,332500,424,129,76.67,23.33,146,95,35,28,167,10,40,21,0,0,85,50,84,14,111,7363
325,299,26,232,67,1946,679,163300,301,24,92.62,7.38,30,0,38,16,230,10,58,31,0,0,10,155,50,0,0,7364
822,752,70,610,142,1969,1030,184400,755,67,91.85,8.15,255,42,99,20,361,0,74,88,0,0,60,314,118,3,33,7365
368,314,54,223,91,1958,1283,106500,284,84,77.17,22.83,41,69,48,41,132,0,59,10,0,0,81,129,26,0,9,7366
207,162,45,38,124,1979,695,0,100,107,48.31,51.69,114,57,130,54,196,0,379,12,0,0,14,15,45,0,38,7367
975,863,112,357,506,1971,866,206900,542,433,55.59,44.41,422,87,256,144,467,11,356,207,0,0,20,551,18,0,0,7368
155,155,0,131,24,1974,0,645300,131,24,84.52,15.48,22,55,111,36,79,11,32,48,0,0,13,11,75,12,49,7369
468,412,56,256,156,1951,800,132100,401,67,85.68,14.32,36,53,186,15,191,50,77,24,0,0,38,181,15,38,25,7370
465,417,48,215,202,1973,873,151200,381,84,81.94,18.06,77,43,63,20,223,0,137,29,0,0,33,165,14,0,0,7371
501,429,72,206,223,1939,659,160500,342,159,68.26,31.74,0,0,56,46,478,87,244,47,0,0,71,41,18,0,0,7372
475,446,29,369,77,1957,932,198100,467,8,98.32,1.68,21,7,18,47,291,0,32,0,0,12,17,171,111,11,20,7373
386,370,16,294,76,1986,825,114100,254,132,65.80,34.20,118,31,183,31,36,3,96,4,0,0,127,128,15,0,0,7374
340,309,31,215,94,1972,732,116900,240,100,70.59,29.41,58,35,39,12,151,12,79,17,0,0,45,76,32,3,4,7375
561,520,41,218,302,1984,833,130300,279,282,49.73,50.27,288,48,185,42,47,102,201,0,0,9,60,223,5,0,0,7376
631,474,157,205,269,1972,577,96000,353,278,55.94,44.06,79,72,187,0,108,59,68,0,0,0,65,123,15,0,24,7377
404,404,0,234,170,1970,633,0,256,148,63.37,36.63,115,64,55,81,70,56,96,0,0,0,48,109,61,15,0,7378
718,673,45,539,134,1971,0,141600,488,230,67.97,32.03,50,32,113,142,195,15,61,52,0,0,81,314,0,0,9,7379
364,364,0,245,119,1963,726,135700,364,0,100.00,0.00,20,6,35,75,146,0,28,44,0,0,56,154,0,0,0,7380
491,491,0,260,231,1980,703,141300,338,153,68.84,31.16,67,75,188,88,105,69,32,33,0,0,153,182,30,3,11,7381
523,452,71,307,145,1977,619,103100,334,189,63.86,36.14,111,24,209,42,103,49,97,0,0,0,171,91,8,0,16,7382
444,362,82,284,78,1983,944,166000,335,109,75.45,24.55,126,87,99,42,110,22,50,0,0,0,64,155,30,24,14,7383
461,361,100,222,139,1943,773,95900,375,86,81.34,18.66,15,43,73,65,215,47,77,53,0,0,92,124,0,0,0,7384
357,298,59,52,246,1939,643,0,177,180,49.58,50.42,43,42,79,47,302,162,159,12,14,0,14,29,9,0,0,7385
427,404,23,249,155,1983,775,163800,291,136,68.15,31.85,163,73,146,44,75,68,91,0,0,0,76,230,1,0,8,7386
294,294,0,150,144,1948,734,122800,280,14,95.24,4.76,27,9,15,8,163,56,32,0,0,0,98,17,19,0,0,7387
439,364,75,195,169,1952,818,133300,346,93,78.82,21.18,26,0,148,35,281,111,127,32,0,0,76,104,0,0,0,7388
564,448,116,205,243,1961,588,125800,251,313,44.50,55.50,75,9,215,28,359,120,133,10,0,20,125,171,0,0,0,7389
807,785,22,574,211,1980,1002,207700,719,88,89.10,10.90,188,48,232,154,114,10,79,0,0,0,24,240,208,36,44,7390
301,301,0,234,67,1969,1021,273400,248,53,82.39,17.61,31,34,130,22,78,11,43,25,0,0,10,28,80,41,25,7391
221,221,0,180,41,1964,0,0,141,80,63.80,36.20,13,6,0,58,137,0,16,0,0,0,10,35,102,16,9,7392
887,800,87,122,678,1979,884,111300,259,628,29.20,70.80,357,39,411,13,13,96,600,0,0,13,0,111,13,0,0,7393
532,440,92,396,44,1976,475,239700,329,203,61.84,38.16,186,65,139,94,77,0,17,42,0,0,106,127,180,23,66,7394
433,390,43,252,138,1976,936,229200,370,63,85.45,14.55,97,42,25,0,208,25,28,8,0,0,12,199,57,20,13,7395
458,413,45,59,354,1965,807,235000,193,265,42.14,57.86,0,64,161,84,240,34,357,11,0,0,48,77,14,0,8,7396
915,885,30,804,81,1977,1354,194700,809,106,88.42,11.58,274,131,407,50,99,22,63,14,8,0,59,545,154,44,44,7397
575,484,91,414,70,1975,0,203900,373,202,64.87,35.13,99,9,235,68,147,0,58,8,0,0,135,118,98,54,23,7398
915,897,18,611,286,1968,1008,182200,836,79,91.37,8.63,173,20,158,384,226,37,168,130,0,0,0,489,137,0,0,7399
621,567,54,211,356,1981,674,411000,283,338,45.57,54.43,96,129,305,25,86,73,250,25,0,0,0,105,84,0,67,7400
748,701,47,598,103,1975,868,215900,486,262,64.97,35.03,137,136,433,73,149,0,197,0,0,0,166,199,95,89,152,7401
470,450,20,379,71,1976,1039,197400,461,9,98.09,1.91,97,51,218,32,8,0,77,24,0,0,8,267,21,0,9,7402
793,716,77,20,696,1962,573,0,76,717,9.58,90.42,64,109,97,55,335,262,238,63,9,0,0,20,0,0,0,7403
738,678,60,544,134,1976,1024,271400,514,224,69.65,30.35,195,60,156,47,96,12,69,0,0,0,99,94,161,58,43,7404
936,928,8,724,204,1975,921,229100,907,29,96.90,3.10,203,92,338,276,144,0,132,16,0,0,0,424,307,71,25,7405
292,281,11,218,63,1973,0,245100,198,94,67.81,32.19,137,0,78,18,42,8,26,15,0,0,0,48,68,37,53,7406
654,654,0,571,83,1976,1205,349600,609,45,93.12,6.88,217,54,189,66,31,29,29,10,43,0,23,69,136,69,120,7407
601,560,41,487,73,1988,0,330500,405,196,67.39,32.61,356,93,170,17,110,18,53,0,9,0,111,103,181,66,168,7408
369,355,14,308,47,1955,0,295200,302,67,81.84,18.16,79,97,84,38,113,0,12,10,0,0,9,154,73,12,71,7409
705,663,42,141,522,1975,769,147400,243,462,34.47,65.53,309,154,208,113,143,60,367,12,10,123,18,231,0,0,0,7410
309,282,27,97,185,1939,721,215800,198,111,64.08,35.92,80,19,12,35,151,0,92,39,0,0,12,36,14,0,0,7411
740,663,77,549,114,1946,846,154500,684,56,92.43,7.57,0,12,96,85,620,63,100,95,0,0,14,530,0,11,0,7412
1160,1009,151,325,684,1998,1087,145100,517,643,44.57,55.43,899,102,277,120,72,63,397,31,67,62,253,245,65,0,15,7413
380,380,0,176,204,1972,760,180600,283,97,74.47,25.53,0,23,90,112,44,10,80,0,0,0,36,112,5,0,0,7414
312,305,7,242,63,1939,891,208700,289,23,92.63,7.37,79,9,76,51,190,22,69,37,0,0,0,177,61,0,12,7415
557,557,0,499,58,1977,0,218200,557,0,100.00,0.00,35,25,191,225,13,0,40,14,14,0,13,230,178,0,0,7416
563,555,8,457,98,1969,885,216800,463,100,82.24,17.76,104,38,152,109,151,0,36,46,0,0,10,239,98,50,36,7417
923,923,0,699,224,1981,948,199000,740,183,80.17,19.83,355,122,267,26,115,0,162,17,0,0,65,297,261,20,39,7418
304,233,71,211,22,1962,0,265000,264,40,86.84,13.16,36,28,59,14,225,0,0,11,0,0,0,155,77,42,28,7419
1102,1023,79,626,397,1991,816,132000,670,432,60.80,39.20,668,60,178,106,231,36,160,26,0,0,166,588,38,0,0,7420
1581,1337,244,672,665,1977,787,225300,819,762,51.80,48.20,633,122,230,217,73,100,278,23,23,81,0,321,392,0,0,7421
392,332,60,107,225,1973,744,150400,267,125,68.11,31.89,0,0,34,60,251,63,90,0,0,0,48,107,0,0,0,7422
470,408,62,260,148,1975,888,136800,387,83,82.34,17.66,182,31,109,28,210,0,97,65,0,0,36,164,46,3,43,7423
629,598,31,514,84,1986,648,486500,504,125,80.13,19.87,242,59,162,74,52,0,9,0,35,25,21,96,148,58,172,7424
600,600,0,498,102,2000,1226,195600,561,39,93.50,6.50,247,43,195,67,74,9,41,59,0,0,43,335,88,0,13,7425
357,324,33,224,100,1992,577,192100,274,83,76.75,23.25,107,47,131,20,74,12,114,7,0,0,65,16,57,0,19,7426
89,89,0,73,16,1992,0,328400,74,15,83.15,16.85,60,92,35,0,16,59,0,0,0,0,39,55,26,15,9,7427
428,402,26,350,52,1985,775,327300,372,56,86.92,13.08,134,15,168,18,141,0,42,12,12,0,9,114,193,47,37,7428
658,599,59,343,256,1972,750,199700,463,195,70.36,29.64,245,157,92,39,119,20,257,50,0,27,18,204,63,0,0,7429
1329,1216,113,1041,175,1991,0,216400,1163,166,87.51,12.49,736,100,158,249,139,37,0,66,0,0,129,849,225,11,12,7430
705,638,67,414,224,1976,820,126600,529,176,75.04,24.96,355,0,233,21,86,0,136,54,0,0,142,276,38,0,0,7431
379,379,0,141,238,1975,736,171300,195,184,51.45,48.55,122,0,129,23,10,111,103,0,0,0,37,17,16,0,0,7432
369,331,38,256,75,1942,783,212900,345,24,93.50,6.50,52,0,116,43,215,0,113,37,0,0,9,115,60,31,14,7433
521,478,43,435,43,1993,1065,182100,438,83,84.07,15.93,321,24,103,8,134,0,31,0,0,0,66,412,26,0,0,7434
599,599,0,342,257,1973,729,234700,405,194,67.61,32.39,94,111,103,192,265,0,142,26,13,0,0,378,89,11,19,7435
530,530,0,462,68,1982,0,331800,455,75,85.85,14.15,217,108,50,62,81,0,13,0,0,0,12,41,84,154,190,7436
537,516,21,499,17,1991,0,25600,59,478,10.99,89.01,384,140,146,11,0,0,29,0,0,0,587,0,0,0,0,7437
386,386,0,329,57,1978,739,139000,242,144,62.69,37.31,93,137,110,23,47,0,71,67,13,11,42,165,11,0,9,7438
1008,981,27,446,535,1974,863,299200,592,416,58.73,41.27,266,201,213,137,280,13,415,59,0,0,0,159,250,89,58,7439
445,402,43,158,244,1947,822,136000,349,96,78.43,21.57,0,15,15,60,255,95,59,0,0,0,0,166,0,0,0,7440
859,851,8,699,152,1991,768,192300,499,360,58.09,41.91,194,83,117,51,186,11,50,14,5,0,126,176,133,13,47,7441
537,499,38,435,64,1983,1289,278800,529,8,98.51,1.49,212,93,156,25,73,32,0,40,12,0,0,111,238,22,60,7442
563,391,172,314,77,1972,757,370400,488,75,86.68,13.32,150,69,84,35,232,3,75,37,0,0,19,92,68,51,118,7443
261,246,15,152,94,1974,938,206900,186,75,71.26,28.74,44,44,117,6,88,7,14,22,0,0,8,121,54,0,0,7444
726,658,68,491,167,1973,827,123400,518,208,71.35,28.65,109,55,247,121,104,22,179,16,0,0,165,234,10,10,0,7445
719,706,13,293,413,1975,1110,188500,609,110,84.70,15.30,108,19,416,168,47,0,38,126,0,0,0,454,25,0,15,7446
349,349,0,307,42,1982,1068,309800,258,91,73.93,26.07,85,81,48,98,54,0,19,68,0,0,0,92,134,12,27,7447
463,406,57,325,81,1967,789,274100,415,48,89.63,10.37,29,29,87,203,0,10,26,43,0,0,0,112,157,0,0,7448
754,643,111,178,465,1958,1010,460800,481,273,63.79,36.21,61,10,174,124,312,51,268,58,12,0,0,45,47,97,59,7449
573,573,0,319,254,1974,913,173200,464,109,80.98,19.02,97,49,265,160,54,40,175,65,0,0,0,265,80,0,0,7450
1063,942,121,608,334,1978,895,284200,624,439,58.70,41.30,318,169,380,42,76,0,231,35,0,24,63,169,221,113,87,7451
502,437,65,251,186,1982,1120,173800,337,165,67.13,32.87,110,80,50,60,198,31,65,36,38,9,10,173,35,0,39,7452
555,555,0,358,197,1994,994,157000,407,148,73.33,26.67,202,83,221,9,0,0,93,106,0,0,15,276,10,0,0,7453
827,827,0,744,83,1981,1069,270500,736,91,89.00,11.00,313,51,275,50,142,0,56,50,43,0,10,120,403,44,65,7454
772,772,0,647,125,1977,1659,281400,742,30,96.11,3.89,320,77,184,108,72,0,61,12,0,0,13,51,428,59,110,7455
744,744,0,663,81,1983,1660,0,323,421,43.41,56.59,151,181,171,87,18,0,0,36,10,0,333,106,79,12,23,7456
1009,980,29,875,105,1996,2226,425100,1009,0,100.00,0.00,528,0,32,118,153,0,0,58,0,0,0,0,286,275,212,7457
584,584,0,205,379,1973,1401,199800,319,265,54.62,45.38,82,61,419,69,25,52,124,33,39,76,0,242,79,0,11,7458
411,350,61,222,128,1959,606,226900,349,62,84.91,15.09,38,21,77,51,192,12,32,11,0,0,19,119,52,11,27,7459
440,421,19,147,274,1950,1242,325400,251,189,57.05,42.95,21,114,44,150,139,0,332,45,0,0,0,18,28,20,25,7460
926,875,51,396,479,1972,721,153800,624,302,67.39,32.61,52,84,275,353,204,35,304,26,0,0,45,373,36,7,31,7461
784,543,241,351,192,1991,1000,264400,556,228,70.92,29.08,286,119,76,215,147,0,34,13,0,0,47,129,113,43,73,7462
450,375,75,257,118,1967,740,282900,273,177,60.67,39.33,56,28,103,90,204,0,129,0,0,0,0,63,227,25,0,7463
1090,817,273,565,252,1988,819,125200,374,716,34.31,65.69,387,208,529,37,13,26,84,74,16,31,70,473,170,0,27,7464
447,447,0,240,207,1971,1267,245600,424,23,94.85,5.15,93,26,182,25,95,0,14,132,0,0,0,135,129,11,0,7465
466,466,0,214,252,1977,894,201600,290,176,62.23,37.77,95,65,270,11,10,72,90,0,11,0,0,154,48,0,0,7466
318,298,20,226,72,1969,537,132700,109,209,34.28,65.72,111,10,67,90,94,0,69,50,0,0,65,68,99,0,0,7467
1264,1179,85,677,502,1989,847,177800,924,340,73.10,26.90,514,125,176,147,266,10,360,196,0,0,15,349,224,0,15,7468
960,849,111,639,210,1984,892,238100,920,40,95.83,4.17,365,22,208,32,254,15,128,61,0,0,35,262,182,120,43,7469
522,447,75,266,181,1974,1335,372900,313,209,59.96,40.04,117,137,197,135,51,7,81,239,0,37,0,11,91,26,68,7470
899,842,57,782,60,1979,3333,643100,899,0,100.00,0.00,171,185,275,179,127,0,0,0,0,0,0,12,60,75,676,7471
380,351,29,244,107,1972,1098,702100,333,47,87.63,12.37,83,35,100,99,89,0,0,0,11,16,0,46,18,33,228,7472
1213,1178,35,815,363,1997,1074,275200,886,327,73.04,26.96,727,61,80,17,3,0,55,37,12,0,64,42,507,58,93,7473
1050,899,151,223,676,1963,1573,214200,314,736,29.90,70.10,127,106,206,274,499,16,183,141,201,167,0,113,61,0,69,7474
945,804,141,612,192,1976,949,158600,635,310,67.20,32.80,238,128,137,140,378,44,153,0,0,0,111,383,97,4,56,7475
355,323,32,277,46,1975,0,303200,311,44,87.61,12.39,49,46,144,19,109,31,11,23,0,0,10,59,107,51,37,7476
535,535,0,278,257,1976,941,150600,463,72,86.54,13.46,208,62,212,0,112,10,217,17,0,0,97,192,11,0,0,7477
269,269,0,174,95,1960,1215,248300,260,9,96.65,3.35,0,6,9,92,173,0,45,9,0,0,0,128,31,8,0,7478
498,479,19,285,194,1961,1097,211800,466,32,93.57,6.43,98,17,52,80,349,0,172,60,0,0,0,253,59,11,0,7479
674,629,45,374,255,1992,909,145200,332,342,49.26,50.74,296,106,122,81,100,0,320,23,12,0,151,143,35,7,14,7480
356,325,31,225,100,1977,841,151800,265,91,74.44,25.56,48,94,74,6,220,26,102,0,0,0,48,124,70,0,0,7481
213,213,0,170,43,1976,741,353000,134,79,62.91,37.09,97,80,93,44,43,0,0,11,0,0,14,86,116,34,46,7482
773,741,32,259,482,1997,1031,169400,615,158,79.56,20.44,350,119,186,0,0,21,101,62,0,0,12,428,0,0,0,7483
541,519,22,113,406,1972,678,200600,205,336,37.89,62.11,35,10,201,155,258,215,332,0,0,0,9,52,27,0,0,7484
494,431,63,216,215,1968,1208,183600,264,230,53.44,46.56,172,8,59,211,136,48,7,29,135,14,10,211,86,16,0,7485
1268,1246,22,1071,175,1983,912,270200,1046,222,82.49,17.51,337,47,351,92,100,36,58,12,3,0,15,297,245,96,121,7486
549,498,51,390,108,1979,768,316700,348,201,63.39,36.61,138,138,53,47,60,0,0,4,0,0,39,120,87,45,124,7487
489,433,56,297,136,1968,575,107100,241,248,49.28,50.72,28,0,195,83,212,75,76,6,0,0,182,115,24,0,0,7488
1042,1030,12,734,296,1993,1036,298500,933,109,89.54,10.46,530,134,259,39,74,29,140,117,15,0,35,246,261,81,90,7489
999,923,76,810,113,1989,758,399400,925,74,92.59,7.41,409,156,119,90,94,0,99,20,0,10,21,131,250,140,197,7490
866,844,22,572,272,1972,1040,198700,663,203,76.56,23.44,62,40,77,180,372,0,27,49,0,0,73,178,164,63,100,7491
422,393,29,297,96,1971,758,243800,294,128,69.67,30.33,87,81,164,38,178,0,57,0,0,48,36,126,151,67,47,7492
1122,1122,0,390,732,1973,675,168800,444,678,39.57,60.43,125,18,547,190,201,14,444,104,26,0,19,197,40,9,0,7493
742,695,47,476,219,1982,739,155300,552,190,74.39,25.61,398,77,127,94,71,62,93,13,0,0,112,379,60,7,0,7494
400,400,0,60,340,1962,697,189100,161,239,40.25,59.75,76,18,28,31,339,0,218,61,0,0,0,102,73,0,0,7495
435,383,52,199,184,1943,491,159600,283,152,65.06,34.94,17,14,45,19,249,55,41,31,0,0,9,105,64,0,0,7496
765,765,0,549,216,1973,767,201100,584,181,76.34,23.66,163,17,219,263,171,0,177,0,0,0,13,362,190,7,45,7497
659,659,0,476,183,1975,866,196600,456,203,69.20,30.80,206,77,191,48,173,13,44,0,0,0,104,174,174,40,29,7498
687,680,7,573,107,1954,1071,198100,687,0,100.00,0.00,117,8,54,58,291,0,105,50,0,0,8,241,87,0,11,7499
483,483,0,426,57,1977,1148,420000,445,38,92.13,7.87,144,66,29,103,105,0,8,14,0,0,0,108,110,73,123,7500
643,607,36,83,524,1971,908,342500,253,390,39.35,60.65,168,23,110,125,217,11,327,50,0,0,26,0,50,33,51,7501
305,305,0,246,59,1970,1218,238300,283,22,92.79,7.21,13,8,110,99,114,21,9,53,0,0,20,150,78,13,0,7502
590,574,16,444,130,1975,946,258800,365,225,61.86,38.14,78,101,66,224,83,0,93,0,0,0,62,80,253,15,19,7503
515,494,21,414,80,1978,990,250000,393,122,76.31,23.69,102,31,93,32,205,3,30,4,0,0,55,139,106,63,43,7504
350,350,0,39,311,1955,494,0,149,201,42.57,57.43,58,77,43,79,95,151,110,0,0,0,0,88,0,0,3,7505
790,749,41,290,459,1954,677,160000,454,336,57.47,42.53,0,18,59,69,632,164,184,29,0,0,30,317,0,0,0,7506
450,424,26,200,224,1968,754,153400,309,141,68.67,31.33,25,220,190,76,108,73,284,8,0,0,11,210,14,0,0,7507
497,454,43,425,29,1978,0,158300,450,47,90.54,9.46,12,163,279,20,33,0,52,83,0,0,0,282,52,0,0,7508
692,664,28,259,405,1987,684,169800,289,403,41.76,58.24,377,93,140,36,51,0,346,54,0,0,76,172,0,0,0,7509
462,462,0,334,128,1948,786,133800,362,100,78.35,21.65,46,0,53,76,268,64,178,9,0,0,67,125,0,0,0,7510
786,697,89,342,355,1972,757,105400,369,417,46.95,53.05,202,126,88,64,185,0,342,22,0,0,139,122,29,0,11,7511
654,583,71,262,321,1966,0,241500,523,131,79.97,20.03,176,0,148,15,232,60,110,37,0,0,16,98,116,50,39,7512
486,459,27,435,24,1980,0,24600,118,368,24.28,75.72,47,112,231,39,4,0,34,0,0,0,320,0,12,0,19,7513
299,258,41,258,0,1979,0,612000,258,41,86.29,13.71,15,14,93,82,75,35,0,0,0,0,11,12,48,56,85,7514
723,671,52,457,214,1994,635,0,311,412,43.02,56.98,564,101,13,0,35,73,122,31,18,44,202,125,14,0,13,7515
403,403,0,336,67,1971,0,331500,322,81,79.90,20.10,85,12,240,20,88,0,32,0,0,0,28,87,93,44,107,7516
810,778,32,264,514,1964,944,179800,432,378,53.33,46.67,114,33,131,159,159,38,281,43,0,0,0,119,35,0,0,7517
379,350,29,196,154,1953,1340,180000,371,8,97.89,2.11,97,0,33,0,297,11,11,19,39,0,0,158,84,0,0,7518
595,595,0,363,232,1939,938,481500,400,195,67.23,32.77,38,11,9,0,557,0,147,0,0,0,0,19,60,158,184,7519
422,416,6,408,8,1939,0,557800,422,0,100.00,0.00,0,0,9,0,396,0,0,0,0,0,0,11,92,146,145,7520
409,409,0,344,65,1939,1185,487900,401,8,98.04,1.96,0,0,0,0,409,0,0,13,47,0,0,12,67,134,136,7521
525,506,19,458,48,1939,2275,561000,486,39,92.57,7.43,10,0,0,14,456,21,0,10,0,27,23,21,123,90,165,7522
1159,1083,76,612,471,1973,1142,249500,864,295,74.55,25.45,200,104,411,133,412,42,225,135,54,16,129,273,297,38,14,7523
350,350,0,265,85,1975,631,227500,332,18,94.86,5.14,76,0,12,12,263,80,18,63,0,0,0,54,92,0,0,7524
311,284,27,212,72,1939,640,244600,246,65,79.10,20.90,9,0,0,27,230,21,73,22,0,0,0,73,44,0,0,7525
282,282,0,228,54,1966,1308,327100,248,34,87.94,12.06,81,29,23,25,127,11,35,0,11,0,28,44,52,96,8,7526
569,512,57,454,58,1975,0,391600,502,67,88.22,11.78,177,42,254,13,116,14,78,0,0,0,29,16,150,118,185,7527
433,433,0,274,159,1972,1052,363800,373,60,86.14,13.86,58,37,94,92,183,0,18,67,0,0,13,30,98,23,117,7528
312,293,19,253,40,1972,0,203100,288,24,92.31,7.69,10,9,162,168,30,21,50,35,10,0,9,108,125,0,0,7529
437,384,53,240,144,1971,726,289700,340,97,77.80,22.20,0,27,77,64,245,14,57,0,0,0,38,43,122,6,83,7530
732,676,56,659,17,1994,0,304500,732,0,100.00,0.00,451,44,210,18,0,0,0,0,19,0,13,176,350,63,81,7531
577,577,0,442,135,1989,1797,590300,568,9,98.44,1.56,181,90,59,58,182,0,14,0,28,0,0,17,69,58,384,7532
338,338,0,321,17,1977,0,850200,338,0,100.00,0.00,169,35,168,15,39,0,0,32,0,0,17,11,28,57,281,7533
928,886,42,793,93,1975,1140,358400,898,30,96.77,3.23,231,122,243,194,132,0,26,13,0,9,10,78,279,209,264,7534
1417,1353,64,1278,75,1997,1888,284900,1237,180,87.30,12.70,669,51,310,37,74,0,14,0,0,0,187,99,377,300,135,7535
948,932,16,835,97,1978,0,369300,792,156,83.54,16.46,241,66,235,54,291,0,29,0,0,0,16,163,230,181,260,7536
816,760,56,703,57,1975,871,419500,735,81,90.07,9.93,203,161,320,108,130,0,40,66,0,0,0,97,253,222,222,7537
535,528,7,442,86,1980,1083,401800,481,54,89.91,10.09,216,17,177,88,94,0,21,0,0,0,25,34,102,37,276,7538
857,763,94,507,256,1987,802,141200,696,161,81.21,18.79,229,35,134,58,270,25,99,63,0,0,80,223,32,36,85,7539
1065,1037,28,696,341,1968,1010,236200,865,200,81.22,18.78,114,51,126,338,361,8,120,123,9,0,7,294,393,0,26,7540
559,518,41,173,345,1978,898,181800,358,201,64.04,35.96,27,34,39,50,162,15,115,0,0,0,26,108,6,0,0,7541
427,427,0,173,254,1982,1028,174700,208,219,48.71,51.29,169,110,65,80,260,39,398,29,0,0,0,39,84,0,0,7542
828,746,82,172,574,1983,878,221800,306,522,36.96,63.04,304,224,153,127,143,45,419,47,19,0,40,99,130,0,0,7543
413,383,30,323,60,1980,1510,349100,370,43,89.59,10.41,107,98,66,26,47,0,67,0,15,0,77,15,64,0,89,7544
653,602,51,584,18,1979,0,453300,653,0,100.00,0.00,162,166,128,116,92,0,0,35,0,0,19,61,170,116,238,7545
453,453,0,284,169,1969,1221,581100,303,150,66.89,33.11,104,29,42,85,132,0,68,0,0,39,0,0,89,0,154,7546
599,498,101,276,222,1990,1190,345400,377,222,62.94,37.06,504,107,28,54,116,79,66,27,63,0,25,93,241,122,45,7547
588,537,51,467,70,1959,0,341700,497,91,84.52,15.48,84,82,125,37,185,0,12,36,0,0,10,143,94,58,111,7548
458,388,70,133,255,1983,1185,329000,141,317,30.79,69.21,159,68,71,56,162,33,80,71,0,0,38,83,99,0,0,7549
207,149,58,72,77,1952,1483,290600,207,0,100.00,0.00,0,0,19,50,150,0,34,40,0,0,0,62,31,10,0,7550
353,268,85,128,140,1972,498,49600,107,246,30.31,69.69,68,48,93,56,87,47,52,0,0,0,58,85,19,0,0,7551
511,484,27,391,93,1958,653,109500,468,43,91.59,8.41,52,2,208,123,315,15,144,0,0,0,158,253,47,0,2,7552
1292,690,602,499,191,1980,861,243500,889,403,68.81,31.19,368,200,195,88,253,88,35,0,0,0,0,201,260,17,129,7553
1214,841,373,745,96,1995,729,154000,874,340,71.99,28.01,518,169,235,28,69,28,27,0,0,0,75,381,185,15,46,7554
306,306,0,170,136,1988,663,239300,202,104,66.01,33.99,106,83,73,88,20,31,17,6,0,0,64,14,64,31,82,7555
722,596,126,438,158,1980,892,169300,412,310,57.06,42.94,142,106,230,105,158,0,83,43,0,0,11,190,184,37,8,7556
1153,837,316,678,159,2001,1266,279800,1045,108,90.63,9.37,499,94,171,84,216,4,57,53,25,0,47,264,230,37,179,7557
579,562,17,514,48,1975,1543,426600,561,18,96.89,3.11,26,42,460,91,44,0,0,34,4,0,5,66,256,133,102,7558
1127,1110,17,730,380,1984,1265,430100,926,201,82.17,17.83,420,394,235,73,248,0,135,94,13,0,32,160,284,138,318,7559
471,397,74,344,53,1977,0,222700,370,101,78.56,21.44,146,85,70,33,78,32,13,0,0,0,60,152,38,23,12,7560
433,417,16,334,83,1991,843,301300,375,58,86.61,13.39,113,89,66,46,24,0,35,8,0,0,0,117,0,83,80,7561
630,620,10,579,41,1981,917,316200,417,213,66.19,33.81,228,128,148,43,142,0,95,0,0,0,36,110,197,104,61,7562
453,425,28,356,69,1968,1385,467400,377,76,83.22,16.78,131,66,69,133,104,0,0,50,0,0,0,7,66,48,234,7563
327,327,0,224,103,1959,875,183800,249,78,76.15,23.85,96,0,125,12,76,0,53,12,0,0,14,171,21,0,0,7564
577,568,9,524,44,1974,1625,333600,510,67,88.39,11.61,188,100,79,24,146,2,16,0,0,0,19,74,164,111,82,7565
432,397,35,302,95,1964,950,231800,349,83,80.79,19.21,33,17,38,117,224,0,89,0,0,0,9,171,90,0,0,7566
781,755,26,653,102,1976,1051,271900,599,182,76.70,23.30,215,191,383,19,50,46,0,0,0,19,193,72,248,50,174,7567
389,389,0,352,37,1981,0,360500,326,63,83.80,16.20,69,60,118,28,77,0,24,0,0,0,12,24,78,79,130,7568
493,447,46,341,106,1983,1375,327200,355,138,72.01,27.99,98,99,144,42,116,9,65,0,27,0,43,68,112,7,145,7569
590,528,62,468,60,1977,2615,333500,485,105,82.20,17.80,145,89,133,62,46,0,15,0,0,0,24,72,88,114,135,7570
469,469,0,247,222,1993,1929,327600,329,140,70.15,29.85,144,95,75,49,11,15,121,0,0,0,0,31,49,51,84,7571
386,386,0,62,324,1945,951,0,116,270,30.05,69.95,16,14,28,69,363,15,338,13,0,0,0,46,47,31,0,7572
284,273,11,93,180,1939,1019,272100,138,146,48.59,51.41,154,64,0,10,90,50,91,58,0,0,0,12,34,39,0,7573
450,450,0,302,148,1939,1482,557000,356,94,79.11,20.89,0,0,0,0,401,0,47,24,16,10,0,14,43,98,149,7574
219,219,0,192,27,1939,2281,577500,210,9,95.89,4.11,0,0,0,0,247,0,0,0,0,27,0,0,11,55,154,7575
327,327,0,271,56,1939,1868,592400,327,0,100.00,0.00,11,0,11,0,288,0,11,0,0,0,0,0,0,103,180,7576
785,734,51,138,596,1952,964,464700,140,645,17.83,82.17,81,26,150,113,547,15,494,90,0,0,27,65,112,14,42,7577
1011,954,57,172,782,1969,854,276900,205,806,20.28,79.72,6,16,254,255,531,28,689,112,0,2,0,61,140,0,0,7578
734,684,50,207,477,1942,866,309000,245,489,33.38,66.62,73,60,34,86,470,46,278,66,0,0,0,48,210,15,16,7579
596,583,13,50,533,1953,945,270600,70,526,11.74,88.26,0,0,100,87,500,17,516,85,0,0,0,28,19,0,22,7580
620,590,30,335,255,1941,1019,460800,300,320,48.39,51.61,11,0,84,42,504,0,133,114,10,0,0,0,111,111,122,7581
560,504,56,252,252,1939,1020,372900,317,243,56.61,43.39,11,0,8,19,431,0,197,77,8,8,0,13,134,23,9,7582
410,410,0,240,170,1939,1204,450900,306,104,74.63,25.37,9,0,26,12,434,0,87,183,28,9,0,0,71,44,34,7583
607,590,17,490,100,1939,1042,448200,540,67,88.96,11.04,33,0,0,9,510,0,54,0,0,0,9,39,133,213,104,7584
346,346,0,295,51,1943,0,446400,295,51,85.26,14.74,34,39,0,47,235,0,0,60,0,0,0,12,107,104,21,7585
742,655,87,305,350,1956,802,247400,408,334,54.99,45.01,28,17,95,88,347,77,177,31,0,0,0,90,90,25,9,7586
591,591,0,336,255,1954,978,279200,380,211,64.30,35.70,25,10,43,48,362,0,206,65,0,0,23,61,122,0,0,7587
522,491,31,353,138,1939,892,276100,432,90,82.76,17.24,26,0,12,69,392,39,104,42,13,0,0,159,103,21,18,7588
916,852,64,305,547,1986,833,255100,305,611,33.30,66.70,126,376,123,18,83,0,338,44,0,0,8,43,236,42,15,7589
730,681,49,200,481,1974,868,189800,267,463,36.58,63.42,52,41,49,149,283,0,201,45,34,0,11,95,54,12,0,7590
1089,1001,88,520,481,1972,885,184200,743,346,68.23,31.77,40,15,147,128,277,15,154,30,0,0,14,299,28,0,0,7591
408,352,56,214,138,1975,963,214200,251,157,61.52,38.48,171,0,48,169,132,15,201,59,0,0,0,120,51,10,0,7592
538,509,29,58,451,2000,835,162500,144,394,26.77,73.23,310,44,52,48,85,22,356,48,0,0,0,42,20,0,10,7593
644,644,0,563,81,1978,886,220100,581,63,90.22,9.78,116,191,146,124,17,0,34,43,0,0,9,231,216,46,0,7594
722,691,31,545,146,1977,936,111700,432,290,59.83,40.17,32,235,416,54,11,11,119,28,0,0,169,252,57,0,0,7595
603,603,0,209,394,1977,1008,203200,275,328,45.61,54.39,47,204,278,29,0,0,267,127,24,13,0,86,25,0,0,7596
1044,900,144,521,379,1980,1284,331000,630,414,60.34,39.66,322,145,129,21,217,0,165,124,14,0,0,124,130,74,149,7597
285,188,97,82,106,1939,579,86900,183,102,64.21,35.79,0,0,0,46,201,0,174,0,0,0,5,60,8,0,0,7598
435,410,25,119,291,1946,589,122600,272,163,62.53,37.47,17,9,12,0,295,67,79,9,0,0,3,80,0,0,0,7599
582,510,72,302,208,1975,663,169600,390,192,67.01,32.99,94,74,135,97,213,19,37,25,0,0,115,86,25,85,40,7600
354,317,37,237,80,1978,516,172500,204,150,57.63,42.37,102,8,101,2,101,26,17,15,0,0,63,67,27,26,40,7601
1004,973,31,304,669,1974,948,338700,389,615,38.75,61.25,91,182,246,206,227,55,436,31,23,0,0,50,150,126,32,7602
446,428,18,217,211,1970,670,224300,257,189,57.62,42.38,23,11,19,130,233,48,66,25,0,0,60,91,100,0,0,7603
504,455,49,261,194,1947,767,270400,404,100,80.16,19.84,42,14,22,98,276,28,56,59,0,0,0,134,122,53,0,7604
554,549,5,363,186,1992,440,123300,310,244,55.96,44.04,162,53,116,32,87,12,76,0,0,0,130,179,2,0,0,7605
1181,1091,90,692,399,1993,922,267800,939,242,79.51,20.49,489,163,226,57,18,35,130,123,39,0,111,116,304,22,0,7606
575,516,59,377,139,1955,753,209500,458,117,79.65,20.35,45,9,66,78,474,0,88,58,38,0,70,183,103,17,0,7607
469,447,22,356,91,1945,1168,162400,367,102,78.25,21.75,52,54,17,10,325,44,12,67,0,0,21,191,37,0,0,7608
1232,1141,91,721,420,1950,929,197500,898,334,72.89,27.11,191,31,78,103,715,0,106,253,18,21,28,429,155,43,0,7609
406,406,0,225,181,1948,993,279600,277,129,68.23,31.77,147,13,21,42,312,34,87,64,53,10,18,117,91,0,0,7610
253,243,10,190,53,1939,1177,306900,231,22,91.30,8.70,32,0,11,0,326,0,29,23,0,10,8,53,127,22,0,7611
719,691,28,188,503,1979,1299,326000,270,449,37.55,62.45,113,0,0,8,302,0,111,66,35,0,10,49,95,11,0,7612
424,366,58,75,291,1942,1049,280900,158,266,37.26,62.74,0,0,32,35,179,0,70,51,0,0,0,36,55,12,0,7613
507,507,0,365,142,1942,1156,266800,409,98,80.67,19.33,0,57,45,16,347,0,76,40,0,7,0,74,127,36,0,7614
745,633,112,339,294,1939,1111,277500,541,204,72.62,27.38,24,0,18,28,592,0,209,58,0,0,0,112,208,39,0,7615
413,413,0,213,200,1939,952,256400,368,45,89.10,10.90,56,57,76,32,403,143,78,88,0,0,0,180,121,14,0,7616
368,347,21,243,104,1941,1143,314800,298,70,80.98,19.02,41,0,9,10,276,0,13,75,0,0,14,88,91,21,10,7617
372,372,0,275,97,1949,976,241700,299,73,80.38,19.62,40,0,13,33,187,0,49,60,0,0,0,126,26,0,0,7618
1453,1253,200,578,675,1966,801,195100,782,671,53.82,46.18,295,196,209,69,645,17,477,97,0,0,12,578,76,11,0,7619
536,503,33,317,186,1960,932,243600,351,185,65.49,34.51,106,0,90,18,262,0,97,93,17,13,0,234,22,0,0,7620
774,711,63,431,280,1951,908,193400,579,195,74.81,25.19,143,0,87,50,317,11,101,26,14,0,12,249,137,10,0,7621
987,859,128,37,822,1939,880,0,76,911,7.70,92.30,13,0,0,12,817,95,475,76,44,0,0,18,0,0,0,7622
1034,879,155,178,701,1963,710,550800,110,924,10.64,89.36,184,0,146,0,619,201,444,94,0,0,0,0,45,0,75,7623
2223,1891,332,563,1328,2001,1663,324000,55,2168,2.47,97.53,553,12,31,0,857,17,242,187,117,141,0,131,138,72,161,7624
345,324,21,0,324,1940,586,0,0,345,0.00,100.00,92,6,0,42,190,122,208,0,0,0,0,0,0,0,0,7625
499,499,0,245,254,1952,1338,733900,212,287,42.48,57.52,30,0,38,89,282,0,101,80,13,0,0,0,0,12,163,7626
447,425,22,209,216,1956,1054,456600,233,214,52.13,47.87,66,30,126,65,172,10,161,34,32,0,0,73,22,22,60,7627
461,446,15,290,156,1962,1121,404700,291,170,63.12,36.88,112,17,70,72,219,0,72,44,14,26,11,81,70,92,28,7628
581,528,53,506,22,1958,2818,487300,581,0,100.00,0.00,31,30,66,107,322,0,8,0,16,0,0,33,122,50,303,7629
526,526,0,349,177,1971,1496,345600,526,0,100.00,0.00,86,68,58,15,272,0,57,17,21,0,0,55,154,105,73,7630
436,436,0,365,71,1942,1042,256900,416,20,95.41,4.59,16,5,11,5,391,0,30,34,0,0,0,149,163,30,6,7631
417,417,0,387,30,1983,0,279700,264,153,63.31,36.69,59,30,76,94,45,42,0,44,0,0,11,27,90,58,22,7632
500,424,76,393,31,1967,0,850200,500,0,100.00,0.00,122,69,8,13,287,0,0,42,0,45,0,10,48,26,265,7633
666,586,80,539,47,1968,1264,603200,641,25,96.25,3.75,69,44,127,130,266,0,11,28,17,0,0,8,73,127,362,7634
404,344,60,344,0,1992,0,672900,404,0,100.00,0.00,144,24,15,12,92,6,0,0,0,13,0,0,30,27,211,7635
878,878,0,694,184,1991,1575,254400,878,0,100.00,0.00,255,21,357,56,70,0,74,48,0,0,0,233,354,12,38,7636
478,478,0,370,108,1956,977,189600,454,24,94.98,5.02,93,0,92,33,348,0,61,48,0,0,10,255,108,0,0,7637
480,419,61,224,195,1961,734,395900,222,258,46.25,53.75,96,0,17,16,376,0,130,89,0,0,0,14,184,30,58,7638
420,420,0,345,75,1939,1279,410600,407,13,96.90,3.10,29,0,0,0,409,0,49,17,40,0,0,18,159,83,72,7639
537,537,0,480,57,1942,1644,362800,496,41,92.36,7.64,60,40,46,44,341,0,0,18,0,16,0,63,121,38,229,7640
412,405,7,296,109,1951,1242,312200,366,46,88.83,11.17,13,0,26,49,300,0,61,53,0,0,0,61,191,13,0,7641
586,530,56,414,116,1950,1043,215100,537,49,91.64,8.36,53,28,75,48,322,0,121,64,0,0,0,252,33,14,0,7642
436,420,16,262,158,1955,991,222000,372,64,85.32,14.68,51,35,44,0,298,11,36,79,22,0,0,226,42,12,0,7643
241,241,0,137,104,1966,0,208200,187,54,77.59,22.41,17,60,35,9,177,48,62,21,0,0,13,92,33,0,0,7644
450,413,37,249,164,1963,894,171400,392,58,87.11,12.89,151,17,36,20,250,12,110,39,0,0,0,224,0,0,0,7645
442,393,49,314,79,1952,1270,195400,442,0,100.00,0.00,30,28,10,97,193,0,30,42,0,8,13,235,30,0,0,7646
548,548,0,282,266,1961,1127,276300,392,156,71.53,28.47,49,0,40,67,378,0,133,75,12,0,11,71,188,14,0,7647
596,570,26,334,236,1947,1053,213700,467,129,78.36,21.64,79,24,43,32,402,0,79,51,0,0,11,219,186,0,0,7648
563,542,21,331,211,1944,925,260400,417,146,74.07,25.93,0,0,52,10,399,64,61,48,0,11,0,104,132,29,12,7649
770,770,0,183,587,1965,915,268800,218,552,28.31,71.69,61,7,118,227,270,97,332,14,32,0,12,43,112,11,8,7650
430,430,0,186,244,1952,988,226400,292,138,67.91,32.09,12,0,79,22,210,0,137,0,0,0,0,79,74,0,0,7651
415,410,5,211,199,1942,1037,445500,246,169,59.28,40.72,33,0,41,9,446,0,154,58,0,0,0,0,177,27,20,7652
542,542,0,301,241,1939,1140,389700,385,157,71.03,28.97,19,0,46,19,357,9,140,21,0,0,19,29,90,81,52,7653
932,836,96,698,138,1985,1592,242100,922,10,98.93,1.07,299,84,358,32,32,0,0,108,0,8,0,136,411,53,17,7654
2070,1939,131,689,1250,1992,1083,198300,1135,935,54.83,45.17,1229,130,225,44,197,84,485,372,18,0,12,417,310,25,9,7655
382,350,32,319,31,1963,0,359400,298,84,78.01,21.99,56,43,25,49,209,0,2,40,0,0,0,87,40,33,82,7656
440,440,0,297,143,1975,1411,381100,391,49,88.86,11.14,37,57,95,44,138,0,10,30,0,0,0,56,183,51,41,7657
865,865,0,447,418,1973,964,140800,742,123,85.78,14.22,354,92,166,108,264,50,224,51,0,0,33,337,158,23,0,7658
1015,824,191,632,192,1993,1250,325900,913,102,89.95,10.05,504,141,121,48,67,0,14,0,31,0,35,181,392,69,146,7659
564,525,39,455,70,1977,1079,216300,512,52,90.78,9.22,203,44,124,92,101,0,25,0,0,0,36,135,181,74,63,7660
669,669,0,542,127,1981,954,231200,542,127,81.02,18.98,229,99,214,47,156,0,85,20,0,0,15,247,135,100,82,7661
692,658,34,413,245,1979,830,282200,557,135,80.49,19.51,231,12,159,65,173,66,134,12,0,0,12,186,116,13,67,7662
1121,1064,57,840,224,1981,1008,251400,859,262,76.63,23.37,388,135,522,56,106,31,119,58,0,0,129,204,223,74,195,7663
521,521,0,403,118,1979,987,203800,459,62,88.10,11.90,158,145,57,144,46,0,88,23,0,0,23,174,133,66,13,7664
442,442,0,255,187,1977,755,189600,354,88,80.09,19.91,65,14,108,0,178,12,55,26,0,0,14,185,51,0,0,7665
313,267,46,88,179,1957,686,124200,167,146,53.35,46.65,117,42,13,30,174,28,159,0,0,0,0,87,0,15,0,7666
359,359,0,241,118,1947,0,236600,265,94,73.82,26.18,0,27,57,9,339,0,61,0,27,58,0,107,128,11,40,7667
693,594,99,284,310,1976,816,105700,286,407,41.27,58.73,102,50,228,69,68,78,92,5,0,0,62,78,18,0,0,7668
603,508,95,449,59,1974,0,279700,465,138,77.11,22.89,159,79,94,39,117,18,97,0,0,0,20,77,161,69,36,7669
548,490,58,374,116,1987,1250,158000,477,71,87.04,12.96,132,168,134,82,40,0,82,12,0,0,44,221,160,9,0,7670
342,285,57,279,6,1986,0,180900,169,173,49.42,50.58,116,43,142,38,27,0,27,0,0,0,29,168,30,12,12,7671
688,495,193,361,134,1976,686,131300,527,161,76.60,23.40,163,53,54,53,295,58,102,12,0,0,128,104,36,36,12,7672
324,301,23,193,108,1970,884,65500,190,134,58.64,41.36,107,38,69,72,159,0,20,12,0,0,120,135,44,63,13,7673
290,230,60,121,109,1973,677,105200,149,141,51.38,48.62,116,29,57,50,64,0,16,15,7,0,91,88,13,13,16,7674
461,412,49,210,202,1959,590,106100,303,158,65.73,34.27,9,37,188,37,277,19,212,22,0,10,49,133,0,0,0,7675
244,222,22,139,83,1949,525,148900,184,60,75.41,24.59,19,32,46,73,137,0,32,10,0,0,72,98,16,0,27,7676
836,798,38,620,178,1979,771,192600,596,240,71.29,28.71,395,53,332,123,50,42,250,54,0,0,83,302,187,17,18,7677
248,217,31,116,101,1952,860,128700,211,37,85.08,14.92,107,10,74,0,162,0,89,0,0,0,80,135,0,15,0,7678
399,379,20,331,48,1976,0,167700,356,43,89.22,10.78,189,83,95,116,47,19,46,9,0,0,86,204,50,0,0,7679
630,575,55,523,52,1991,0,156000,445,185,70.63,29.37,261,47,134,135,0,0,52,19,0,0,118,255,35,18,0,7680
473,473,0,141,332,1940,681,111100,321,152,67.86,32.14,4,9,17,68,383,76,190,4,0,0,49,117,10,0,0,7681
548,435,113,284,151,1978,966,322700,310,238,56.57,43.43,119,115,169,80,38,14,56,12,3,0,101,7,47,58,178,7682
1006,673,333,350,323,1990,776,377800,776,230,77.14,22.86,144,63,235,48,206,68,148,0,8,14,9,32,156,43,91,7683
271,247,24,124,123,1962,735,104500,174,97,64.21,35.79,83,42,51,39,184,29,142,33,0,0,20,166,0,0,9,7684
1150,326,824,164,162,1974,816,586100,1029,121,89.48,10.52,293,185,141,30,432,10,50,0,0,0,0,5,22,0,185,7685
301,301,0,243,58,1939,1625,293100,294,7,97.67,2.33,30,0,13,18,372,0,55,64,43,0,16,57,173,10,0,7686
575,520,55,358,162,1945,865,281800,425,150,73.91,26.09,41,40,136,76,319,17,156,114,13,0,14,169,129,0,0,7687
271,245,26,215,30,1951,1325,299000,271,0,100.00,0.00,0,0,5,13,348,0,0,20,0,17,0,114,160,55,0,7688
463,434,29,261,173,1941,899,254100,318,145,68.68,31.32,33,5,0,0,520,0,102,52,23,9,0,165,111,9,0,7689
193,193,0,146,47,1939,1870,437500,182,11,94.30,5.70,20,0,0,0,309,0,28,48,7,6,0,18,155,40,27,7690
562,527,35,316,211,1939,930,276700,396,166,70.46,29.54,52,0,0,9,462,0,76,27,11,0,14,116,191,3,0,7691
386,386,0,231,155,1939,1471,274400,371,15,96.11,3.89,51,0,11,13,344,21,66,16,36,0,0,107,160,13,0,7692
479,468,11,351,117,1939,722,278100,427,52,89.14,10.86,53,0,0,0,450,0,71,12,0,0,10,83,211,8,10,7693
518,518,0,479,39,1939,0,359400,518,0,100.00,0.00,0,0,12,0,467,19,12,0,0,0,0,82,234,95,37,7694
942,842,100,166,676,1947,966,260400,244,698,25.90,74.10,17,16,84,18,697,0,366,104,27,0,0,46,116,0,0,7695
384,339,45,274,65,1948,0,207400,384,0,100.00,0.00,0,0,11,25,344,0,36,10,0,0,24,230,69,11,0,7696
321,321,0,313,8,1939,0,638200,321,0,100.00,0.00,12,30,16,6,309,30,0,0,0,0,0,0,41,52,250,7697
689,655,34,135,520,1994,847,180500,193,496,28.01,71.99,171,18,95,25,184,70,291,28,11,0,0,56,0,0,0,7698
602,602,0,345,257,1989,972,0,303,299,50.33,49.67,344,39,22,17,72,0,115,0,0,0,173,108,0,33,7,7699
452,452,0,388,64,1984,1390,240700,452,0,100.00,0.00,168,112,144,0,39,0,31,10,10,0,19,174,159,0,30,7700
524,511,13,501,10,1980,0,252800,524,0,100.00,0.00,206,60,106,65,74,0,0,20,0,0,0,110,237,109,10,7701
886,886,0,501,385,1990,1026,193900,516,370,58.24,41.76,527,278,66,125,116,45,309,228,39,0,122,210,46,28,17,7702
698,661,37,579,82,1989,0,249400,662,36,94.84,5.16,215,115,140,53,46,14,15,0,10,0,8,157,330,12,23,7703
989,896,93,165,731,1976,856,209100,237,752,23.96,76.04,154,107,508,119,18,29,489,57,0,0,10,188,24,9,0,7704
843,810,33,514,296,1967,994,400000,606,237,71.89,28.11,83,96,230,172,293,18,249,13,14,0,0,7,318,91,128,7705
607,607,0,444,163,1956,1080,191500,549,58,90.44,9.56,74,30,117,98,366,0,73,45,14,0,8,315,188,0,0,7706
581,540,41,65,475,2000,898,0,135,446,23.24,76.76,168,89,30,11,189,0,254,0,0,0,0,167,0,23,0,7707
348,338,10,262,76,1957,1689,236900,348,0,100.00,0.00,10,0,86,77,260,0,18,0,0,0,19,140,177,20,10,7708
685,628,57,265,363,1973,836,174300,303,382,44.23,55.77,224,43,132,127,188,13,324,30,0,0,25,170,85,0,7,7709
1089,1036,53,564,472,1973,1082,158000,897,192,82.37,17.63,174,109,79,80,377,17,161,88,0,0,34,376,132,11,0,7710
725,673,52,369,304,1961,1021,182400,622,103,85.79,14.21,139,0,84,82,355,0,90,54,55,0,26,326,58,0,0,7711
506,459,47,371,88,1943,1160,231400,496,10,98.02,1.98,121,0,17,40,337,24,54,55,0,0,0,282,75,7,6,7712
618,595,23,386,209,1958,1042,192400,602,16,97.41,2.59,87,75,90,66,275,0,55,109,0,0,18,307,104,0,0,7713
851,797,54,456,341,1970,772,205900,559,292,65.69,34.31,177,76,25,201,370,0,213,116,0,0,0,288,163,0,0,7714
389,382,7,274,108,1959,1125,179800,349,40,89.72,10.28,42,21,51,121,161,16,0,54,41,0,9,156,71,0,20,7715
796,694,102,405,289,1973,777,254300,466,330,58.54,41.46,203,41,287,273,19,9,124,30,47,8,66,87,196,86,8,7716
676,651,25,372,279,1965,1059,183300,482,194,71.30,28.70,138,52,206,174,89,0,129,36,23,0,49,276,72,0,0,7717
443,354,89,272,82,2000,1590,276100,430,13,97.07,2.93,283,69,31,8,69,28,0,0,20,0,8,93,225,0,69,7718
363,331,32,252,79,1981,1313,597500,335,28,92.29,7.71,60,68,52,43,154,0,12,6,0,11,61,75,37,21,154,7719
1039,990,49,562,428,1970,1082,222800,798,241,76.80,23.20,531,5,132,167,292,122,364,50,43,0,10,284,175,30,13,7720
335,335,0,241,94,1984,1160,307700,165,170,49.25,50.75,83,38,118,14,71,15,87,0,0,0,25,26,50,37,25,7721
374,313,61,278,35,1976,915,366700,300,74,80.21,19.79,50,77,83,0,83,0,0,0,16,0,11,97,91,19,38,7722
771,713,58,596,117,1980,972,342900,683,88,88.59,11.41,263,93,221,32,104,0,24,10,0,0,31,139,249,111,142,7723
1212,1028,184,624,404,1992,913,255600,827,385,68.23,31.77,680,174,128,58,95,50,116,119,0,0,0,189,397,169,15,7724
349,304,45,190,114,1979,840,314000,200,149,57.31,42.69,184,48,54,11,47,0,19,75,0,0,12,39,42,79,78,7725
384,289,95,204,85,1962,522,300000,347,37,90.36,9.64,42,0,94,38,245,30,48,13,0,0,12,140,82,0,30,7726
478,432,46,380,52,1976,1656,316900,377,101,78.87,21.13,241,54,108,33,137,0,28,18,0,0,0,80,99,65,202,7727
379,330,49,267,63,1978,1060,0,172,207,45.38,54.62,84,144,177,112,142,0,13,0,0,0,295,143,41,47,22,7728
1100,531,569,487,44,1970,700,273100,944,156,85.82,14.18,157,184,281,81,129,13,70,0,0,0,52,216,137,13,79,7729
1156,956,200,782,174,1995,1401,401500,1068,88,92.39,7.61,712,92,91,35,135,0,65,25,0,0,23,170,203,102,291,7730
696,647,49,520,127,1977,969,242100,520,176,74.71,25.29,177,103,76,77,177,0,37,33,0,0,57,146,181,32,85,7731
275,267,8,0,267,1984,967,0,8,267,2.91,97.09,154,38,53,32,5,25,229,16,5,0,0,0,0,4,0,7732
501,453,48,241,212,1972,711,178700,310,191,61.88,38.12,80,51,221,91,158,55,121,0,0,0,35,208,99,16,3,7733
458,380,78,339,41,1975,0,291100,376,82,82.10,17.90,117,20,106,34,130,10,0,8,0,0,64,103,121,0,25,7734
578,535,43,226,309,1980,578,163600,343,235,59.34,40.66,77,0,64,76,136,63,100,17,0,0,0,144,0,0,0,7735
321,263,58,165,98,1971,671,188500,258,63,80.37,19.63,88,42,137,96,163,21,114,0,0,0,13,61,108,7,72,7736
422,422,0,352,70,1973,1042,244400,422,0,100.00,0.00,108,125,94,97,48,0,37,0,0,0,59,28,127,83,35,7737
639,562,77,489,73,1984,967,153500,439,200,68.70,31.30,159,28,161,37,83,40,5,10,7,0,49,173,37,4,86,7738
497,406,91,162,244,1970,642,250000,342,155,68.81,31.19,289,101,131,16,92,167,66,0,0,78,102,45,67,17,19,7739
800,647,153,410,237,1983,0,172200,681,119,85.13,14.88,294,45,234,88,95,71,77,33,45,0,28,124,61,24,76,7740
517,485,32,302,183,1955,634,165400,371,146,71.76,28.24,103,71,55,12,311,65,0,20,0,0,44,263,25,42,36,7741
545,507,38,335,172,1974,913,154600,408,137,74.86,25.14,122,0,88,123,152,0,19,0,0,0,170,128,107,0,17,7742
366,349,17,293,56,1977,0,243900,303,63,82.79,17.21,123,68,25,40,0,0,40,0,0,0,12,69,85,0,28,7743
527,453,74,332,121,1969,695,152300,378,149,71.73,28.27,38,58,133,39,248,48,56,22,0,0,96,194,25,0,0,7744
446,372,74,166,206,1965,820,116700,280,166,62.78,37.22,81,94,35,43,165,49,38,15,0,0,16,95,44,12,0,7745
506,455,51,209,246,1950,680,153800,260,246,51.38,48.62,0,30,56,24,358,139,88,42,10,10,13,75,18,0,0,7746
296,248,48,108,140,1959,716,145700,229,67,77.36,22.64,36,0,44,66,153,0,81,8,0,0,36,148,9,8,9,7747
462,462,0,223,239,1959,585,166600,256,206,55.41,44.59,38,42,77,47,217,41,72,24,0,0,20,151,32,12,14,7748
374,277,97,185,92,1968,632,153600,314,60,83.96,16.04,91,29,105,33,181,0,110,71,0,0,31,170,57,0,0,7749
443,443,0,191,252,1977,708,0,194,249,43.79,56.21,129,0,171,71,183,52,82,0,0,40,84,162,0,0,0,7750
455,377,78,269,108,1983,586,287200,400,55,87.91,12.09,112,47,267,47,23,0,0,17,55,0,35,75,97,32,103,7751
449,449,0,420,29,1978,0,303300,364,85,81.07,18.93,135,27,174,95,135,0,0,0,0,0,47,103,205,66,54,7752
811,760,51,709,51,1993,1116,284800,654,157,80.64,19.36,291,179,265,45,15,3,15,0,0,18,141,165,171,83,158,7753
558,428,130,230,198,1978,733,150400,368,190,65.95,34.05,195,48,104,9,167,8,85,8,0,0,27,251,74,5,17,7754
235,159,76,105,54,1959,821,283700,151,84,64.26,35.74,42,0,57,16,120,41,59,0,0,0,6,0,33,9,24,7755
566,566,0,121,445,1980,866,234400,178,388,31.45,68.55,336,104,144,0,131,76,408,20,0,0,0,53,122,0,0,7756
242,228,14,228,0,1959,0,225000,232,10,95.87,4.13,39,38,50,0,99,21,10,11,0,0,12,82,42,11,10,7757
673,631,42,500,131,1962,1089,292400,621,52,92.27,7.73,22,57,83,138,372,0,117,27,32,0,0,112,173,107,89,7758
346,303,43,153,150,1957,926,227200,306,40,88.44,11.56,91,19,101,0,128,0,47,29,0,0,25,92,106,27,13,7759
1072,1072,0,643,429,1976,638,131700,822,250,76.68,23.32,265,229,299,208,222,132,119,127,0,0,116,540,57,0,0,7760
331,260,71,244,16,1972,0,225800,263,68,79.46,20.54,23,9,43,75,108,0,0,0,0,0,18,93,30,0,14,7761
1019,1019,0,598,421,1975,671,9999,173,846,16.98,83.02,240,218,266,71,105,212,265,65,0,0,291,39,28,0,0,7762
717,692,25,358,334,1974,780,132000,401,316,55.93,44.07,81,55,360,128,189,13,235,0,0,0,100,274,65,23,0,7763
942,843,99,595,248,1994,965,321000,620,322,65.82,34.18,772,111,96,148,27,0,229,0,40,0,188,36,319,149,64,7764
740,578,162,335,243,1959,713,139300,506,234,68.38,31.62,139,40,100,46,397,25,98,0,0,0,129,235,55,12,11,7765
676,676,0,485,191,1996,1056,545200,540,136,79.88,20.12,544,82,133,22,68,0,154,96,0,0,0,101,130,33,261,7766
778,693,85,315,378,1969,705,152200,531,247,68.25,31.75,136,52,148,69,166,100,101,33,3,5,44,141,50,0,2,7767
816,816,0,568,248,1991,1158,320600,639,177,78.31,21.69,481,322,116,0,0,0,193,11,0,0,71,92,381,107,49,7768
647,639,8,615,24,1977,1538,344800,612,35,94.59,5.41,228,37,258,61,99,0,10,0,0,0,0,34,209,140,221,7769
462,462,0,245,217,1959,761,118900,303,159,65.58,34.42,83,0,86,55,242,58,156,83,0,0,54,90,0,0,0,7770
512,503,9,470,33,1985,0,293100,512,0,100.00,0.00,49,266,45,0,0,0,0,0,24,0,0,105,185,46,0,7771
634,579,55,375,204,1982,1167,281400,523,111,82.49,17.51,210,24,113,30,137,11,72,14,31,27,33,152,110,36,25,7772
365,334,31,171,163,1966,891,160400,331,34,90.68,9.32,0,11,116,48,347,0,13,52,0,0,10,324,86,0,0,7773
502,424,78,217,207,1954,780,109600,458,44,91.24,8.76,58,11,59,26,265,11,101,0,0,0,113,170,10,0,5,7774
1637,1637,0,867,770,1995,993,242800,867,770,52.96,47.04,1038,29,111,75,69,39,320,203,62,15,53,145,340,44,30,7775
1419,1232,187,951,281,1999,961,251300,1194,225,84.14,15.86,1018,84,276,125,101,40,271,87,22,0,96,195,350,214,158,7776
534,526,8,309,217,1949,1285,288700,479,55,89.70,10.30,52,9,5,54,442,20,64,69,16,0,10,160,178,9,0,7777
904,857,47,585,272,1971,924,334600,570,334,63.05,36.95,105,52,175,149,234,15,93,61,42,0,13,59,337,52,26,7778
980,916,64,478,438,1981,818,168800,689,291,70.31,29.69,139,267,84,129,295,0,315,27,0,18,0,262,163,13,29,7779
303,303,0,284,19,1977,0,256300,303,0,100.00,0.00,50,119,182,16,28,0,0,0,0,0,15,50,132,68,117,7780
792,690,102,533,157,1992,943,155300,390,402,49.24,50.76,326,116,105,0,60,0,70,50,51,14,131,123,107,13,0,7781
321,321,0,288,33,1980,1670,243200,257,64,80.06,19.94,93,52,103,107,77,0,8,0,0,0,41,115,140,38,21,7782
496,496,0,466,30,1984,1200,546100,440,56,88.71,11.29,146,105,107,21,74,0,0,0,0,0,11,45,55,51,225,7783
503,495,8,439,56,1981,838,557700,468,35,93.04,6.96,128,124,45,48,118,10,13,13,13,0,12,9,68,120,134,7784
744,653,91,303,350,1949,613,130600,392,352,52.69,47.31,19,0,153,59,460,155,57,97,0,0,91,202,0,0,0,7785
340,340,0,292,48,1978,0,285000,300,40,88.24,11.76,54,12,75,95,43,0,0,0,0,0,0,62,99,52,66,7786
879,682,197,549,133,1971,876,261300,734,145,83.50,16.50,206,81,262,116,179,0,21,0,0,0,24,98,199,102,93,7787
872,837,35,208,629,1983,888,184800,204,668,23.39,76.61,190,127,413,67,87,71,509,0,0,0,74,110,0,0,0,7788
1286,1270,16,1215,55,1996,1838,378900,1286,0,100.00,0.00,988,209,16,0,62,0,0,17,0,0,30,16,544,229,354,7789
595,574,21,114,460,1962,902,147200,437,158,73.45,26.55,60,26,181,86,257,97,342,16,0,0,10,102,6,0,0,7790
446,446,0,364,82,1964,865,217000,388,58,87.00,13.00,24,0,80,73,310,0,13,54,15,0,0,224,85,9,0,7791
471,354,117,177,177,1965,915,172400,267,204,56.69,43.31,43,15,82,91,210,0,130,53,54,0,0,182,22,0,0,7792
1204,1073,131,606,467,1986,747,157900,760,444,63.12,36.88,447,138,307,99,140,63,130,68,0,0,170,548,105,0,0,7793
413,383,30,237,146,1977,765,102100,275,138,66.59,33.41,129,18,99,69,81,21,61,19,0,0,57,159,0,0,39,7794
401,323,78,97,226,1968,584,0,307,94,76.56,23.44,0,24,71,60,242,57,166,0,0,0,14,122,0,0,0,7795
317,317,0,247,70,1982,903,149700,175,142,55.21,44.79,103,43,152,50,57,21,10,32,0,0,30,256,17,0,8,7796
1359,1321,38,513,808,1994,1000,284300,524,835,38.56,61.44,1055,394,66,9,27,58,373,299,43,18,129,76,195,139,48,7797
847,836,11,749,87,1994,958,190000,770,77,90.91,9.09,540,24,44,61,179,18,27,59,0,0,46,382,256,56,4,7798
820,746,74,541,205,1985,1015,285800,719,101,87.68,12.32,316,53,119,64,203,4,69,55,10,0,7,217,151,38,160,7799
608,520,88,433,87,1983,725,250900,481,127,79.11,20.89,171,94,33,21,221,15,78,0,0,0,0,210,55,22,10,7800
305,305,0,254,51,1966,688,156300,186,119,60.98,39.02,32,69,0,91,187,15,103,20,0,0,104,137,0,0,0,7801
674,636,38,392,244,1962,676,235200,529,145,78.49,21.51,184,25,183,82,217,0,111,35,9,0,48,166,162,17,15,7802
568,438,130,420,18,1980,0,200700,427,141,75.18,24.82,217,75,74,14,35,32,52,0,0,0,53,145,52,12,28,7803
519,519,0,285,234,1985,874,116600,330,189,63.58,36.42,218,116,21,0,309,80,7,77,0,0,145,154,46,16,0,7804
650,650,0,580,70,1975,1020,148500,615,35,94.62,5.38,68,25,320,91,237,0,79,81,0,0,38,512,22,0,0,7805
1263,1174,89,933,241,1984,858,188600,735,528,58.19,41.81,466,132,405,24,155,0,222,59,12,0,419,187,180,13,60,7806
786,699,87,180,519,1977,1002,252600,407,379,51.78,48.22,132,93,272,49,101,0,363,84,55,0,10,39,54,0,18,7807
374,277,97,189,88,1972,607,162900,241,133,64.44,35.56,57,19,91,37,162,57,36,15,0,0,73,84,14,6,0,7808
393,367,26,168,199,1963,1143,278000,261,132,66.41,33.59,68,23,46,108,151,0,103,32,0,33,0,32,55,84,0,7809
44,44,0,0,44,1977,1426,0,0,44,0.00,100.00,0,0,0,0,0,0,0,0,0,0,0,0,0,0,0,7810
1106,1032,74,670,362,2000,1132,327800,747,359,67.54,32.46,523,10,151,50,240,0,117,113,34,0,0,227,180,100,81,7811
655,572,83,296,276,1992,861,240100,399,256,60.92,39.08,281,36,137,0,158,13,166,33,0,0,77,187,65,28,10,7812
411,411,0,236,175,1972,760,359600,387,24,94.16,5.84,72,15,134,11,121,0,0,0,30,0,12,76,65,41,114,7813
318,299,19,238,61,1986,1411,159300,299,19,94.03,5.97,146,69,98,13,31,0,11,88,8,0,11,107,89,12,22,7814
357,312,45,260,52,1986,971,253600,325,32,91.04,8.96,139,19,80,19,114,0,44,7,0,0,23,110,100,18,19,7815
1060,791,269,403,388,1992,907,355000,749,311,70.66,29.34,359,138,203,66,161,14,176,141,24,42,99,88,181,47,76,7816
598,533,65,341,192,1970,666,14400,118,480,19.73,80.27,234,107,217,88,160,82,118,0,0,0,437,102,0,0,28,7817
640,626,14,390,236,1977,0,197500,562,78,87.81,12.19,145,42,258,128,180,0,80,26,0,0,57,250,168,0,66,7818
544,544,0,219,325,1954,1029,163400,481,63,88.42,11.58,62,55,43,28,221,28,101,0,0,0,123,91,26,13,13,7819
594,473,121,359,114,1956,740,171500,482,112,81.14,18.86,183,46,103,26,278,0,74,8,0,0,66,284,80,48,38,7820
492,444,48,420,24,1978,1083,200000,373,119,75.81,24.19,77,105,29,83,72,0,16,36,0,0,30,138,69,17,18,7821
568,287,281,221,66,1982,1444,299200,500,68,88.03,11.97,192,109,49,18,45,11,48,14,10,0,18,69,95,44,44,7822
269,269,0,269,0,1975,0,423600,238,31,88.48,11.52,84,63,50,40,38,0,0,0,11,0,0,17,85,28,123,7823
579,579,0,546,33,2000,1671,346400,573,6,98.96,1.04,390,24,49,46,0,23,0,10,0,0,9,71,203,66,104,7824
337,214,123,152,62,1976,1041,184400,285,52,84.57,15.43,23,85,0,0,251,0,81,41,0,0,12,68,13,0,0,7825
600,589,11,275,314,1939,1153,443600,336,264,56.00,44.00,125,0,39,78,313,34,74,57,23,0,13,10,111,107,42,7826
920,837,83,403,434,1975,848,241400,648,272,70.43,29.57,103,237,166,291,99,69,215,8,0,0,13,196,341,42,12,7827
295,295,0,218,77,1983,520,258200,243,52,82.37,17.63,146,43,60,13,43,12,24,42,0,0,16,36,102,29,44,7828
786,744,42,679,65,1977,784,246700,661,125,84.10,15.90,166,69,176,106,191,21,20,0,0,0,135,276,119,42,53,7829
431,385,46,253,132,1944,524,213900,378,53,87.70,12.30,25,9,32,56,268,57,37,0,0,0,13,258,9,16,0,7830
596,571,25,447,124,1973,756,182700,518,78,86.91,13.09,51,36,64,34,296,23,58,6,0,0,10,185,80,8,13,7831
506,361,145,244,117,1983,967,245700,322,184,63.64,36.36,85,66,50,9,111,28,10,14,7,0,30,106,49,7,0,7832
343,314,29,200,114,1978,695,166700,216,127,62.97,37.03,87,24,113,58,111,0,64,3,0,0,105,142,48,14,0,7833
366,366,0,264,102,1977,1036,168600,281,85,76.78,23.22,106,37,107,81,162,13,98,48,0,0,11,179,46,17,25,7834
321,246,75,150,96,1947,650,215600,174,147,54.21,45.79,47,0,27,12,333,0,164,75,0,0,14,72,11,29,0,7835
417,358,59,128,230,1939,1151,346800,237,180,56.83,43.17,25,24,32,18,370,9,119,78,5,0,66,53,91,9,13,7836
426,406,20,189,217,1956,924,142000,355,71,83.33,16.67,31,27,26,42,350,17,62,30,0,0,36,305,0,0,0,7837
474,426,48,369,57,1992,792,170800,271,203,57.17,42.83,106,60,218,22,47,8,0,0,0,0,67,237,83,20,9,7838
541,541,0,227,314,1970,900,203400,374,167,69.13,30.87,131,30,120,89,288,28,217,13,0,0,51,148,90,12,11,7839
1263,1194,69,932,262,1990,737,229300,945,318,74.82,25.18,752,107,164,40,137,0,34,94,72,8,12,488,283,127,68,7840
1071,964,107,872,92,1978,1758,452900,965,106,90.10,9.90,337,296,241,67,156,0,0,0,26,0,0,78,213,345,365,7841
553,479,74,388,91,1970,1402,459400,527,26,95.30,4.70,202,0,71,153,108,0,97,0,50,11,0,37,120,26,133,7842
770,721,49,683,38,1978,1000,355100,720,50,93.51,6.49,467,40,270,116,85,0,12,78,0,0,0,77,269,302,189,7843
425,397,28,397,0,1985,0,668500,425,0,100.00,0.00,45,264,27,22,29,0,0,0,0,0,16,0,0,38,333,7844
292,292,0,256,36,1978,0,52800,64,228,21.92,78.08,55,165,50,24,42,14,0,0,0,0,153,85,27,14,43,7845
355,348,7,127,221,1968,639,181300,231,124,65.07,34.93,41,0,45,103,274,64,206,0,35,0,0,88,70,0,0,7846
557,470,87,406,64,1972,847,185300,479,78,86.00,14.00,207,77,28,12,266,0,53,11,0,0,46,253,75,12,52,7847
368,283,85,203,80,1963,586,227600,320,48,86.96,13.04,74,15,58,98,165,0,40,0,0,0,50,158,87,46,17,7848
476,453,23,150,303,1973,752,129300,256,220,53.78,46.22,49,47,241,59,185,8,274,31,0,0,8,209,25,0,0,7849
462,384,78,252,132,1939,823,133400,360,102,77.92,22.08,103,27,24,0,306,33,81,85,9,0,10,170,0,0,0,7850
398,335,63,177,158,1973,965,182500,244,154,61.31,38.69,125,11,70,19,131,11,67,71,0,0,38,121,32,0,16,7851
319,294,25,277,17,1961,1054,248100,306,13,95.92,4.08,75,32,28,7,260,0,56,18,9,0,11,184,20,0,18,7852
534,228,306,77,151,1958,647,367200,229,305,42.88,57.12,124,0,244,0,378,0,225,0,0,0,0,0,12,0,10,7853
541,507,34,408,99,1984,1074,285800,438,103,80.96,19.04,81,0,143,164,84,22,43,0,0,0,53,115,90,37,49,7854
1062,1052,10,785,267,1996,857,201800,778,284,73.26,26.74,708,70,112,99,21,101,33,97,0,32,184,272,169,0,0,7855
1520,1456,64,1167,289,1993,995,247800,1249,271,82.17,17.83,666,173,171,67,192,12,67,93,53,6,152,384,312,85,64,7856
299,299,0,271,28,1970,0,250300,299,0,100.00,0.00,56,0,66,155,54,0,41,9,0,0,0,91,104,0,41,7857
667,644,23,518,126,1978,925,256700,525,142,78.71,21.29,233,42,127,43,189,4,76,7,0,0,59,214,114,47,36,7858
1253,1207,46,768,439,1978,1668,282500,913,340,72.87,27.13,272,171,266,331,230,0,229,33,38,33,0,252,514,63,77,7859
687,595,92,8,587,1976,633,0,77,610,11.21,88.79,58,19,218,122,123,195,242,13,0,19,0,5,0,0,0,7860
935,797,138,601,196,1986,732,115700,576,359,61.60,38.40,338,213,198,75,81,41,142,0,0,0,255,266,24,42,14,7861
904,904,0,741,163,1998,1377,350200,750,154,82.96,17.04,901,8,0,0,0,0,0,95,14,0,27,42,490,179,62,7862
772,709,63,543,166,1972,1105,164800,710,62,91.97,8.03,51,28,295,196,254,0,66,126,0,0,0,539,50,0,0,7863
1054,1054,0,1005,49,1995,1831,370100,1054,0,100.00,0.00,638,199,103,28,0,0,0,55,0,0,16,106,334,126,297,7864
625,583,42,410,173,1967,1152,209200,611,14,97.76,2.24,107,17,236,122,112,0,19,25,0,0,13,261,180,17,13,7865
537,498,39,478,20,1975,0,327200,511,26,95.16,4.84,85,123,317,96,147,0,12,15,0,0,28,187,190,164,83,7866
475,416,59,324,92,1971,675,244900,399,76,84.00,16.00,138,33,182,108,59,0,14,0,0,0,48,69,121,85,144,7867
393,369,24,215,154,1959,752,144000,391,2,99.49,0.51,20,0,54,59,274,6,76,4,0,0,75,160,47,0,2,7868
439,381,58,264,117,1977,568,83300,197,242,44.87,55.13,118,48,60,12,204,70,110,0,0,0,160,37,40,0,0,7869
283,283,0,202,81,1950,864,248000,271,12,95.76,4.24,16,20,60,11,288,60,82,0,0,0,8,81,101,10,5,7870
555,504,51,371,133,1939,1239,338200,518,37,93.33,6.67,66,0,26,0,419,0,119,53,0,0,0,86,165,55,0,7871
585,538,47,413,125,1978,1103,283100,466,119,79.66,20.34,115,63,197,58,50,0,57,0,0,0,65,130,105,40,38,7872
342,306,36,155,151,1948,638,167100,227,115,66.37,33.63,38,30,38,6,212,58,140,0,0,0,32,81,13,0,0,7873
230,191,39,191,0,1977,0,309400,172,58,74.78,25.22,81,43,63,27,34,18,13,0,0,0,51,47,39,51,29,7874
506,506,0,285,221,1988,939,158300,415,91,82.02,17.98,153,45,198,14,41,47,73,35,0,0,17,236,11,0,0,7875
474,356,118,13,343,1979,932,0,54,420,11.39,88.61,190,0,43,16,133,44,142,34,24,0,0,0,22,0,16,7876
451,451,0,265,186,1965,799,332600,287,164,63.64,36.36,54,45,219,124,180,0,287,29,16,0,0,32,222,26,0,7877
567,560,7,182,378,1948,680,137000,400,167,70.55,29.45,22,62,74,56,382,88,222,41,0,0,42,164,14,0,0,7878
1166,1147,19,516,631,1998,868,226300,625,541,53.60,46.40,529,323,251,42,36,73,320,134,9,0,125,111,74,13,37,7879
676,666,10,366,300,1958,1023,243500,493,183,72.93,27.07,59,55,11,41,365,7,18,13,76,0,21,193,135,0,0,7880
693,646,47,419,227,1949,1247,459300,675,18,97.40,2.60,178,40,136,103,204,8,27,11,0,0,13,125,151,82,182,7881
327,297,30,231,66,1939,1096,234300,279,48,85.32,14.68,0,0,0,12,347,0,12,0,11,0,3,71,98,39,0,7882
676,502,174,439,63,1959,696,231300,513,163,75.89,24.11,81,101,135,82,132,20,31,4,0,0,43,211,111,22,42,7883
1302,1129,173,851,278,1976,824,195900,1073,229,82.41,17.59,705,119,195,160,283,70,256,19,0,0,8,716,301,18,7,7884
290,276,14,210,66,1958,725,567200,241,49,83.10,16.90,27,31,7,52,187,0,0,46,0,12,0,20,43,72,111,7885
411,328,83,285,43,1974,906,187500,355,56,86.37,13.63,132,48,116,11,113,14,34,0,0,0,65,170,96,7,10,7886
540,469,71,306,163,1984,775,134000,289,251,53.52,46.48,136,79,139,70,16,0,32,27,0,0,105,104,75,0,39,7887
1967,1795,172,1147,648,2002,1305,213200,1707,260,86.78,13.22,1111,301,281,26,38,16,299,185,94,42,48,514,383,22,61,7888
449,449,0,381,68,1983,1207,203200,408,41,90.87,9.13,100,130,230,116,6,0,22,78,38,0,0,210,204,17,13,7889
857,761,96,617,144,1976,0,281400,756,101,88.21,11.79,80,92,473,116,61,0,90,16,17,0,0,140,473,30,0,7890
867,738,129,368,370,1957,859,240200,499,368,57.55,42.45,20,83,143,216,458,14,433,22,8,0,0,289,69,7,11,7891
784,739,45,698,41,1987,0,463000,784,0,100.00,0.00,289,90,70,101,97,0,0,7,17,42,0,0,177,144,260,7892
441,367,74,230,137,1973,615,147900,294,147,66.67,33.33,17,12,142,165,38,17,67,0,0,0,50,205,0,0,0,7893
740,683,57,554,129,1992,1144,136800,618,122,83.51,16.49,348,19,33,31,91,0,26,6,2,0,41,297,79,0,0,7894
351,351,0,195,156,1942,1278,284600,278,73,79.20,20.80,0,0,102,37,314,0,101,70,0,0,0,155,79,0,0,7895
545,529,16,110,419,1982,1325,506800,44,501,8.07,91.93,339,236,104,29,15,0,117,250,109,0,0,14,81,14,61,7896
643,643,0,605,38,1993,0,547200,643,0,100.00,0.00,304,32,101,0,19,0,0,19,0,0,0,0,57,126,254,7897
3186,404,2782,335,69,1987,876,511900,3049,137,95.70,4.30,1875,1042,182,15,16,0,0,38,0,0,0,16,12,104,89,7898
855,578,277,405,173,1982,579,173900,637,218,74.50,25.50,269,51,243,43,139,0,57,20,0,0,71,231,121,11,60,7899
102,102,0,70,32,1975,0,120600,71,31,69.61,30.39,35,24,0,11,32,0,9,25,0,0,0,16,20,0,6,7900
437,412,25,282,130,1939,854,404400,387,50,88.56,11.44,11,0,0,0,416,11,30,21,8,0,7,51,160,51,20,7901
503,483,20,383,100,1975,891,163400,280,223,55.67,44.33,68,87,313,44,0,37,12,15,0,0,142,185,121,0,0,7902
269,217,52,115,102,1944,844,252800,214,55,79.55,20.45,25,12,37,29,181,22,101,0,0,0,25,33,52,37,14,7903
704,620,84,274,346,1974,823,205900,517,187,73.44,26.56,160,97,52,92,335,80,212,13,0,0,0,121,93,29,30,7904
210,210,0,170,40,1971,500,0,182,28,86.67,13.33,83,18,0,14,115,12,25,0,0,0,25,44,40,0,26,7905
358,327,31,238,89,1979,975,278600,264,94,73.74,26.26,74,46,88,11,49,13,0,0,0,6,0,58,73,20,90,7906
826,777,49,513,264,1980,979,183200,561,265,67.92,32.08,360,39,66,149,196,14,214,35,0,0,18,123,279,83,25,7907
632,632,0,518,114,1988,792,236300,526,106,83.23,16.77,150,67,113,153,105,21,36,0,0,0,83,198,137,87,10,7908
550,379,171,279,100,1987,833,134700,394,156,71.64,28.36,156,40,48,62,25,35,13,5,0,0,31,137,41,0,23,7909
951,906,45,437,469,1979,1019,459200,609,342,64.04,35.96,360,193,196,83,47,41,255,29,62,74,0,10,109,49,213,7910
846,708,138,477,231,2000,957,116100,469,377,55.44,44.56,227,100,148,0,0,0,19,12,0,0,154,178,0,0,43,7911
640,583,57,287,296,1982,1001,157600,348,292,54.38,45.63,282,87,221,61,31,0,266,48,0,0,71,235,8,10,11,7912
411,376,35,325,51,1978,1196,147500,399,12,97.08,2.92,176,26,89,65,39,0,35,12,0,0,41,262,21,11,13,7913
336,272,64,217,55,1939,0,238500,336,0,100.00,0.00,13,0,45,0,325,0,33,45,0,0,15,129,128,0,0,7914
324,324,0,176,148,1962,533,211500,207,117,63.89,36.11,0,41,28,15,202,0,42,33,0,0,0,156,16,0,0,7915
630,587,43,569,18,1975,0,326700,612,18,97.14,2.86,225,25,157,65,108,0,15,0,0,0,0,165,114,137,149,7916
1405,1405,0,1346,59,1994,0,464000,1351,54,96.16,3.84,769,49,148,150,158,0,55,0,13,0,0,54,226,261,563,7917
1046,1004,42,456,548,1974,927,193200,544,502,52.01,47.99,317,73,392,137,210,73,237,111,0,0,143,209,249,0,0,7918
449,399,50,352,47,1985,1398,232400,390,59,86.86,13.14,180,117,157,11,53,0,16,0,19,0,28,281,146,28,0,7919
694,648,46,520,128,1985,0,359600,599,95,86.31,13.69,170,66,235,94,211,49,0,17,0,0,89,106,242,145,128,7920
761,708,53,381,327,1946,870,633500,341,420,44.81,55.19,81,35,63,93,522,0,210,18,19,0,10,25,64,23,332,7921
728,583,145,347,236,1957,937,247500,493,235,67.72,32.28,196,11,75,55,407,0,178,31,0,11,9,177,154,0,46,7922
554,554,0,515,39,1977,1168,185800,554,0,100.00,0.00,100,67,164,151,20,0,14,7,0,0,0,344,95,24,15,7923
581,581,0,292,289,1958,547,331200,336,245,57.83,42.17,42,0,145,94,298,141,123,38,0,19,15,79,95,29,0,7924
509,509,0,296,213,1962,688,199700,312,197,61.30,38.70,72,16,48,34,230,0,111,0,0,0,42,147,53,0,0,7925
23,19,4,0,19,2001,1181,0,0,23,0.00,100.00,0,2,2,25,16,0,8,20,0,0,0,0,6,0,0,7926
601,581,20,401,180,1991,794,111100,363,238,60.40,39.60,415,114,136,45,125,60,144,32,0,0,111,251,88,23,40,7927
996,943,53,378,565,1986,1050,0,244,752,24.50,75.50,309,423,166,81,30,0,465,162,0,0,0,112,9,38,169,7928
535,490,45,405,85,1992,0,250200,535,0,100.00,0.00,283,96,118,31,82,0,0,0,0,0,57,187,317,9,10,7929
600,529,71,281,248,1961,952,182300,503,97,83.83,16.17,99,50,177,28,252,0,29,23,35,0,124,171,132,22,9,7930
1165,1123,42,885,238,1997,981,141600,1011,154,86.78,13.22,600,237,184,25,58,51,114,99,17,0,64,658,21,0,0,7931
213,185,28,132,53,1973,403,181300,185,28,86.85,13.15,105,7,47,0,111,7,49,0,0,7,8,19,93,14,0,7932
540,540,0,197,343,1952,783,222700,320,220,59.26,40.74,69,0,147,0,327,51,153,24,11,0,0,139,81,0,0,7933
528,438,90,320,118,1969,1016,192700,477,51,90.34,9.66,47,96,111,54,180,9,96,27,0,0,10,213,49,12,31,7934
764,631,133,237,394,1978,884,215900,526,238,68.85,31.15,322,137,105,57,84,63,97,59,0,0,10,127,151,22,79,7935
532,486,46,391,95,1973,960,290900,468,64,87.97,12.03,47,63,142,49,140,0,23,97,0,0,25,29,114,24,110,7936
913,783,130,132,651,1996,763,0,139,774,15.22,84.78,497,146,84,0,42,56,380,35,0,82,52,46,90,0,0,7937
479,479,0,116,363,1993,951,35900,141,338,29.44,70.56,203,54,99,58,15,11,213,10,0,0,158,11,0,0,0,7938
822,735,87,406,329,1970,938,147000,579,243,70.44,29.56,177,0,157,228,181,40,210,55,0,0,16,375,0,0,11,7939
581,581,0,331,250,1960,768,182900,401,180,69.02,30.98,18,30,29,147,363,11,102,46,0,0,7,253,135,0,0,7940
1134,971,163,838,133,1979,1008,311700,994,140,87.65,12.35,295,283,296,47,200,45,71,6,0,0,67,146,222,279,189,7941
462,416,46,305,111,1941,1114,335100,399,63,86.36,13.64,17,39,23,0,544,0,31,42,0,0,23,121,323,64,9,7942
584,492,92,373,119,1976,670,118100,221,363,37.84,62.16,111,43,276,23,104,0,121,32,3,0,115,135,28,11,23,7943
356,356,0,264,92,1956,792,149000,324,32,91.01,8.99,0,16,163,39,276,0,56,0,0,0,172,183,28,0,0,7944
1404,1311,93,874,437,1993,1139,234300,836,568,59.54,40.46,791,107,234,47,87,31,202,153,56,0,176,97,283,158,81,7945
342,285,57,274,11,1992,0,204200,342,0,100.00,0.00,181,72,41,11,9,0,0,13,0,0,14,174,77,0,36,7946
793,711,82,421,290,1987,803,159800,710,83,89.53,10.47,480,205,243,36,14,34,124,35,89,17,52,559,12,0,0,7947
330,259,71,140,119,1988,1049,150000,248,82,75.15,24.85,141,17,20,58,36,0,97,0,0,0,46,68,33,0,0,7948
791,606,185,463,143,1978,762,67800,270,521,34.13,65.87,199,56,258,22,102,21,57,35,18,0,218,204,20,0,19,7949
750,704,46,50,654,1974,977,280000,98,652,13.07,86.93,31,126,476,25,86,0,450,123,0,0,0,0,51,24,0,7950
849,849,0,623,226,1971,946,177500,445,404,52.41,47.59,31,70,90,398,75,35,93,12,46,0,128,148,155,13,0,7951
330,222,108,197,25,1939,0,226900,322,8,97.58,2.42,27,0,7,9,304,27,0,46,0,0,0,167,74,11,0,7952
623,623,0,611,12,1971,0,157900,568,55,91.17,8.83,146,21,128,100,75,32,0,9,0,0,64,151,164,23,27,7953
1189,1051,138,34,1017,1993,829,0,0,1189,0.00,100.00,898,244,13,0,13,157,735,161,77,0,0,0,0,0,0,7954
774,583,191,306,277,1977,668,97600,353,421,45.61,54.39,424,158,308,60,80,211,269,33,0,0,119,288,0,0,13,7955
500,416,84,98,318,1971,722,103300,229,271,45.80,54.20,39,40,93,38,142,59,79,0,0,0,53,61,10,0,0,7956
464,464,0,372,92,1966,2031,176100,437,27,94.18,5.82,37,0,90,158,109,0,16,71,0,0,35,224,48,0,0,7957
473,397,76,336,61,1984,785,321500,411,62,86.89,13.11,206,115,48,43,159,0,54,23,12,0,20,135,171,58,88,7958
299,299,0,89,210,1943,686,72100,291,8,97.32,2.68,0,29,45,0,228,33,198,0,0,0,40,31,0,0,0,7959
694,676,18,613,63,1975,983,184100,508,186,73.20,26.80,198,49,119,35,150,0,6,14,16,0,100,152,104,16,57,7960
436,392,44,314,78,1976,710,252300,321,115,73.62,26.38,55,77,71,29,167,18,13,0,0,0,20,138,40,47,64,7961
1959,1731,228,1431,300,1995,1734,496600,1826,133,93.21,6.79,1358,54,76,34,226,0,138,81,22,52,18,63,159,215,851,7962
1024,843,181,347,496,1942,908,297700,589,435,57.52,42.48,257,34,22,36,531,89,392,14,33,0,0,0,84,50,66,7963
2227,2009,218,567,1442,1990,698,403000,28,2199,1.26,98.74,1053,48,11,99,593,389,307,129,89,0,0,32,39,49,97,7964
348,302,46,273,29,1975,0,297800,280,68,80.46,19.54,110,18,75,35,46,0,11,0,20,0,0,26,47,57,104,7965
545,477,68,157,320,1975,796,162600,335,210,61.47,38.53,54,116,129,8,139,0,227,6,0,0,10,142,8,0,0,7966
740,653,87,484,169,1982,1113,166100,548,192,74.05,25.95,294,27,172,127,53,8,97,56,25,0,5,135,159,28,3,7967
515,488,27,379,109,1975,985,231900,467,48,90.68,9.32,19,30,211,48,104,0,24,19,0,0,0,190,179,0,0,7968
2726,2144,582,880,1264,2004,1572,396100,327,2399,12.00,88.00,794,230,301,0,214,0,190,130,213,46,0,82,185,67,221,7969
683,570,113,437,133,1981,908,239900,280,403,41.00,59.00,166,116,345,90,85,34,92,9,80,0,6,190,112,59,89,7970
403,391,12,290,101,1951,1188,188000,382,21,94.79,5.21,0,0,38,39,315,0,12,90,50,0,19,165,9,0,0,7971
381,381,0,215,166,1975,595,123300,188,193,49.34,50.66,50,0,188,193,120,77,96,0,0,0,130,214,7,0,8,7972
431,350,81,284,66,1957,811,146400,332,99,77.03,22.97,58,9,45,30,298,0,66,25,0,0,37,163,31,0,61,7973
777,709,68,177,532,1973,795,227000,293,484,37.71,62.29,154,87,245,153,113,48,384,10,35,0,0,156,29,8,10,7974
406,406,0,177,229,1955,662,117400,290,116,71.43,28.57,58,75,94,60,268,39,124,0,0,0,16,191,53,12,0,7975
359,339,20,230,109,1945,1529,321000,354,5,98.61,1.39,16,0,9,25,263,0,5,17,9,0,0,73,191,9,0,7976
886,874,12,810,64,1981,1419,275200,819,67,92.44,7.56,225,153,269,66,125,27,0,34,0,0,29,179,408,44,74,7977
291,291,0,138,153,1953,1011,157100,184,107,63.23,36.77,27,36,96,178,88,11,34,66,0,0,71,60,47,0,16,7978
446,392,54,353,39,1976,0,1016300,416,30,93.27,6.73,120,87,77,62,34,0,52,0,0,0,16,20,0,34,258,7979
1155,1071,84,863,208,1974,1400,228300,798,357,69.09,30.91,107,39,448,189,266,0,139,47,38,0,228,231,240,3,28,7980
613,568,45,493,75,1974,1913,327200,613,0,100.00,0.00,54,9,178,180,198,37,24,40,16,0,0,54,327,72,49,7981
576,555,21,325,230,1939,1571,274300,496,80,86.11,13.89,0,8,0,40,494,29,53,77,43,0,16,203,121,0,0,7982
325,315,10,285,30,1941,0,355800,325,0,100.00,0.00,0,0,0,0,326,0,32,0,0,0,0,64,145,53,32,7983
712,631,81,523,108,1972,0,370100,652,60,91.57,8.43,38,57,250,99,155,0,24,12,0,0,0,49,335,52,127,7984
658,601,57,491,110,1984,846,296600,290,368,44.07,55.93,200,16,231,42,159,0,87,0,0,0,116,123,147,56,83,7985
825,800,25,371,429,1953,783,134100,560,265,67.88,32.12,93,66,71,10,413,75,126,0,0,0,133,233,0,10,0,7986
433,417,16,366,51,1976,1238,201400,346,87,79.91,20.09,77,57,161,20,219,0,55,0,0,0,39,256,37,49,59,7987
1708,1626,82,1272,354,2002,1461,319400,1431,277,83.78,16.22,1274,20,60,12,40,0,67,99,58,0,21,188,676,124,163,7988
749,688,61,492,196,1998,879,244300,533,216,71.16,28.84,395,85,76,59,99,35,63,16,0,0,96,158,250,54,42,7989
951,827,124,699,128,1978,782,276300,735,216,77.29,22.71,317,115,273,0,230,0,27,0,0,0,96,254,226,57,180,7990
484,466,18,415,51,1974,838,169200,313,171,64.67,35.33,104,54,150,65,163,0,49,29,0,0,108,116,90,22,68,7991
533,523,10,488,35,1999,0,380400,518,15,97.19,2.81,286,84,99,0,0,0,65,0,0,0,9,129,145,18,29,7992
579,559,20,320,239,1968,1119,269700,390,189,67.36,32.64,57,76,75,257,157,0,49,52,6,0,20,202,204,24,0,7993
475,444,31,391,53,1982,1474,336400,475,0,100.00,0.00,245,206,168,22,0,0,35,0,23,0,0,142,194,15,135,7994
1056,1010,46,950,60,1980,0,485800,898,158,85.04,14.96,389,65,267,9,245,0,24,48,0,0,73,136,128,105,378,7995
467,454,13,167,287,1991,932,188200,214,253,45.82,54.18,250,12,23,13,142,31,142,80,0,0,16,51,77,0,10,7996
686,590,96,310,280,1956,700,160000,446,240,65.01,34.99,52,66,118,39,458,0,222,41,0,0,10,197,64,24,9,7997
281,281,0,156,125,1972,1098,238800,192,89,68.33,31.67,44,23,159,87,0,0,56,37,0,0,0,87,133,0,0,7998
290,290,0,263,27,1994,0,258800,216,74,74.48,25.52,144,0,29,80,38,0,0,0,0,0,9,81,89,29,71,7999
605,587,18,452,135,1976,1159,217800,562,43,92.89,7.11,155,71,142,55,318,0,55,36,0,0,13,429,173,12,0,8000
431,376,55,287,89,1962,1403,227100,431,0,100.00,0.00,23,15,97,131,291,0,0,112,0,0,0,347,98,0,0,8001
828,799,29,275,524,1978,1005,115100,252,576,30.43,69.57,121,60,284,120,167,20,290,33,29,0,99,209,66,0,6,8002
517,477,40,356,121,1978,977,159000,489,28,94.58,5.42,66,12,258,69,78,0,18,69,0,0,17,196,89,0,82,8003
775,618,157,202,416,1969,889,184800,465,310,60.00,40.00,178,45,119,86,185,75,133,23,40,28,0,226,53,0,0,8004
1314,1300,14,930,370,1981,981,364800,950,364,72.30,27.70,209,548,398,44,0,0,172,45,11,0,43,156,186,229,292,8005
821,784,37,747,37,1986,1838,331500,821,0,100.00,0.00,347,99,178,139,7,0,0,0,15,0,0,71,356,200,128,8006
525,447,78,402,45,1974,1195,219600,517,8,98.48,1.52,39,30,134,161,67,0,0,23,0,0,35,167,102,11,9,8007
314,304,10,277,27,1999,1031,238300,314,0,100.00,0.00,230,26,0,0,11,0,11,0,0,0,14,148,94,0,0,8008
578,478,100,333,145,1975,959,117000,353,225,61.07,38.93,91,39,155,93,201,32,92,15,0,0,60,139,43,0,17,8009
726,674,52,312,362,1982,777,183500,479,247,65.98,34.02,227,220,194,128,128,29,321,78,0,0,24,133,147,40,45,8010
1432,1432,0,987,445,1992,893,415800,1183,249,82.61,17.39,739,61,298,62,157,0,145,32,73,0,23,126,189,281,405,8011
509,482,27,269,213,1976,729,191800,302,207,59.33,40.67,71,55,198,83,135,0,249,27,0,13,29,83,70,0,0,8012
477,438,39,373,65,1974,0,375700,443,34,92.87,7.13,84,0,69,109,156,0,24,8,0,0,27,35,89,63,46,8013
573,438,135,323,115,1966,592,123300,458,115,79.93,20.07,163,92,140,57,184,44,147,27,0,0,48,144,57,25,21,8014
593,593,0,457,136,1987,771,220300,356,237,60.03,39.97,312,179,129,0,70,0,238,108,0,0,50,99,185,0,10,8015
450,421,29,351,70,1978,884,373000,388,62,86.22,13.78,232,43,148,71,86,0,0,14,0,0,23,66,127,90,144,8016
1662,1550,112,1120,430,2001,1178,195400,1442,220,86.76,13.24,1043,162,161,74,66,12,63,183,0,0,76,447,453,106,48,8017
1437,146,1291,146,0,1984,0,720600,1301,136,90.54,9.46,252,429,524,0,25,0,0,0,0,0,0,0,0,0,146,8018
1310,954,356,624,330,1987,823,113200,964,346,73.59,26.41,549,320,152,28,3,0,129,28,0,0,93,521,69,0,14,8019
1244,1124,120,446,678,1996,991,279200,796,448,63.99,36.01,868,92,85,84,0,0,356,142,53,54,28,89,298,86,12,8020
568,522,46,503,19,1990,844,241800,364,204,64.08,35.92,161,129,12,32,170,0,38,0,0,0,81,216,115,25,23,8021
576,543,33,396,147,1975,1089,216200,568,8,98.61,1.39,210,14,143,68,72,0,99,0,14,0,26,200,59,20,57,8022
780,711,69,424,287,1964,839,161600,627,153,80.38,19.62,168,22,76,149,244,35,118,70,13,0,7,346,49,11,0,8023
632,620,12,283,337,1974,767,291200,357,275,56.49,43.51,73,58,207,124,166,11,320,0,10,0,17,53,153,17,14,8024
790,743,47,668,75,1992,1125,182600,469,321,59.37,40.63,426,137,117,15,81,0,98,60,43,0,150,235,175,0,0,8025
562,414,148,326,88,1995,1086,170400,356,206,63.35,36.65,345,20,194,0,0,0,64,11,0,0,59,123,126,17,13,8026
323,323,0,83,240,1971,761,252600,100,223,30.96,69.04,70,0,30,64,170,32,210,15,0,0,0,35,9,0,0,8027
614,332,282,272,60,1973,922,253900,515,99,83.88,16.12,117,74,88,163,158,0,40,11,0,0,16,176,120,8,28,8028
509,469,40,242,227,1973,631,122600,319,190,62.67,37.33,105,37,81,82,177,63,14,0,0,0,50,246,38,0,0,8029
587,561,26,458,103,1957,1455,209600,577,10,98.30,1.70,49,26,13,134,369,0,48,30,0,0,12,290,117,48,0,8030
1062,1002,60,417,585,1981,702,219700,543,519,51.13,48.87,136,175,140,160,130,0,441,0,0,0,98,114,34,54,0,8031
576,536,40,202,334,1969,798,376900,154,422,26.74,73.26,161,77,215,288,62,20,392,19,0,56,0,33,10,18,255,8032
1355,1273,82,508,765,1995,915,234500,532,823,39.26,60.74,1016,135,179,30,75,33,387,183,77,0,32,278,225,12,30,8033
591,455,136,367,88,1978,725,169900,240,351,40.61,59.39,201,73,92,29,88,3,15,0,0,4,70,230,8,0,83,8034
401,370,31,162,208,1958,620,84800,257,144,64.09,35.91,79,21,106,56,244,77,118,4,0,0,149,99,0,0,6,8035
475,475,0,375,100,1961,1163,154600,475,0,100.00,0.00,137,0,115,150,194,0,161,56,0,0,7,362,10,0,0,8036
504,483,21,257,226,1962,986,147300,443,61,87.90,12.10,61,15,95,39,163,0,129,13,0,0,3,172,12,0,0,8037
447,319,128,258,61,1954,834,141100,421,26,94.18,5.82,46,14,70,35,291,31,48,18,0,0,16,203,96,0,0,8038
398,398,0,217,181,1961,960,338500,295,103,74.12,25.88,9,9,40,182,134,0,67,0,0,0,0,71,66,56,86,8039
1247,1176,71,399,777,1971,983,180500,783,464,62.79,37.21,175,53,164,288,148,61,294,64,0,0,47,221,22,13,0,8040
700,675,25,397,278,1958,721,191200,526,174,75.14,24.86,62,0,46,45,439,0,105,56,0,0,0,322,75,0,0,8041
638,638,0,613,25,1965,0,557500,620,18,97.18,2.82,29,35,173,100,233,0,0,0,8,0,0,23,104,37,398,8042
747,736,11,263,473,1982,805,157200,199,548,26.64,73.36,174,168,236,88,66,10,456,28,12,44,39,133,10,0,0,8043
1179,1179,0,1051,128,1984,1354,272300,1126,53,95.50,4.50,498,187,502,127,36,0,42,19,19,0,43,214,589,132,184,8044
402,390,12,321,69,1976,0,223700,319,83,79.35,20.65,11,28,171,80,252,43,33,0,0,0,128,129,49,35,12,8045
957,957,0,794,163,1996,1660,321100,941,16,98.33,1.67,761,53,43,49,39,0,0,42,110,14,17,68,471,100,123,8046
238,238,0,136,102,1960,559,129900,179,59,75.21,24.79,0,0,18,42,219,21,45,0,0,0,44,134,9,0,0,8047
786,719,67,255,464,1969,702,139100,423,363,53.82,46.18,60,132,98,211,238,172,269,8,0,0,20,162,53,0,0,8048
1309,1172,137,844,328,1994,1315,220600,859,450,65.62,34.38,716,96,45,71,359,18,230,226,29,0,107,193,208,74,53,8049
751,693,58,192,501,1991,950,248100,222,529,29.56,70.44,360,197,161,18,24,82,239,273,14,0,0,68,10,41,18,8050
1107,967,140,183,784,1979,964,145700,402,705,36.31,63.69,279,131,565,94,21,0,687,63,0,0,55,239,0,0,0,8051
986,986,0,782,204,1984,1011,202900,858,128,87.02,12.98,507,134,415,68,53,0,113,40,0,0,0,552,322,54,27,8052
972,776,196,160,616,1949,712,277500,257,715,26.44,73.56,57,70,80,94,523,241,266,57,18,0,0,43,9,12,0,8053
606,606,0,440,166,1996,1491,228800,606,0,100.00,0.00,370,59,0,0,29,0,0,22,15,13,0,94,280,10,11,8054
1192,1192,0,717,475,1997,1219,252200,942,250,79.03,20.97,722,95,108,0,27,12,86,195,96,0,28,264,228,26,17,8055
1798,1645,153,339,1306,2001,981,208800,324,1474,18.02,81.98,1627,0,24,0,0,16,714,265,11,24,0,243,206,0,0,8056
712,666,46,107,559,1993,1085,207600,113,599,15.87,84.13,538,254,87,0,0,32,351,148,12,0,0,0,91,0,0,8057
946,851,95,324,527,1990,1047,314700,419,527,44.29,55.71,345,475,66,0,42,0,499,49,46,0,0,35,247,44,8,8058
934,849,85,378,471,2003,1049,189400,393,541,42.08,57.92,576,0,29,0,0,0,188,52,0,0,0,200,41,0,0,8059
1244,1244,0,1168,76,1996,1817,359900,1244,0,100.00,0.00,939,15,0,0,0,0,0,41,41,20,15,61,488,253,35,8060
787,732,55,347,385,1983,1188,547300,430,357,54.64,45.36,299,204,191,68,21,0,109,250,0,0,0,9,88,90,78,8061
398,398,0,317,81,1994,0,234400,229,169,57.54,42.46,303,52,58,16,118,0,41,41,0,0,39,212,38,51,72,8062
323,277,46,193,84,1973,1040,305400,293,30,90.71,9.29,76,32,43,9,172,0,60,15,0,0,17,99,39,35,49,8063
426,426,0,280,146,1973,891,169400,362,64,84.98,15.02,116,12,121,116,65,0,133,35,0,0,0,192,40,0,0,8064
971,914,57,222,692,1975,899,376700,276,695,28.42,71.58,250,66,251,153,136,0,308,109,0,0,23,150,77,46,53,8065
706,657,49,318,339,1939,962,450700,418,288,59.21,40.79,22,0,10,13,685,14,301,98,30,12,0,26,63,30,156,8066
857,839,18,751,88,1987,759,208700,640,217,74.68,25.32,177,555,47,0,31,44,14,0,0,0,0,390,304,14,0,8067
890,828,62,685,143,1960,1672,785900,730,160,82.02,17.98,161,155,115,64,399,0,73,36,0,26,0,44,83,62,490,8068
898,872,26,663,209,1982,771,252300,719,179,80.07,19.93,304,134,342,0,10,11,76,14,26,13,0,241,328,0,23,8069
818,765,53,574,191,1980,1268,364700,477,341,58.31,41.69,334,198,239,40,26,0,90,75,0,0,13,179,140,74,250,8070
615,532,83,326,206,1968,742,141900,495,120,80.49,19.51,155,55,112,68,253,20,133,16,0,0,95,273,77,3,17,8071
775,658,117,572,86,1993,0,0,293,482,37.81,62.19,510,47,75,47,79,0,54,19,0,0,269,281,46,17,31,8072
527,345,182,285,60,1963,590,202800,414,113,78.56,21.44,67,100,84,104,143,0,24,4,0,0,33,155,117,12,14,8073
969,890,79,509,381,1988,911,204300,696,273,71.83,28.17,337,130,315,71,169,51,200,99,0,0,74,312,64,30,29,8074
589,574,15,335,239,1967,754,173500,387,202,65.70,34.30,68,10,179,179,231,10,169,90,0,0,0,340,48,0,10,8075
523,523,0,207,316,1987,1111,328700,289,234,55.26,44.74,198,127,65,48,71,0,60,108,0,0,11,79,141,0,10,8076
919,783,136,489,294,1998,1133,216200,760,159,82.70,17.30,560,66,69,40,39,21,113,14,0,0,9,152,236,48,42,8077
263,263,0,185,78,1939,1182,293000,218,45,82.89,17.11,0,16,13,34,264,0,60,64,0,0,0,13,96,52,0,8078
880,800,80,595,205,1988,810,148400,609,271,69.20,30.80,313,32,298,93,148,33,255,51,0,0,124,290,60,13,0,8079
825,825,0,726,99,1984,0,281200,679,146,82.30,17.70,345,98,178,48,64,32,75,15,0,0,44,129,196,82,128,8080
378,378,0,229,149,1977,1090,19600,25,353,6.61,93.39,173,149,173,53,0,0,236,32,0,0,197,60,0,13,10,8081
710,568,142,481,87,1991,1414,415000,500,210,70.42,29.58,176,99,172,42,83,11,59,19,0,0,75,117,56,26,157,8082
685,578,107,440,138,1951,746,212200,556,129,81.17,18.83,150,82,118,0,167,0,0,0,0,0,31,334,83,0,38,8083
494,454,40,238,216,1963,776,109600,341,153,69.03,30.97,53,41,132,29,161,44,130,14,0,0,99,51,3,0,17,8084
513,513,0,419,94,1978,884,335100,433,80,84.41,15.59,95,95,202,87,119,0,27,0,0,0,7,114,213,71,83,8085
815,709,106,573,136,1952,763,123200,780,35,95.71,4.29,43,21,140,60,462,0,105,0,0,0,116,324,42,0,0,8086
980,938,42,778,160,1975,1408,222000,898,82,91.63,8.37,155,218,295,160,190,0,148,111,22,0,15,332,361,0,0,8087
411,369,42,294,75,1969,0,237100,411,0,100.00,0.00,122,12,129,177,51,0,52,11,29,0,11,206,141,5,0,8088
1288,1226,62,1039,187,1995,934,334600,1066,222,82.76,17.24,793,102,177,54,153,24,86,68,66,0,87,152,314,239,136,8089
624,582,42,383,199,1972,970,168900,591,33,94.71,5.29,283,38,157,179,136,13,0,54,0,0,51,419,112,0,14,8090
603,440,163,374,66,1966,0,400000,557,46,92.37,7.63,100,0,23,105,129,0,0,17,12,0,0,8,130,50,140,8091
405,405,0,381,24,1979,0,280100,272,133,67.16,32.84,90,81,196,45,50,29,32,0,0,0,45,90,84,59,80,8092
965,952,13,824,128,1976,1255,391800,920,45,95.34,4.66,219,432,227,124,44,0,0,19,105,0,0,44,244,178,376,8093
1122,1052,70,594,458,1977,731,206300,668,454,59.54,40.46,285,115,229,28,290,13,72,8,0,13,52,432,172,43,0,8094
529,412,117,389,23,1997,1010,152300,342,187,64.65,35.35,335,77,55,5,0,0,5,0,0,0,14,315,42,0,16,8095
675,665,10,492,173,1999,1330,216000,611,64,90.52,9.48,344,78,340,58,58,0,215,65,30,0,12,99,241,78,33,8096
1321,1241,80,472,769,1992,857,226700,616,705,46.63,53.37,678,217,140,66,159,16,477,196,14,0,20,192,225,59,0,8097
934,840,94,422,418,1980,734,126900,361,573,38.65,61.35,359,192,208,63,0,0,199,27,0,10,189,138,91,0,14,8098
1075,663,412,490,173,1995,889,242900,957,118,89.02,10.98,483,100,158,89,16,0,55,16,0,0,44,191,77,17,16,8099
356,306,50,289,17,1982,1438,442400,309,47,86.80,13.20,138,38,82,71,71,0,8,15,13,0,15,15,39,83,160,8100
513,483,30,338,145,1977,925,321600,377,136,73.49,26.51,237,50,157,26,113,2,3,11,0,0,103,109,135,81,112,8101
704,569,135,64,505,2000,966,117000,234,470,33.24,66.76,48,34,137,91,169,0,167,67,0,0,28,94,38,0,0,8102
1010,919,91,706,213,2001,1262,163900,909,101,90.00,10.00,779,52,0,32,0,0,49,172,0,0,53,537,28,0,0,8103
236,236,0,55,181,1974,658,152100,55,181,23.31,76.69,0,50,117,8,81,0,188,0,0,0,8,0,0,0,0,8104
599,599,0,466,133,1996,699,175800,393,206,65.61,34.39,512,40,83,0,25,0,161,70,6,0,126,215,29,0,0,8105
1111,1056,55,987,69,1986,969,453100,983,128,88.48,11.52,563,204,236,77,38,0,8,32,31,0,10,146,91,188,600,8106
959,872,87,272,600,1985,988,265700,344,615,35.87,64.13,399,393,266,69,28,34,580,43,0,14,0,134,131,21,29,8107
599,547,52,275,272,1994,831,169100,469,130,78.30,21.70,135,127,160,44,209,64,254,57,0,0,0,186,88,0,0,8108
1033,920,113,578,342,1985,999,231900,646,387,62.54,37.46,261,293,107,238,106,0,221,103,0,0,0,282,269,77,24,8109
392,329,63,186,143,1965,676,347600,284,108,72.45,27.55,117,39,33,27,142,57,0,55,0,0,21,21,66,31,21,8110
568,449,119,212,237,1958,523,84200,407,161,71.65,28.35,86,2,37,157,313,56,86,0,0,4,212,82,15,0,0,8111
384,344,40,328,16,1974,0,354400,319,65,83.07,16.93,174,121,7,21,56,0,0,60,0,0,15,28,126,56,53,8112
401,382,19,382,0,1939,0,445100,401,0,100.00,0.00,8,0,0,0,387,0,0,0,9,0,11,35,150,104,74,8113
464,440,24,121,319,1939,641,281700,151,313,32.54,67.46,12,0,0,0,452,84,158,46,3,0,0,55,61,0,0,8114
211,178,33,78,100,1974,1011,424100,151,60,71.56,28.44,34,32,32,11,104,0,20,0,11,0,9,52,42,7,62,8115
934,757,177,656,101,1986,681,265300,636,298,68.09,31.91,312,95,242,66,206,0,86,30,6,0,104,93,176,149,214,8116
533,441,92,342,99,1985,892,398500,474,59,88.93,11.07,227,70,76,31,64,0,25,11,0,0,11,23,78,35,249,8117
589,495,94,348,147,1999,853,174100,437,152,74.19,25.81,320,49,121,0,103,0,58,13,0,0,31,133,152,42,72,8118
584,404,180,321,83,1976,536,230600,458,126,78.42,21.58,110,103,186,125,171,15,134,0,0,0,33,190,114,0,60,8119
623,604,19,508,96,1983,738,159400,334,289,53.61,46.39,122,51,185,54,74,73,40,20,0,0,96,116,75,3,8,8120
242,242,0,207,35,1978,0,188800,180,62,74.38,25.62,65,57,144,0,10,0,0,9,0,0,63,106,46,0,23,8121
921,882,39,579,303,1988,798,122300,652,269,70.79,29.21,394,127,250,122,105,136,187,0,10,0,56,278,122,14,42,8122
727,677,50,651,26,1989,1438,471000,709,18,97.52,2.48,256,55,244,98,72,0,55,17,0,0,16,35,39,161,350,8123
280,223,57,187,36,1985,878,286300,198,82,70.71,29.29,147,0,51,25,159,0,16,0,0,0,45,31,122,0,8,8124
463,394,69,76,318,1951,691,160700,305,158,65.87,34.13,43,95,54,17,204,14,267,0,0,0,21,60,0,0,0,8125
729,714,15,603,111,1978,713,236300,618,111,84.77,15.23,214,141,268,65,129,38,103,0,0,0,46,235,232,25,67,8126
324,304,20,258,46,1973,1181,182800,247,77,76.23,23.77,26,0,68,41,161,0,61,14,0,0,10,130,37,13,31,8127
1073,1022,51,714,308,1981,888,209100,772,301,71.95,28.05,579,90,356,127,121,11,143,49,60,0,191,322,280,0,31,8128
276,213,63,153,60,1983,686,72800,89,187,32.25,67.75,84,58,77,0,189,0,73,10,0,0,138,141,23,0,0,8129
517,445,72,341,104,1979,1127,486400,412,105,79.69,20.31,137,86,70,115,41,12,22,16,13,0,46,66,44,33,184,8130
302,227,75,144,83,1950,636,101400,270,32,89.40,10.60,46,8,40,14,175,8,12,4,0,0,85,60,0,5,3,8131
560,412,148,198,214,1969,646,171900,387,173,69.11,30.89,91,12,0,41,289,11,127,0,20,0,18,131,55,41,0,8132
431,367,64,334,33,1982,0,265500,226,205,52.44,47.56,164,229,134,0,134,0,73,57,0,0,60,129,109,14,40,8133
373,305,68,217,88,1993,617,226500,253,120,67.83,32.17,107,23,109,11,36,0,0,0,4,0,19,132,89,5,26,8134
275,261,14,154,107,1954,802,181900,216,59,78.55,21.45,53,16,46,40,121,0,42,0,0,0,11,143,30,0,0,8135
489,489,0,359,130,1985,700,148800,283,206,57.87,42.13,354,54,16,28,78,0,58,13,0,0,190,167,55,0,25,8136
210,210,0,138,72,1961,778,95700,172,38,81.90,18.10,0,10,104,0,184,0,55,0,0,0,64,99,0,0,0,8137
209,209,0,148,61,1974,1567,188300,145,64,69.38,30.62,107,31,65,18,76,0,0,0,0,0,160,20,71,0,46,8138
374,327,47,172,155,1973,1050,152600,287,87,76.74,23.26,77,7,0,9,239,0,105,9,0,0,29,165,15,0,0,8139
1724,1646,78,1201,445,1994,1260,257300,1573,151,91.24,8.76,574,193,201,148,175,0,33,138,66,12,9,267,305,112,270,8140
505,493,12,406,87,1979,0,256600,283,222,56.04,43.96,54,109,257,12,92,0,90,0,0,0,70,169,74,32,27,8141
377,310,67,213,97,1946,610,152100,248,129,65.78,34.22,52,38,48,52,178,40,43,3,13,0,69,138,21,0,11,8142
476,400,76,331,69,1984,694,248900,354,122,74.37,25.63,298,76,163,42,90,37,55,28,0,0,99,28,182,75,111,8143
277,277,0,251,26,1976,0,244000,158,119,57.04,42.96,34,51,75,32,121,17,28,0,0,0,88,24,80,21,21,8144
574,526,48,318,208,1955,750,168500,505,69,87.98,12.02,83,32,33,75,392,39,130,11,0,0,52,254,36,0,0,8145
492,492,0,283,209,1971,919,175600,408,84,82.93,17.07,151,19,218,71,143,0,82,85,0,0,36,262,72,0,0,8146
594,594,0,319,275,1978,790,165100,367,227,61.78,38.22,164,34,234,170,27,121,140,76,0,13,0,194,60,11,0,8147
633,434,199,356,78,1990,613,161900,385,248,60.82,39.18,191,129,0,13,132,13,61,0,0,0,31,60,69,35,87,8148
272,259,13,153,106,1984,1033,357800,203,69,74.63,25.37,85,14,46,11,100,0,10,12,0,0,9,18,65,79,53,8149
611,584,27,305,279,1972,624,201200,419,192,68.58,31.42,115,8,145,46,164,64,80,48,0,35,29,133,70,9,10,8150
1651,1524,127,1002,522,1998,999,173000,1394,257,84.43,15.57,863,39,281,70,103,62,165,246,0,0,16,433,355,30,8,8151
310,291,19,146,145,1975,821,107400,219,91,70.65,29.35,78,0,99,26,109,21,70,0,0,0,48,132,17,7,0,8152
1362,1362,0,1059,303,1995,923,413100,1102,260,80.91,19.09,1002,153,87,51,24,0,195,36,12,0,18,18,332,300,328,8153
685,664,21,238,426,1967,816,188600,405,280,59.12,40.88,80,46,283,212,63,72,298,0,0,0,26,239,9,0,8,8154
455,379,76,318,61,1968,632,273100,368,87,80.88,19.12,132,56,130,54,142,23,88,6,0,0,22,114,140,33,41,8155
492,492,0,266,226,1976,851,172800,277,215,56.30,43.70,52,98,490,35,40,23,196,80,0,0,53,302,11,0,0,8156
762,699,63,528,171,1970,1205,319200,695,67,91.21,8.79,112,49,149,126,299,0,51,66,0,11,31,125,302,95,24,8157
842,788,54,551,237,1988,979,0,310,532,36.82,63.18,368,339,104,22,14,0,173,34,0,0,245,33,117,43,0,8158
422,341,81,281,60,1959,786,174200,375,47,88.86,11.14,0,0,249,45,127,0,166,0,0,0,0,185,31,0,0,8159
367,313,54,141,172,1964,1131,437000,169,198,46.05,53.95,24,0,91,14,171,0,146,16,0,0,14,0,73,43,8,8160
440,432,8,236,196,1955,1114,205800,360,80,81.82,18.18,25,8,89,9,337,0,64,66,16,0,0,259,8,0,0,8161
263,215,48,141,74,1957,759,125300,196,67,74.52,25.48,38,26,36,11,160,37,39,0,0,0,53,121,0,0,0,8162
389,389,0,281,108,1979,900,134300,294,95,75.58,24.42,256,11,151,13,111,14,54,29,0,0,146,212,43,12,0,8163
541,507,34,184,323,1963,970,287700,256,285,47.32,52.68,17,53,153,0,258,10,215,63,8,0,16,56,102,11,0,8164
295,295,0,114,181,1974,825,131000,148,147,50.17,49.83,97,12,69,14,208,57,76,0,0,0,46,136,24,14,0,8165
819,777,42,498,279,1983,693,149300,543,276,66.30,33.70,282,97,265,30,123,87,110,0,0,30,64,403,36,0,0,8166
650,650,0,511,139,1993,902,159500,498,152,76.62,23.38,190,111,112,65,25,0,48,0,0,0,95,314,33,13,0,8167
577,577,0,291,286,1975,1056,241500,397,180,68.80,31.20,50,87,232,150,26,66,109,0,0,0,10,287,49,0,15,8168
576,473,103,340,133,1975,822,270500,392,184,68.06,31.94,144,129,131,28,82,0,193,9,10,0,7,141,57,40,16,8169
326,296,30,233,63,1948,645,112500,291,35,89.26,10.74,11,14,71,42,198,10,55,6,0,0,52,163,7,0,0,8170
409,409,0,315,94,1970,1130,194000,361,48,88.26,11.74,175,0,96,99,57,0,69,16,0,0,0,248,14,13,13,8171
432,336,96,28,308,1972,881,0,33,399,7.64,92.36,115,0,56,24,225,45,191,41,0,0,0,16,15,0,74,8172
1102,1057,45,398,659,1971,833,210200,658,444,59.71,40.29,253,35,204,188,412,96,425,71,0,0,0,223,222,11,12,8173
570,555,15,457,98,1967,1359,389800,543,27,95.26,4.74,34,40,115,146,147,0,19,18,41,16,0,22,95,78,146,8174
553,459,94,202,257,1974,956,237200,282,271,50.99,49.01,244,18,174,137,105,0,422,0,0,0,24,0,109,0,52,8175
989,914,75,462,452,1990,1057,190200,700,289,70.78,29.22,630,66,187,79,74,42,180,137,34,18,140,161,103,92,11,8176
669,664,5,552,112,1972,544,113400,505,164,75.49,24.51,39,20,242,152,298,0,39,0,0,0,112,494,69,0,0,8177
500,368,132,62,306,1939,491,0,184,316,36.80,63.20,18,39,33,67,407,315,103,0,0,0,9,0,16,0,0,8178
1657,1476,181,821,655,1991,892,27400,310,1347,18.71,81.29,655,124,230,161,139,32,208,49,0,0,601,122,0,0,0,8179
895,835,60,574,261,1975,939,237700,825,70,92.18,7.82,173,77,319,145,206,108,102,16,0,0,69,173,224,35,65,8180
488,437,51,412,25,1985,0,243500,351,137,71.93,28.07,150,0,128,14,155,0,23,0,0,0,49,114,56,82,84,8181
590,503,87,421,82,1980,926,220900,393,197,66.61,33.39,203,92,120,77,74,0,20,0,0,0,73,149,162,39,25,8182
284,237,47,192,45,1970,510,168000,238,46,83.80,16.20,7,67,40,40,35,4,25,14,0,0,23,50,22,0,0,8183
740,709,31,612,97,1982,968,264500,698,42,94.32,5.68,355,32,273,18,61,0,96,51,0,0,7,171,303,47,7,8184
482,395,87,177,218,1948,1048,138800,421,61,87.34,12.66,11,0,97,42,395,41,20,0,0,0,43,220,63,0,31,8185
223,197,26,64,133,1945,793,189600,176,47,78.92,21.08,49,0,0,40,139,29,38,0,0,0,10,48,61,0,10,8186
1718,1683,35,1303,380,1999,1663,294300,1705,13,99.24,0.76,842,141,84,54,322,9,0,42,8,0,15,336,508,329,96,8187
791,712,79,428,284,1969,890,239700,526,265,66.50,33.50,236,77,177,68,305,38,293,12,51,0,0,124,162,44,13,8188
960,934,26,206,728,1988,596,467600,166,794,17.29,82.71,376,102,20,34,198,222,137,86,31,0,0,18,44,12,100,8189
566,566,0,259,307,1991,832,193800,402,164,71.02,28.98,164,123,124,42,108,66,125,83,0,0,0,129,75,27,11,8190
416,407,9,373,34,1979,0,359400,329,87,79.09,20.91,150,35,175,36,98,0,22,0,15,0,0,26,150,153,128,8191
1418,1234,184,719,515,1989,728,370400,853,565,60.16,39.84,550,331,338,124,166,54,225,156,70,93,148,225,133,89,285,8192
972,733,239,381,352,1992,735,200400,549,423,56.48,43.52,373,154,286,67,131,168,314,80,46,0,0,198,66,0,26,8193
538,481,57,288,193,1952,916,174100,470,68,87.36,12.64,13,16,108,33,453,27,128,98,0,0,48,221,45,0,13,8194
379,290,89,167,123,1972,746,185100,230,149,60.69,39.31,37,40,78,14,138,24,52,29,0,0,13,143,23,0,0,8195
528,443,85,325,118,1968,0,373800,452,76,85.61,14.39,98,54,124,38,213,0,20,0,0,0,0,152,157,37,50,8196
337,240,97,141,99,1941,492,80800,261,76,77.45,22.55,57,20,52,9,288,28,47,0,0,0,113,14,17,11,39,8197
659,587,72,574,13,1974,0,382000,611,48,92.72,7.28,153,28,257,56,120,0,37,0,0,0,10,109,143,102,213,8198
1301,1283,18,1058,225,1986,1017,428600,1114,187,85.63,14.37,499,215,154,96,189,0,106,120,40,12,0,101,320,91,363,8199
423,423,0,369,54,1982,0,151800,128,295,30.26,69.74,121,29,25,50,78,0,32,14,0,0,33,64,41,14,105,8200
912,816,96,665,151,1970,776,216000,664,248,72.81,27.19,186,48,175,81,255,54,37,38,0,0,28,166,202,49,40,8201
499,499,0,343,156,1963,939,303900,449,50,89.98,10.02,27,33,45,43,279,15,44,56,0,0,0,130,79,18,14,8202
641,604,37,380,224,1947,845,238100,330,311,51.48,48.52,57,0,68,71,333,0,191,4,0,0,29,146,147,0,0,8203
258,227,31,168,59,1962,635,144600,192,66,74.42,25.58,46,7,80,6,176,12,42,0,0,0,139,73,22,0,0,8204
577,577,0,455,122,1960,0,367500,521,56,90.29,9.71,246,60,153,12,202,17,0,53,0,0,13,98,48,24,365,8205
279,266,13,41,225,1969,950,164200,80,199,28.67,71.33,171,7,52,14,72,11,227,19,16,0,6,7,13,0,0,8206
474,430,44,327,103,1981,630,316800,405,69,85.44,14.56,138,26,103,0,212,41,13,0,0,0,96,63,168,0,12,8207
566,527,39,333,194,1988,844,149100,466,100,82.33,17.67,229,57,180,45,183,19,66,10,0,0,52,246,26,0,59,8208
339,330,9,288,42,1980,1370,308800,339,0,100.00,0.00,75,182,39,0,118,0,0,14,13,0,0,19,278,49,41,8209
473,443,30,330,113,1973,1012,109700,354,119,74.84,25.16,51,104,107,71,165,11,45,0,0,0,197,77,65,0,12,8210
695,609,86,588,21,1978,695,51300,165,530,23.74,76.26,165,78,191,89,80,0,34,0,15,0,407,74,29,0,0,8211
483,483,0,346,137,1968,0,500000,457,26,94.62,5.38,73,15,88,129,91,0,0,0,0,0,19,57,105,25,129,8212
337,297,40,245,52,1994,0,270100,322,15,95.55,4.45,172,12,31,67,135,0,12,12,13,0,0,64,149,24,0,8213
424,335,89,333,2,1978,0,350000,379,45,89.39,10.61,123,39,90,38,98,0,0,0,0,0,39,116,83,46,25,8214
704,580,124,482,98,1984,1000,432100,642,62,91.19,8.81,243,114,198,40,81,10,46,16,0,0,13,32,159,143,177,8215
413,351,62,277,74,1969,761,149600,296,117,71.67,28.33,90,29,54,14,169,0,55,2,0,0,74,140,45,0,0,8216
935,849,86,576,273,1977,866,139000,746,189,79.79,20.21,202,58,89,84,236,0,57,48,50,0,54,202,58,18,0,8217
504,504,0,413,91,1983,949,332000,430,74,85.32,14.68,113,43,201,32,95,0,15,17,0,0,0,95,145,56,58,8218
1052,53,999,36,17,1979,0,0,670,382,63.69,36.31,485,733,129,14,15,0,0,0,0,0,0,15,0,0,77,8219
718,718,0,626,92,1979,1025,414800,627,91,87.33,12.67,245,71,66,95,133,0,20,0,8,0,22,67,234,75,164,8220
509,482,27,214,268,1976,914,202000,459,50,90.18,9.82,149,76,104,8,117,14,29,97,30,0,17,129,37,29,29,8221
234,234,0,138,96,1966,496,217500,196,38,83.76,16.24,87,41,49,48,112,0,28,0,0,0,39,92,79,25,16,8222
457,332,125,248,84,1971,1162,267200,344,113,75.27,24.73,106,35,240,119,152,8,26,21,0,0,164,175,108,47,55,8223
412,330,82,289,41,1974,440,285500,349,63,84.71,15.29,53,33,105,20,93,0,26,0,0,0,0,94,58,12,49,8224
1827,1727,100,949,778,1993,899,151300,1189,638,65.08,34.92,1009,61,270,113,36,0,335,292,40,13,50,449,154,0,13,8225
1247,1238,9,1022,216,2004,1463,413900,1096,151,87.89,12.11,666,111,54,13,51,0,41,10,0,62,0,8,145,161,265,8226
1303,1239,64,258,981,1986,1055,0,189,1114,14.50,85.50,337,335,117,137,46,0,291,144,195,16,89,98,54,0,0,8227
518,473,45,79,394,1963,707,80700,240,278,46.33,53.67,28,40,96,119,200,136,189,36,0,0,51,40,7,0,0,8228
623,623,0,406,217,1977,1056,170100,495,128,79.45,20.55,150,11,268,43,23,0,58,24,0,0,129,236,39,0,0,8229
284,284,0,232,52,1947,956,230800,277,7,97.54,2.46,10,0,0,27,281,0,52,12,0,0,17,142,86,9,0,8230
749,696,53,346,350,1987,775,172200,424,325,56.61,43.39,178,88,86,150,98,49,208,51,0,0,11,266,15,0,0,8231
751,751,0,429,322,1959,982,168000,639,112,85.09,14.91,89,0,102,106,243,13,143,124,0,0,12,191,10,0,0,8232
415,399,16,112,287,1965,778,140400,251,164,60.48,39.52,34,28,119,74,111,105,67,41,0,0,19,87,0,0,0,8233
493,493,0,220,273,1974,1092,237200,364,129,73.83,26.17,49,11,171,149,32,0,149,42,0,0,0,87,65,10,12,8234
1278,1174,104,1025,149,2002,1053,199700,923,355,72.22,27.78,871,15,180,0,111,10,55,101,17,0,226,429,207,38,16,8235
483,421,62,271,150,1951,1687,341300,452,31,93.58,6.42,47,0,50,91,297,0,0,82,0,17,0,47,167,41,106,8236
403,403,0,244,159,1945,587,148500,276,127,68.49,31.51,14,0,53,61,338,83,66,16,0,0,0,206,74,0,0,8237
632,565,67,256,309,1941,748,125000,574,58,90.82,9.18,86,0,23,28,620,9,239,30,0,0,41,312,0,0,0,8238
635,609,26,444,165,1959,636,127300,552,83,86.93,13.07,151,0,108,175,226,55,79,45,0,0,63,401,17,0,0,8239
443,426,17,203,223,1947,635,136200,347,96,78.33,21.67,25,7,118,33,222,99,126,0,0,0,15,110,8,0,0,8240
519,479,40,367,112,1977,892,250300,357,162,68.79,31.21,105,101,158,20,86,11,3,0,0,0,86,129,104,26,70,8241
782,713,69,295,418,1942,803,226800,565,217,72.25,27.75,15,34,95,185,612,111,287,48,0,0,78,207,75,0,7,8242
262,262,0,92,170,1959,835,162700,165,97,62.98,37.02,0,0,92,26,209,44,122,70,0,0,35,56,0,0,0,8243
438,438,0,231,207,1962,745,192500,272,166,62.10,37.90,108,7,88,26,227,54,101,55,0,0,26,209,11,0,0,8244
516,516,0,293,223,1977,861,192800,368,148,71.32,28.68,278,121,26,104,9,128,47,11,0,0,0,72,191,78,11,8245
1301,1208,93,766,442,1990,858,238300,820,481,63.03,36.97,462,110,139,35,83,13,71,72,31,17,74,225,238,19,28,8246
335,307,28,195,112,1967,856,181600,296,39,88.36,11.64,57,21,85,35,140,0,94,70,0,0,10,98,25,26,11,8247
1196,359,837,242,117,1980,868,173900,896,300,74.92,25.08,411,164,224,33,380,36,55,7,0,0,65,94,35,12,81,8248
656,656,0,222,434,1960,929,378700,169,487,25.76,74.24,11,27,56,147,458,0,392,40,15,0,0,41,114,64,33,8249
699,613,86,223,390,1946,1032,421100,194,505,27.75,72.25,97,0,73,37,492,71,188,62,39,0,0,46,42,41,130,8250
590,578,12,383,195,1939,1047,426100,384,206,65.08,34.92,0,0,0,33,578,23,153,14,0,0,10,81,116,27,68,8251
355,336,19,300,36,1978,735,178100,253,102,71.27,28.73,62,19,187,0,60,0,20,12,0,0,18,112,81,1,9,8252
513,452,61,261,191,1939,1049,400600,374,139,72.90,27.10,112,14,0,65,402,0,249,32,13,0,0,152,71,47,14,8253
474,474,0,321,153,1951,1404,173600,422,52,89.03,10.97,14,0,40,13,296,13,0,12,0,0,13,281,33,11,0,8254
333,333,0,156,177,1939,1035,280200,228,105,68.47,31.53,0,19,46,40,227,0,158,0,0,0,0,95,9,0,0,8255
376,309,67,197,112,1980,692,111400,166,210,44.15,55.85,92,46,58,10,71,27,46,0,0,0,98,80,4,0,0,8256
605,584,21,440,144,1977,767,242900,433,172,71.57,28.43,66,33,222,36,294,22,71,11,0,0,23,201,189,0,16,8257
541,353,188,316,37,1988,1031,380500,535,6,98.89,1.11,197,133,90,84,76,0,8,31,0,0,12,20,145,53,129,8258
449,433,16,320,113,1991,947,186500,339,110,75.50,24.50,138,30,67,31,126,14,48,20,0,0,34,164,27,15,15,8259
331,289,42,144,145,1962,544,74200,208,123,62.84,37.16,0,22,66,13,176,0,73,0,0,0,76,54,31,0,0,8260
455,423,32,385,38,1979,1226,194300,388,67,85.27,14.73,202,50,89,62,96,0,12,0,0,0,95,167,119,62,23,8261
769,703,66,374,329,1971,958,270900,432,337,56.18,43.82,391,20,20,31,316,0,199,34,83,0,0,169,139,50,37,8262
328,328,0,240,88,1939,1061,355000,203,125,61.89,38.11,31,0,0,75,264,0,146,35,0,0,16,0,78,10,32,8263
466,450,16,237,213,1939,1243,235300,402,64,86.27,13.73,21,0,47,19,252,0,57,21,15,11,0,173,21,0,0,8264
359,309,50,142,167,1957,890,209700,260,99,72.42,27.58,129,33,68,31,215,0,170,30,0,0,20,187,22,0,13,8265
528,490,38,370,120,1946,971,298600,437,91,82.77,17.23,6,12,23,54,389,12,72,24,8,0,0,73,172,0,12,8266
552,492,60,400,92,1976,1057,224700,514,38,93.12,6.88,172,20,331,3,10,0,143,22,4,0,0,140,217,10,0,8267
1069,1027,42,631,396,1994,624,149100,559,510,52.29,47.71,597,89,127,57,28,32,212,99,0,0,128,370,15,0,0,8268
1004,934,70,788,146,1994,1452,194300,774,230,77.09,22.91,760,71,313,33,82,31,102,108,0,0,132,570,218,25,0,8269
545,545,0,371,174,1978,708,109500,201,344,36.88,63.12,222,86,158,38,61,24,91,17,0,0,174,242,0,17,0,8270
1222,1140,82,960,180,1994,1118,261100,1027,195,84.04,15.96,740,143,199,88,90,0,24,90,0,0,89,380,278,105,162,8271
913,827,86,614,213,1989,699,181400,481,432,52.68,47.32,338,119,114,84,150,71,133,0,0,0,88,278,100,30,0,8272
544,505,39,354,151,1972,1168,241000,535,9,98.35,1.65,32,17,237,92,201,0,42,78,0,0,14,240,146,12,15,8273
886,838,48,634,204,1995,1168,156500,532,354,60.05,39.95,697,73,149,20,92,0,156,89,0,0,190,394,139,0,13,8274
446,395,51,305,90,1979,625,324100,386,60,86.55,13.45,82,41,65,13,168,13,34,25,0,0,28,82,55,15,62,8275
235,193,42,183,10,1977,0,147500,199,36,84.68,15.32,70,27,66,34,40,0,20,10,0,0,33,132,42,0,0,8276
1856,1702,154,1319,383,1998,1330,239100,1705,151,91.86,8.14,1194,0,134,91,163,0,87,91,0,0,0,483,782,33,25,8277
949,914,35,293,621,1982,867,189200,370,579,38.99,61.01,204,218,241,207,24,83,408,35,0,0,0,272,59,24,13,8278
452,452,0,335,117,1972,1051,221700,373,79,82.52,17.48,77,51,184,49,71,0,42,19,0,0,12,277,74,0,0,8279
731,694,37,494,200,1979,0,159300,539,192,73.73,26.27,205,52,219,125,32,18,99,48,0,0,50,284,72,12,0,8280
428,401,27,295,106,1972,534,104500,380,48,88.79,11.21,43,58,84,31,175,19,74,0,0,0,90,186,22,0,0,8281
318,318,0,262,56,1968,970,339100,295,23,92.77,7.23,60,22,142,19,83,0,0,0,0,0,7,99,128,25,34,8282
313,205,108,165,40,1960,725,236100,272,41,86.90,13.10,56,28,42,19,196,0,14,1,0,0,26,58,49,15,36,8283
860,852,8,576,276,1969,878,213800,826,34,96.05,3.95,223,63,211,291,155,20,157,28,8,0,15,472,167,19,11,8284
609,609,0,171,438,1966,696,224600,361,248,59.28,40.72,0,110,151,10,454,188,126,33,0,0,42,64,82,0,11,8285
672,655,17,326,329,1955,851,205600,346,326,51.49,48.51,83,34,52,129,607,0,241,22,0,0,29,222,285,15,13,8286
684,676,8,291,385,1958,1291,170600,641,43,93.71,6.29,54,31,92,53,364,6,70,67,0,0,22,272,111,0,0,8287
415,358,57,222,136,1957,838,189900,339,76,81.69,18.31,52,0,28,99,262,0,50,69,0,0,0,250,52,0,11,8288
693,585,108,431,154,1975,1056,193000,599,94,86.44,13.56,40,74,196,195,146,0,63,18,13,0,12,386,147,0,0,8289
471,471,0,386,85,1986,1557,229000,471,0,100.00,0.00,236,48,150,30,69,9,10,41,0,0,39,183,190,0,9,8290
1102,1049,53,275,774,1969,879,157500,488,614,44.28,55.72,171,55,463,62,275,94,444,73,0,0,71,248,67,0,13,8291
1089,1089,0,619,470,1971,730,546100,640,449,58.77,41.23,171,137,290,279,211,31,326,10,16,0,0,22,170,61,330,8292
12,12,0,12,0,0,0,0,0,12,0.00,100.00,0,0,0,0,0,0,0,0,0,0,0,0,0,0,0,8293
2302,2182,120,979,1203,1998,1045,224900,1526,776,66.29,33.71,1921,113,107,88,77,179,433,368,44,36,116,373,393,110,67,8294
2564,1411,1153,1176,235,1999,1293,348400,2079,485,81.08,18.92,1472,198,213,11,27,0,53,6,21,0,0,170,203,207,473,8295
550,466,84,300,166,1948,765,117700,440,110,80.00,20.00,82,41,164,50,298,27,136,0,0,0,135,171,77,32,28,8296
347,310,37,246,64,1956,625,303000,338,9,97.41,2.59,64,19,84,42,113,8,9,10,0,0,0,76,150,51,18,8297
328,328,0,315,13,1983,0,234500,247,81,75.30,24.70,178,29,144,53,12,0,0,0,0,0,14,165,136,48,14,8298
499,426,73,330,96,1968,786,171000,403,96,80.76,19.24,64,58,131,66,145,0,46,0,0,0,60,233,78,0,36,8299
403,335,68,286,49,1975,911,278300,296,107,73.45,26.55,113,21,89,0,171,0,0,0,0,0,88,125,107,14,60,8300
1123,1007,116,695,312,2002,859,215900,976,147,86.91,13.09,945,0,83,61,190,75,115,196,0,0,31,291,334,55,63,8301
786,689,97,530,159,1974,1294,323300,755,31,96.06,3.94,87,0,374,132,74,63,14,15,0,0,51,86,205,104,124,8302
922,890,32,570,320,1963,848,379700,826,96,89.59,10.41,178,35,304,48,226,0,50,21,0,0,67,97,170,125,205,8303
318,290,28,220,70,1958,978,330000,260,58,81.76,18.24,0,21,0,16,305,0,0,17,15,0,12,138,90,20,19,8304
930,882,48,102,780,1967,1169,325000,138,792,14.84,85.16,372,9,60,212,350,0,283,329,70,84,10,30,70,0,12,8305
666,666,0,334,332,1983,1045,240100,305,361,45.80,54.20,165,136,121,158,11,0,271,47,0,0,26,93,96,37,21,8306
1074,1030,44,74,956,1992,990,165300,132,942,12.29,87.71,623,383,150,22,50,116,736,167,20,0,0,46,8,0,0,8307
397,384,13,327,57,1987,841,394800,264,133,66.50,33.50,159,26,87,29,78,0,10,0,0,0,11,51,122,108,77,8308
854,811,43,106,705,1995,843,82300,90,764,10.54,89.46,433,176,128,62,85,177,495,0,0,11,39,57,16,0,0,8309
526,526,0,488,38,1977,0,277200,465,61,88.40,11.60,158,91,151,140,32,0,45,49,30,0,0,125,199,44,80,8310
641,641,0,464,177,1990,742,165400,466,175,72.70,27.30,308,25,106,65,108,16,66,27,29,0,15,228,97,27,37,8311
817,767,50,548,219,1990,1256,179900,692,125,84.70,15.30,428,93,105,7,66,0,49,45,0,0,128,379,26,0,0,8312
257,249,8,188,61,1963,1110,303300,232,25,90.27,9.73,56,39,44,25,113,9,22,7,11,0,3,56,71,18,47,8313
321,321,0,275,46,1980,0,302200,250,71,77.88,22.12,68,43,68,19,83,35,15,0,0,0,15,48,26,68,74,8314
762,728,34,276,452,1974,846,160000,534,228,70.08,29.92,288,53,163,146,203,10,342,127,0,0,0,336,0,0,25,8315
369,369,0,323,46,1968,1155,183900,369,0,100.00,0.00,39,9,158,198,11,0,62,11,11,0,0,207,124,0,0,8316
513,433,80,373,60,1979,742,218500,293,220,57.12,42.88,92,29,98,50,165,0,66,0,9,0,52,112,144,27,13,8317
872,872,0,791,81,1980,1688,321300,820,52,94.04,5.96,220,49,473,88,11,0,110,0,0,0,0,160,398,91,42,8318
802,683,119,77,606,1985,668,167800,168,634,20.95,79.05,452,166,128,42,43,6,631,19,0,0,0,25,11,0,36,8319
770,770,0,367,403,1973,787,168900,539,231,70.00,30.00,120,33,152,235,173,49,134,87,0,0,8,361,56,0,0,8320
373,321,52,198,123,1968,814,390900,202,171,54.16,45.84,41,31,72,65,133,7,39,26,0,0,7,45,102,38,63,8321
400,351,49,260,91,1966,754,339400,328,72,82.00,18.00,28,24,88,24,173,11,44,0,0,0,9,55,74,27,85,8322
468,468,0,316,152,1992,1616,326600,441,27,94.23,5.77,118,136,61,74,0,0,0,43,0,0,14,125,162,45,0,8323
756,718,38,548,170,1978,509,342000,687,69,90.87,9.13,142,12,174,122,224,115,0,9,0,0,0,11,216,137,82,8324
807,790,17,648,142,1996,1800,713800,807,0,100.00,0.00,531,49,38,13,204,0,15,0,0,24,28,0,48,60,615,8325
419,419,0,366,53,1979,1297,247200,419,0,100.00,0.00,25,123,152,15,0,0,0,14,0,0,15,115,156,15,0,8326
972,905,67,377,528,1997,1101,355000,583,389,59.98,40.02,590,102,95,19,0,17,161,143,0,0,0,15,216,103,90,8327
808,774,34,544,230,1978,1214,225000,674,134,83.42,16.58,199,68,291,105,9,21,92,89,53,0,36,210,134,9,0,8328
856,723,133,430,293,1958,746,149400,678,178,79.21,20.79,211,126,19,92,389,86,193,98,0,0,41,350,22,0,0,8329
74,74,0,0,74,1974,633,0,0,74,0.00,100.00,71,10,29,13,75,10,118,24,0,21,15,0,0,0,0,8330
741,727,14,529,198,1992,644,191100,610,131,82.32,17.68,303,85,228,56,159,147,51,66,20,0,10,403,71,0,0,8331
783,728,55,412,316,1985,945,246000,562,221,71.78,28.22,232,103,118,142,72,12,97,0,0,0,0,130,300,15,0,8332
227,227,0,208,19,1982,0,232700,150,77,66.08,33.92,134,23,26,38,105,0,5,0,0,0,26,122,119,22,19,8333
820,782,38,259,523,1991,1028,205300,468,352,57.07,42.93,449,129,59,29,178,40,291,157,18,0,0,225,81,0,0,8334
998,998,0,681,317,1970,1066,251100,824,174,82.57,17.43,96,38,249,207,397,14,114,137,15,0,11,356,233,98,9,8335
689,689,0,378,311,1964,1140,400000,475,214,68.94,31.06,33,36,132,178,355,0,133,12,42,0,0,47,91,159,117,8336
1371,1371,0,1269,102,2000,1375,577300,1346,25,98.18,1.82,1122,63,0,36,26,0,0,0,26,0,16,8,37,295,775,8337
1939,1731,208,1417,314,2003,1540,302800,1775,164,91.54,8.46,1696,174,262,24,31,0,16,171,93,37,23,406,746,277,136,8338
618,308,310,200,108,1990,871,187000,369,249,59.71,40.29,206,54,123,15,127,0,15,13,26,0,50,74,20,101,109,8339
424,389,35,356,33,1969,850,343400,340,84,80.19,19.81,48,101,39,99,133,0,30,0,0,0,0,101,141,31,79,8340
1168,1094,74,467,627,1974,932,182100,749,419,64.13,35.87,463,29,250,178,234,18,270,203,35,0,89,285,53,64,80,8341
536,536,0,367,169,1975,952,201400,427,109,79.66,20.34,152,31,231,209,75,12,184,104,0,0,0,144,143,17,12,8342
1160,1075,85,280,795,1976,740,145800,626,534,53.97,46.03,322,73,143,86,74,15,237,0,0,0,23,223,101,43,13,8343
1407,217,1190,166,51,1971,0,166700,1086,321,77.19,22.81,218,49,153,216,395,0,18,0,0,0,56,12,19,0,0,8344
417,407,10,366,41,1979,1119,329300,382,35,91.61,8.39,146,42,219,48,39,0,28,0,0,0,0,74,202,40,116,8345
